ID,Sex,Sex Label,Regions,Regions Label,Periods,Periods Label,PopulationOn1January_1,PopulationDensity_2,LiveBornChildren_3,LiveBornChildrenRatio_4,Deaths_5,DeathsRatio_6,NaturalIncrease_7,TotalArrivals_8,TotalArrivalsRatio_9,DueToImmigration_10,DueToIntermunicipalMoves_11,TotalDeparturesIncludingAdministra_12,TotalDeparturesIncludingAdmRatio_13,DueToEmigrationIncludingAdministr_14,NetAdministrativeCorrections_15,DueToIntermunicipalMoves_16,NetMigrationIncludingAdministrative_17,PopulationGrowth_18,PopulationGrowthRatio_19,PopulationOn31December_20
70,T001038,Total male and female,NL01  ,The Netherlands,2012JJ00,2012,16730348,496,175959,10.5,140813,8.4,35146,768233,45.9,158374,609859,754350,45,144491,-34135,609859,13883,49227,2.9,16779575
71,T001038,Total male and female,NL01  ,The Netherlands,2013JJ00,2013,16779575,498,171341,10.2,141245,8.4,30096,778922,46.4,164772,614150,759819,45.2,145669,-28489,614150,19103,49714,3,16829289
72,T001038,Total male and female,NL01  ,The Netherlands,2014JJ00,2014,16829289,500,175181,10.4,139223,8.3,35958,837416,49.7,182949,654467,802329,47.6,147862,-25614,654467,35087,71437,4.2,16900726
73,T001038,Total male and female,NL01  ,The Netherlands,2015JJ00,2015,16900726,502,170510,10.1,147134,8.7,23376,902220,53.3,204615,697605,847114,50,149509,-22625,697605,55106,78394,4.6,16979120
74,T001038,Total male and female,NL01  ,The Netherlands,2016JJ00,2016,16979120,504,172520,10.1,148997,8.7,23523,998227,58.6,230739,767488,919033,54,151545,-24225,767488,79194,102387,6,17081507
75,T001038,Total male and female,NL01  ,The Netherlands,2017JJ00,2017,17081507,507,169836,9.9,150214,8.8,19622,1031566,60.2,234957,796609,950901,55.5,154292,-26840,796609,80665,99577,5.8,17181084
76,T001038,Total male and female,NL01  ,The Netherlands,2018JJ00,2018,17181084,510,168525,9.8,153363,8.9,15162,1002022,58.2,243737,758285,915651,53.1,157366,-22569,758285,86371,101079,5.9,17282163
77,T001038,Total male and female,NL01  ,The Netherlands,2019JJ00,2019,17282163,513,169680,9.8,151885,8.8,17795,1026586,59.2,269064,757522,918551,53,161029,-21873,757522,108035,125422,7.3,17407585
78,T001038,Total male and female,NL01  ,The Netherlands,2020JJ00,2020,17407585,517,168681,9.7,168678,9.7,3,1014246,58.2,220853,793393,945887,54.2,152494,-19333,793393,68359,67830,3.9,17475415
79,T001038,Total male and female,NL01  ,The Netherlands,2021JJ00,2021,17475415,519,179441,10.2,170972,9.8,8469,1055038,60.2,252528,802510,947840,54.1,145330,-17236,802510,107198,115257,6.6,17590672
80,T001038,Total male and female,NL01  ,The Netherlands,2022JJ00,2022,17590672,523,167504,9.5,170112,9.6,-2608,1189995,67.2,403108,786887,966197,54.6,179310,-23090,786887,223798,220619,12.5,17811291
81,T001038,Total male and female,NL01  ,The Netherlands,2023JJ00,2023,17811291,529,164487,9.2,169521,9.5,-5034,1154151,64.6,335668,818483,1016785,56.9,198302,-32318,818483,137366,131651,7.4,17942942
152,T001038,Total male and female,LD01  ,Noord-Nederland (LD),2012JJ00,2012,1718896,207,16512,9.6,16182,9.4,330,78936,45.9,11386,67550,79689,46.4,9891,-1823,69798,-753,-411,-0.2,1718485
153,T001038,Total male and female,LD01  ,Noord-Nederland (LD),2013JJ00,2013,1718485,207,15763,9.2,16113,9.4,-350,80051,46.6,11924,68127,80205,46.7,9358,-1576,70847,-154,-452,-0.3,1718033
154,T001038,Total male and female,LD01  ,Noord-Nederland (LD),2014JJ00,2014,1718033,207,16026,9.3,15725,9.2,301,85751,49.9,14919,70832,85287,49.6,10454,-2164,74833,464,742,0.4,1718775
155,T001038,Total male and female,LD01  ,Noord-Nederland (LD),2015JJ00,2015,1718775,207,15369,8.9,16515,9.6,-1146,93401,54.3,18984,74417,92655,53.9,9964,-1723,82691,746,-385,-0.2,1718390
156,T001038,Total male and female,LD01  ,Noord-Nederland (LD),2016JJ00,2016,1718390,207,15631,9.1,16953,9.9,-1322,111541,64.8,28035,83506,106344,61.8,10273,-1806,96071,5197,3857,2.2,1722247
157,T001038,Total male and female,LD01  ,Noord-Nederland (LD),2017JJ00,2017,1722247,208,15250,8.9,17130,9.9,-1880,118206,68.6,31714,86492,116206,67.5,10506,-2314,105700,2000,65,0,1722312
158,T001038,Total male and female,LD01  ,Noord-Nederland (LD),2018JJ00,2018,1722312,208,14704,8.5,17416,10.1,-2712,104576,60.7,23599,80977,100343,58.2,10066,-1476,90277,4233,1517,0.9,1723829
159,T001038,Total male and female,LD01  ,Noord-Nederland (LD),2019JJ00,2019,1723829,208,15109,8.8,16899,9.8,-1790,102028,59.1,23861,78167,94534,54.7,10582,-1598,83952,7494,5676,3.3,1729505
160,T001038,Total male and female,LD01  ,Noord-Nederland (LD),2020JJ00,2020,1729505,209,14932,8.6,17720,10.2,-2788,99608,57.5,19446,80162,93165,53.8,10220,-1557,82945,6443,3638,2.1,1733143
161,T001038,Total male and female,LD01  ,Noord-Nederland (LD),2021JJ00,2021,1733143,209,16068,9.2,19146,11,-3078,109759,63.2,27789,81970,97902,56.3,9717,-1628,88185,11857,8789,5.1,1741932
162,T001038,Total male and female,LD01  ,Noord-Nederland (LD),2022JJ00,2022,1741932,210,14831,8.5,19320,11,-4489,121347,69.3,42727,78620,101085,57.8,12378,-1703,88707,20262,15745,9,1757677
163,T001038,Total male and female,LD01  ,Noord-Nederland (LD),2023JJ00,2023,1757677,212,14582,8.3,19007,10.8,-4425,121013,68.7,37090,83923,106890,60.6,14537,-2709,92353,14123,9703,5.5,1767380
234,T001038,Total male and female,LD02  ,Oost-Nederland (LD),2012JJ00,2012,3543938,365,37193,10.5,28969,8.2,8224,144702,40.8,22330,122372,143362,40.4,19394,-3574,123968,1340,9644,2.7,3553582
235,T001038,Total male and female,LD02  ,Oost-Nederland (LD),2013JJ00,2013,3553582,366,36521,10.3,29326,8.2,7195,145277,40.8,23697,121580,146825,41.3,21588,-4537,125237,-1548,5700,1.6,3559282
236,T001038,Total male and female,LD02  ,Oost-Nederland (LD),2014JJ00,2014,3559282,367,36865,10.3,28785,8.1,8080,154765,43.4,26162,128603,153435,43,21523,-3320,131912,1330,9739,2.7,3569021
237,T001038,Total male and female,LD02  ,Oost-Nederland (LD),2015JJ00,2015,3569021,368,36025,10.1,30135,8.4,5890,167727,46.9,31301,136426,158994,44.5,21732,-3492,137262,8733,14678,4.1,3583699
238,T001038,Total male and female,LD02  ,Oost-Nederland (LD),2016JJ00,2016,3583699,369,35933,10,30635,8.5,5298,188623,52.5,33816,154807,174147,48.5,22042,-3782,152105,14476,19707,5.5,3603406
239,T001038,Total male and female,LD02  ,Oost-Nederland (LD),2017JJ00,2017,3603406,371,35444,9.8,31153,8.6,4291,191622,53,28805,162817,175919,48.7,21633,-3775,154286,15703,19868,5.5,3623274
240,T001038,Total male and female,LD02  ,Oost-Nederland (LD),2018JJ00,2018,3623274,374,35318,9.7,32013,8.8,3305,187557,51.6,32342,155215,169192,46.6,21501,-2919,147691,18365,21675,6,3644949
241,T001038,Total male and female,LD02  ,Oost-Nederland (LD),2019JJ00,2019,3644949,376,35543,9.7,32026,8.8,3517,193079,52.8,37509,155570,170080,46.5,23199,-3903,146881,22999,26430,7.3,3671379
242,T001038,Total male and female,LD02  ,Oost-Nederland (LD),2020JJ00,2020,3671379,379,35855,9.7,35245,9.6,610,191100,51.9,30568,160532,171663,46.6,20761,-3434,150902,19437,19983,5.4,3691362
243,T001038,Total male and female,LD02  ,Oost-Nederland (LD),2021JJ00,2021,3691362,381,37578,10.1,35920,9.7,1658,194201,52.4,32969,161232,170012,45.9,21344,-3828,148668,24189,25791,7,3717153
244,T001038,Total male and female,LD02  ,Oost-Nederland (LD),2022JJ00,2022,3717153,384,35963,9.6,36077,9.6,-114,220299,58.9,62514,157785,174487,46.7,28289,-4888,146198,45812,45589,12.3,3762742
245,T001038,Total male and female,LD02  ,Oost-Nederland (LD),2023JJ00,2023,3762742,388,35298,9.3,35396,9.4,-98,212323,56.2,47445,164878,185924,49.2,31901,-7236,154023,26399,26188,7,3788930
316,T001038,Total male and female,LD03  ,West-Nederland (LD),2012JJ00,2012,7880753,912,89118,11.3,64215,8.1,24903,393220,49.8,93232,299988,384333,48.7,90133,-24454,294200,8887,33853,4.3,7914606
317,T001038,Total male and female,LD03  ,West-Nederland (LD),2013JJ00,2013,7914606,917,86488,10.9,64202,8.1,22286,398176,50.2,95785,302391,382728,48.2,88536,-19413,294192,15448,38088,4.8,7952694
318,T001038,Total male and female,LD03  ,West-Nederland (LD),2014JJ00,2014,7952694,921,89206,11.2,62967,7.9,26239,430751,54,104950,325801,403566,50.6,87006,-15723,316560,27185,53544,6.7,8006238
319,T001038,Total male and female,LD03  ,West-Nederland (LD),2015JJ00,2015,8006238,927,86821,10.8,66732,8.3,20089,462648,57.6,112342,350306,426793,53.1,87875,-12905,338918,35855,55784,7,8062022
320,T001038,Total male and female,LD03  ,West-Nederland (LD),2016JJ00,2016,8062022,933,87955,10.9,67514,8.3,20441,498593,61.6,120378,378215,455086,56.2,89370,-13990,365716,43507,63755,7.9,8125777
321,T001038,Total male and female,LD03  ,West-Nederland (LD),2017JJ00,2017,8125777,941,86792,10.6,67384,8.3,19408,517011,63.4,127922,389089,471808,57.8,91825,-16402,379983,45203,64237,7.9,8190014
322,T001038,Total male and female,LD03  ,West-Nederland (LD),2018JJ00,2018,8190014,949,86301,10.5,68868,8.4,17433,510448,62.1,139001,371447,465066,56.6,92576,-12957,372490,45382,62428,7.6,8252442
323,T001038,Total male and female,LD03  ,West-Nederland (LD),2019JJ00,2019,8252442,956,86901,10.5,68067,8.2,18834,528364,63.7,153876,374488,472878,57,93390,-11088,379488,55486,74103,9,8326545
324,T001038,Total male and female,LD03  ,West-Nederland (LD),2020JJ00,2020,8326545,965,85829,10.3,75533,9.1,10296,516783,61.9,121958,394825,492174,59,88950,-9985,403224,24609,34544,4.1,8361089
325,T001038,Total male and female,LD03  ,West-Nederland (LD),2021JJ00,2021,8361089,969,90818,10.8,76316,9.1,14502,537079,64,136336,400743,491961,58.6,81725,-7303,410236,45118,59322,7.1,8420411
326,T001038,Total male and female,LD03  ,West-Nederland (LD),2022JJ00,2022,8420411,976,83971,9.9,75993,9,7978,608262,71.7,211437,396825,499966,59,99961,-11421,400005,108296,115884,13.8,8536295
327,T001038,Total male and female,LD03  ,West-Nederland (LD),2023JJ00,2023,8536295,990,82401,9.6,75813,8.8,6588,585668,68.3,173178,412490,519372,60.6,110025,-15442,409347,66296,72343,8.5,8608638
398,T001038,Total male and female,LD04  ,Zuid-Nederland (LD),2012JJ00,2012,3586761,508,33136,9.2,31447,8.8,1689,151375,42.2,31426,119949,146966,40.9,25073,-4284,121893,4409,6141,1.7,3592902
399,T001038,Total male and female,LD04  ,Zuid-Nederland (LD),2013JJ00,2013,3592902,509,32569,9.1,31604,8.8,965,155418,43.2,33366,122052,150061,41.7,26187,-2963,123874,5357,6378,1.8,3599280
400,T001038,Total male and female,LD04  ,Zuid-Nederland (LD),2014JJ00,2014,3599280,510,33084,9.2,31746,8.8,1338,166149,46.1,36918,129231,160041,44.4,28879,-4407,131162,6108,7412,2.1,3606692
401,T001038,Total male and female,LD04  ,Zuid-Nederland (LD),2015JJ00,2015,3606692,511,32295,8.9,33752,9.3,-1457,178444,49.4,41988,136456,168672,46.7,29938,-4505,138734,9772,8317,2.3,3615009
402,T001038,Total male and female,LD04  ,Zuid-Nederland (LD),2016JJ00,2016,3615009,512,33001,9.1,33895,9.4,-894,199470,55.1,48510,150960,183456,50.6,29860,-4647,153596,16014,15068,4.2,3630077
403,T001038,Total male and female,LD04  ,Zuid-Nederland (LD),2017JJ00,2017,3630077,514,32350,8.9,34547,9.5,-2197,204727,56.3,46516,158211,186968,51.4,30328,-4349,156640,17759,15407,4.2,3645484
404,T001038,Total male and female,LD04  ,Zuid-Nederland (LD),2018JJ00,2018,3645484,517,32202,8.8,35066,9.6,-2864,199441,54.6,48795,150646,181050,49.6,33223,-5217,147827,18391,15459,4.2,3660943
405,T001038,Total male and female,LD04  ,Zuid-Nederland (LD),2019JJ00,2019,3660943,519,32127,8.8,34893,9.5,-2766,203115,55.3,53818,149297,181059,49.3,33858,-5284,147201,22056,19213,5.2,3680156
406,T001038,Total male and female,LD04  ,Zuid-Nederland (LD),2020JJ00,2020,3680156,522,32065,8.7,40180,10.9,-8115,206755,56.1,48881,157874,188885,51.3,32563,-4357,156322,17870,9665,2.6,3689821
407,T001038,Total male and female,LD04  ,Zuid-Nederland (LD),2021JJ00,2021,3689821,523,34977,9.5,39590,10.7,-4613,213999,57.8,55434,158565,187965,50.8,32544,-4477,155421,26034,21355,5.8,3711176
408,T001038,Total male and female,LD04  ,Zuid-Nederland (LD),2022JJ00,2022,3711176,527,32739,8.8,38722,10.4,-5983,240087,64.3,86430,153657,190659,51.1,38682,-5078,151977,49428,43401,11.7,3754577
409,T001038,Total male and female,LD04  ,Zuid-Nederland (LD),2023JJ00,2023,3754577,533,32206,8.6,39305,10.4,-7099,235147,62.4,77955,157192,204599,54.3,41839,-6931,162760,30548,23417,6.2,3777994
480,T001038,Total male and female,PV20  ,Groningen Province (PV),2012JJ00,2012,580875,250,5604,9.6,5460,9.4,144,34721,59.7,6247,28474,34040,58.6,5458,-1200,28582,681,830,1.4,581705
481,T001038,Total male and female,PV20  ,Groningen Province (PV),2013JJ00,2013,581705,250,5326,9.1,5387,9.3,-61,35120,60.3,6594,28526,34042,58.5,5197,-1126,28845,1078,1023,1.8,582728
482,T001038,Total male and female,PV20  ,Groningen Province (PV),2014JJ00,2014,582728,251,5414,9.3,5325,9.1,89,38723,66.4,8977,29746,37592,64.4,5935,-1526,31657,1131,1214,2.1,583942
483,T001038,Total male and female,PV20  ,Groningen Province (PV),2015JJ00,2015,583942,251,5329,9.1,5481,9.4,-152,42363,72.6,11611,30752,42454,72.7,5818,-1315,36636,-91,-221,-0.4,583721
484,T001038,Total male and female,PV20  ,Groningen Province (PV),2016JJ00,2016,583721,251,5406,9.3,5583,9.6,-177,45910,78.7,12156,33754,45855,78.6,5975,-1367,39880,55,-140,-0.2,583581
485,T001038,Total male and female,PV20  ,Groningen Province (PV),2017JJ00,2017,583581,251,5092,8.7,5664,9.7,-572,42977,73.7,9043,33934,43022,73.8,6151,-1563,36871,-45,-637,-1.1,582944
486,T001038,Total male and female,PV20  ,Groningen Province (PV),2018JJ00,2018,582944,251,4933,8.5,5650,9.7,-717,48491,83.1,17098,31393,46747,80.1,5609,-799,41138,1744,1046,1.8,583990
487,T001038,Total male and female,PV20  ,Groningen Province (PV),2019JJ00,2019,583990,251,5042,8.6,5500,9.4,-458,45663,78.1,16664,28999,43350,74.1,6239,-1052,37111,2313,1876,3.2,585866
488,T001038,Total male and female,PV20  ,Groningen Province (PV),2020JJ00,2020,585866,252,4956,8.5,5716,9.7,-760,43955,75,14043,29912,42152,71.9,6406,-1067,35746,1803,1071,1.8,586937
489,T001038,Total male and female,PV20  ,Groningen Province (PV),2021JJ00,2021,586937,253,5306,9,6201,10.5,-895,51640,87.7,22575,29065,47581,80.8,5665,-727,41916,4059,3233,5.5,590170
490,T001038,Total male and female,PV20  ,Groningen Province (PV),2022JJ00,2022,590170,255,4994,8.4,6192,10.4,-1198,57290,96.6,28650,28640,50212,84.7,6461,-664,43751,7078,5905,10,596075
491,T001038,Total male and female,PV20  ,Groningen Province (PV),2023JJ00,2023,596075,257,4843,8.1,6179,10.3,-1336,58973,98.5,26716,32257,52446,87.6,7464,-1012,44982,6527,5272,8.8,601347
562,T001038,Total male and female,PV21  ,Fryslân (PV),2012JJ00,2012,647214,194,6502,10,5882,9.1,620,25652,39.6,3146,22506,26631,41.2,2706,-264,23925,-979,-352,-0.5,646862
563,T001038,Total male and female,PV21  ,Fryslân (PV),2013JJ00,2013,646862,195,6263,9.7,5937,9.2,326,26551,41.1,3259,23292,27470,42.5,2621,-231,24849,-919,-545,-0.8,646317
564,T001038,Total male and female,PV21  ,Fryslân (PV),2014JJ00,2014,646317,194,6310,9.8,5783,8.9,527,27969,43.3,3743,24226,28532,44.1,2867,-390,25665,-563,-60,-0.1,646257
565,T001038,Total male and female,PV21  ,Fryslân (PV),2015JJ00,2015,646257,194,6011,9.3,6059,9.4,-48,28429,44,3590,24839,28602,44.3,2435,-127,26167,-173,-217,-0.3,646040
566,T001038,Total male and female,PV21  ,Fryslân (PV),2016JJ00,2016,646040,194,6017,9.3,6286,9.7,-269,31491,48.7,3583,27908,30374,47,2627,-216,27747,1117,834,1.3,646874
567,T001038,Total male and female,PV21  ,Fryslân (PV),2017JJ00,2017,646874,195,5967,9.2,6264,9.7,-297,32687,50.5,3469,29218,31991,49.4,2924,-568,29067,696,394,0.6,647268
568,T001038,Total male and female,PV21  ,Fryslân (PV),2018JJ00,2018,647268,194,5779,8.9,6426,9.9,-647,30969,47.8,4040,26929,29920,46.2,2813,-417,27107,1049,404,0.6,647672
569,T001038,Total male and female,PV21  ,Fryslân (PV),2019JJ00,2019,647672,194,5957,9.2,6256,9.6,-299,31402,48.4,4497,26905,28816,44.4,2676,-256,26140,2586,2285,3.5,649957
570,T001038,Total male and female,PV21  ,Fryslân (PV),2020JJ00,2020,649957,195,5841,9,6453,9.9,-612,30955,47.6,3513,27442,28848,44.3,2532,-334,26316,2107,1478,2.3,651435
571,T001038,Total male and female,PV21  ,Fryslân (PV),2021JJ00,2021,651435,195,6319,9.7,7069,10.8,-750,32028,49.1,3349,28679,28676,43.9,2520,-533,26156,3352,2584,4,654019
572,T001038,Total male and female,PV21  ,Fryslân (PV),2022JJ00,2022,654019,196,5801,8.8,7098,10.8,-1297,35572,54.2,8248,27324,28722,43.7,3736,-636,24986,6850,5532,8.5,659551
573,T001038,Total male and female,PV21  ,Fryslân (PV),2023JJ00,2023,659551,197,5698,8.6,7033,10.6,-1335,34694,52.5,6204,28490,30982,46.9,4288,-979,26694,3712,2353,3.6,661904
644,T001038,Total male and female,PV22  ,Drenthe (PV),2012JJ00,2012,490807,186,4406,9,4840,9.9,-434,18563,37.9,1993,16570,19018,38.8,1727,-359,17291,-455,-889,-1.8,489918
645,T001038,Total male and female,PV22  ,Drenthe (PV),2013JJ00,2013,489918,186,4174,8.5,4789,9.8,-615,18380,37.6,2071,16309,18693,38.2,1540,-219,17153,-313,-930,-1.9,488988
646,T001038,Total male and female,PV22  ,Drenthe (PV),2014JJ00,2014,488988,186,4302,8.8,4617,9.4,-315,19059,39,2199,16860,19163,39.2,1652,-248,17511,-104,-412,-0.8,488576
647,T001038,Total male and female,PV22  ,Drenthe (PV),2015JJ00,2015,488576,185,4029,8.2,4975,10.2,-946,22609,46.3,3783,18826,21599,44.2,1711,-281,19888,1010,53,0.1,488629
648,T001038,Total male and female,PV22  ,Drenthe (PV),2016JJ00,2016,488629,185,4208,8.6,5084,10.4,-876,34140,69.6,12296,21844,30115,61.4,1671,-223,28444,4025,3163,6.5,491792
649,T001038,Total male and female,PV22  ,Drenthe (PV),2017JJ00,2017,491792,187,4191,8.5,5202,10.6,-1011,42542,86.5,19202,23340,41193,83.7,1431,-183,39762,1349,308,0.6,492100
650,T001038,Total male and female,PV22  ,Drenthe (PV),2018JJ00,2018,492100,187,3992,8.1,5340,10.9,-1348,25116,51,2461,22655,23676,48.1,1644,-260,22032,1440,67,0.1,492167
651,T001038,Total male and female,PV22  ,Drenthe (PV),2019JJ00,2019,492167,187,4110,8.3,5143,10.4,-1033,24963,50.6,2700,22263,22368,45.4,1667,-290,20701,2595,1515,3.1,493682
652,T001038,Total male and female,PV22  ,Drenthe (PV),2020JJ00,2020,493682,188,4135,8.4,5551,11.2,-1416,24698,50,1890,22808,22165,44.8,1282,-156,20883,2533,1089,2.2,494771
653,T001038,Total male and female,PV22  ,Drenthe (PV),2021JJ00,2021,494771,188,4443,9,5876,11.8,-1433,26091,52.6,1865,24226,21645,43.6,1532,-368,20113,4446,2972,6,497743
654,T001038,Total male and female,PV22  ,Drenthe (PV),2022JJ00,2022,497743,189,4036,8.1,6030,12.1,-1994,28485,57,5829,22656,22151,44.3,2181,-403,19970,6334,4308,8.7,502051
655,T001038,Total male and female,PV22  ,Drenthe (PV),2023JJ00,2023,502051,191,4041,8,5795,11.5,-1754,27346,54.4,4170,23176,23462,46.6,2785,-718,20677,3884,2078,4.1,504129
726,T001038,Total male and female,PV23  ,Overijssel (PV),2012JJ00,2012,1137668,342,12367,10.9,9421,8.3,2946,40362,35.5,6873,33489,41625,36.6,6159,-1102,35466,-1263,1682,1.5,1139350
727,T001038,Total male and female,PV23  ,Overijssel (PV),2013JJ00,2013,1139350,343,12151,10.7,9753,8.6,2398,39852,35,6625,33227,41919,36.8,6583,-1255,35336,-2067,347,0.3,1139697
728,T001038,Total male and female,PV23  ,Overijssel (PV),2014JJ00,2014,1139697,343,12092,10.6,9623,8.4,2469,41818,36.7,6890,34928,43327,38,6498,-1149,36829,-1509,955,0.8,1140652
729,T001038,Total male and female,PV23  ,Overijssel (PV),2015JJ00,2015,1140652,343,11765,10.3,9985,8.7,1780,46145,40.4,8675,37470,44302,38.8,6267,-851,38035,1843,3628,3.2,1144280
730,T001038,Total male and female,PV23  ,Overijssel (PV),2016JJ00,2016,1144280,344,11728,10.2,10134,8.8,1594,49998,43.6,8170,41828,48161,42,6595,-1273,41566,1837,3407,3,1147687
731,T001038,Total male and female,PV23  ,Overijssel (PV),2017JJ00,2017,1147687,345,11345,9.9,10254,8.9,1091,51443,44.7,7729,43714,48700,42.4,6031,-886,42669,2743,3814,3.3,1151501
732,T001038,Total male and female,PV23  ,Overijssel (PV),2018JJ00,2018,1151501,347,11178,9.7,10510,9.1,668,50886,44.1,8670,42216,46615,40.4,5814,-487,40801,4271,4930,4.3,1156431
733,T001038,Total male and female,PV23  ,Overijssel (PV),2019JJ00,2019,1156431,348,11225,9.7,10478,9,747,51559,44.5,9918,41641,46273,39.9,6613,-1088,39660,5286,5975,5.2,1162406
734,T001038,Total male and female,PV23  ,Overijssel (PV),2020JJ00,2020,1162406,350,11099,9.5,11562,9.9,-463,51171,43.9,8235,42936,46557,40,5623,-867,40934,4614,4127,3.6,1166533
735,T001038,Total male and female,PV23  ,Overijssel (PV),2021JJ00,2021,1166533,351,11628,9.9,11688,10,-60,51225,43.8,8734,42491,45764,39.1,5946,-987,39818,5461,5377,4.6,1171910
736,T001038,Total male and female,PV23  ,Overijssel (PV),2022JJ00,2022,1171910,353,11301,9.6,11719,9.9,-418,59805,50.8,17205,42600,46929,39.8,7753,-1144,39176,12876,12423,10.6,1184333
737,T001038,Total male and female,PV23  ,Overijssel (PV),2023JJ00,2023,1184333,357,10935,9.2,11527,9.7,-592,56239,47.4,12274,43965,50910,42.9,8711,-1935,42199,5329,4700,4,1189033
808,T001038,Total male and female,PV24  ,Flevoland (PV),2012JJ00,2012,395525,279,4991,12.6,2213,5.6,2778,16014,40.3,3696,12318,15890,40,2596,-215,13294,124,2916,7.4,398441
809,T001038,Total male and female,PV24  ,Flevoland (PV),2013JJ00,2013,398441,282,4687,11.7,2247,5.6,2440,16417,41.1,4779,11638,17415,43.6,3501,-764,13914,-998,1452,3.6,399893
810,T001038,Total male and female,PV24  ,Flevoland (PV),2014JJ00,2014,399893,283,4922,12.3,2136,5.3,2786,18098,45.1,5993,12105,19281,48.1,3807,-498,15474,-1183,1898,4.7,401791
811,T001038,Total male and female,PV24  ,Flevoland (PV),2015JJ00,2015,401791,284,4735,11.8,2260,5.6,2475,21202,52.6,7251,13951,21412,53.1,4267,-685,17145,-210,2277,5.7,404068
812,T001038,Total male and female,PV24  ,Flevoland (PV),2016JJ00,2016,404068,286,4706,11.6,2377,5.9,2329,23159,57,6618,16541,21744,53.6,3792,-540,17952,1415,3750,9.3,407818
813,T001038,Total male and female,PV24  ,Flevoland (PV),2017JJ00,2017,407818,289,4565,11.1,2282,5.6,2283,22579,55.1,4890,17689,20997,51.2,3806,-463,17191,1582,3852,9.4,411670
814,T001038,Total male and female,PV24  ,Flevoland (PV),2018JJ00,2018,411670,292,4793,11.6,2486,6,2307,22825,55.1,5447,17378,20244,48.9,3688,-295,16556,2581,4876,11.8,416546
815,T001038,Total male and female,PV24  ,Flevoland (PV),2019JJ00,2019,416546,295,4892,11.7,2469,5.9,2423,25055,59.7,6782,18273,20982,50,4059,-349,16923,4073,6475,15.5,423021
816,T001038,Total male and female,PV24  ,Flevoland (PV),2020JJ00,2020,423021,300,4871,11.4,2740,6.4,2131,24357,57.2,4932,19425,21291,50,3385,-361,17906,3066,5205,12.3,428226
817,T001038,Total male and female,PV24  ,Flevoland (PV),2021JJ00,2021,428226,303,5179,12,2945,6.8,2234,26695,61.9,5558,21137,22379,51.9,4180,-663,18199,4316,6545,15.3,434771
818,T001038,Total male and female,PV24  ,Flevoland (PV),2022JJ00,2022,434771,308,5099,11.6,2877,6.5,2222,31718,72.1,10821,20897,23976,54.5,5689,-797,18287,7742,9930,22.8,444701
819,T001038,Total male and female,PV24  ,Flevoland (PV),2023JJ00,2023,444701,315,4966,11.1,2912,6.5,2054,28933,64.6,7829,21104,24838,55.5,6456,-1198,18382,4095,6125,13.8,450826
890,T001038,Total male and female,PV25  ,Gelderland (PV),2012JJ00,2012,2010745,405,19835,9.9,17335,8.6,2500,88326,43.9,11761,76565,85847,42.6,10639,-2257,75208,2479,5046,2.5,2015791
891,T001038,Total male and female,PV25  ,Gelderland (PV),2013JJ00,2013,2015791,406,19683,9.8,17326,8.6,2357,89008,44.1,12293,76715,87491,43.4,11504,-2518,75987,1517,3901,1.9,2019692
892,T001038,Total male and female,PV25  ,Gelderland (PV),2014JJ00,2014,2019692,407,19851,9.8,17026,8.4,2825,94849,46.9,13279,81570,90827,44.9,11218,-1673,79609,4022,6886,3.4,2026578
893,T001038,Total male and female,PV25  ,Gelderland (PV),2015JJ00,2015,2026578,408,19525,9.6,17890,8.8,1635,100380,49.4,15375,85005,93280,45.9,11198,-1956,82082,7100,8773,4.3,2035351
894,T001038,Total male and female,PV25  ,Gelderland (PV),2016JJ00,2016,2035351,410,19499,9.6,18124,8.9,1375,115466,56.6,19028,96438,104242,51.1,11655,-1969,92587,11224,12550,6.2,2047901
895,T001038,Total male and female,PV25  ,Gelderland (PV),2017JJ00,2017,2047901,412,19534,9.5,18617,9.1,917,117600,57.3,16186,101414,106222,51.7,11796,-2426,94426,11378,12202,6,2060103
896,T001038,Total male and female,PV25  ,Gelderland (PV),2018JJ00,2018,2060103,415,19347,9.4,19017,9.2,330,113846,55.1,18225,95621,102333,49.5,11999,-2137,90334,11513,11869,5.8,2071972
897,T001038,Total male and female,PV25  ,Gelderland (PV),2019JJ00,2019,2071972,417,19426,9.3,19079,9.2,347,116465,56,20809,95656,102825,49.5,12527,-2466,90298,13640,13980,6.7,2085952
898,T001038,Total male and female,PV25  ,Gelderland (PV),2020JJ00,2020,2085952,420,19885,9.5,20943,10,-1058,115572,55.3,17401,98171,103815,49.6,11753,-2206,92062,11757,10651,5.1,2096603
899,T001038,Total male and female,PV25  ,Gelderland (PV),2021JJ00,2021,2096603,422,20771,9.9,21287,10.1,-516,116281,55.3,18677,97604,101869,48.4,11218,-2178,90651,14412,13869,6.6,2110472
900,T001038,Total male and female,PV25  ,Gelderland (PV),2022JJ00,2022,2110472,425,19563,9.2,21481,10.1,-1918,128776,60.7,34488,94288,103582,48.8,14847,-2947,88735,25194,23236,11,2133708
901,T001038,Total male and female,PV25  ,Gelderland (PV),2023JJ00,2023,2133708,430,19397,9.1,20957,9.8,-1560,127151,59.4,27342,99809,110176,51.5,16734,-4103,93442,16975,15363,7.2,2149071
972,T001038,Total male and female,PV26  ,Utrecht Province (PV),2012JJ00,2012,1237117,894,14878,12,8933,7.2,5945,62452,50.3,9387,53065,60177,48.5,8740,-1255,51437,2275,8177,6.6,1245294
973,T001038,Total male and female,PV26  ,Utrecht Province (PV),2013JJ00,2013,1245294,901,14313,11.5,9101,7.3,5212,63826,51.1,9930,53896,60711,48.6,9017,-895,51694,3115,8378,6.7,1253672
974,T001038,Total male and female,PV26  ,Utrecht Province (PV),2014JJ00,2014,1253672,907,14821,11.8,9087,7.2,5734,70317,55.9,10698,59619,66179,52.6,9025,-760,57154,4138,9900,7.9,1263572
975,T001038,Total male and female,PV26  ,Utrecht Province (PV),2015JJ00,2015,1263572,914,14371,11.3,9484,7.5,4887,75636,59.6,11886,63750,70480,55.6,9292,-1011,61188,5156,10041,7.9,1273613
976,T001038,Total male and female,PV26  ,Utrecht Province (PV),2016JJ00,2016,1273613,923,14465,11.3,9609,7.5,4856,80496,62.9,12337,68159,74478,58.2,8476,-720,66002,6018,10891,8.6,1284504
977,T001038,Total male and female,PV26  ,Utrecht Province (PV),2017JJ00,2017,1284504,931,14532,11.3,9701,7.5,4831,81093,62.9,12091,69002,74931,58.1,9015,-1107,65916,6162,10980,8.5,1295484
978,T001038,Total male and female,PV26  ,Utrecht Province (PV),2018JJ00,2018,1295484,940,14354,11,9869,7.6,4485,80073,61.5,13205,66868,73127,56.2,9293,-841,63834,6946,11406,8.8,1306890
979,T001038,Total male and female,PV26  ,Utrecht Province (PV),2019JJ00,2019,1342158,904,14935,11.1,10176,7.5,4759,82811,61.4,14980,67831,74849,55.5,9837,-882,65012,7962,12676,9.4,1354834
980,T001038,Total male and female,PV26  ,Utrecht Province (PV),2020JJ00,2020,1354834,912,14776,10.9,11179,8.2,3597,81545,60,11847,69698,78787,58,8888,-386,69899,2758,6319,4.7,1361153
981,T001038,Total male and female,PV26  ,Utrecht Province (PV),2021JJ00,2021,1361153,916,15784,11.6,11323,8.3,4461,84727,62,13268,71459,80428,58.9,8436,-802,71992,4299,8720,6.4,1369873
982,T001038,Total male and female,PV26  ,Utrecht Province (PV),2022JJ00,2022,1369873,923,14229,10.3,11461,8.3,2768,93899,68.1,22557,71342,78868,57.2,10283,-662,68585,15031,17770,13,1387643
983,T001038,Total male and female,PV26  ,Utrecht Province (PV),2023JJ00,2023,1387643,935,14070,10.1,11557,8.3,2513,91748,65.8,16902,74846,81825,58.7,11255,-1433,70570,9923,12414,8.9,1400057
1054,T001038,Total male and female,PV27  ,Noord-Holland (PV),2012JJ00,2012,2709822,1017,29791,11,22118,8.1,7673,142275,52.4,35888,106387,135516,49.9,34354,-8828,101162,6759,14478,5.3,2724300
1055,T001038,Total male and female,PV27  ,Noord-Holland (PV),2013JJ00,2013,2724300,1023,29312,10.7,22026,8.1,7286,144192,52.8,36737,107455,134597,49.3,33253,-6469,101344,9595,17069,6.3,2741369
1056,T001038,Total male and female,PV27  ,Noord-Holland (PV),2014JJ00,2014,2741369,1029,29959,10.9,21617,7.9,8342,159159,57.8,42565,116594,147053,53.4,34358,-6304,112695,12106,20560,7.5,2761929
1057,T001038,Total male and female,PV27  ,Noord-Holland (PV),2015JJ00,2015,2761929,1037,29509,10.6,23032,8.3,6477,173392,62.5,46369,127023,157000,56.6,34429,-3812,122571,16392,22925,8.3,2784854
1058,T001038,Total male and female,PV27  ,Noord-Holland (PV),2016JJ00,2016,2784854,1046,29876,10.7,23276,8.3,6600,185009,66.1,51251,133758,166941,59.7,35238,-3757,131703,18068,24629,8.8,2809483
1059,T001038,Total male and female,PV27  ,Noord-Holland (PV),2017JJ00,2017,2809483,1055,29393,10.4,22866,8.1,6527,190876,67.7,55623,135253,175621,62.3,37664,-5840,137957,15255,21699,7.7,2831182
1060,T001038,Total male and female,PV27  ,Noord-Holland (PV),2018JJ00,2018,2831182,1062,29253,10.3,23424,8.2,5829,192122,67.6,62713,129409,175675,61.8,39278,-4951,136397,16447,22177,7.8,2853359
1061,T001038,Total male and female,PV27  ,Noord-Holland (PV),2019JJ00,2019,2853359,1071,29254,10.2,23086,8.1,6168,202030,70.5,69450,132580,181981,63.5,40113,-4451,141868,20049,26168,9.2,2879527
1062,T001038,Total male and female,PV27  ,Noord-Holland (PV),2020JJ00,2020,2879527,1081,29031,10.1,25481,8.8,3550,192708,66.8,52621,140087,187191,64.9,37097,-2294,150094,5517,8959,3.1,2888486
1063,T001038,Total male and female,PV27  ,Noord-Holland (PV),2021JJ00,2021,2888486,1084,30919,10.7,25972,9,4947,202289,69.8,60062,142227,185760,64.1,34987,-2038,150773,16529,21341,7.4,2909827
1064,T001038,Total male and female,PV27  ,Noord-Holland (PV),2022JJ00,2022,2909827,1093,28408,9.7,25891,8.8,2517,232345,79.3,92327,140018,191865,65.5,42340,-3896,149525,40480,42795,14.7,2952622
1065,T001038,Total male and female,PV27  ,Noord-Holland (PV),2023JJ00,2023,2952622,1109,27545,9.3,26077,8.8,1468,220492,74.4,77061,143431,197779,66.7,47330,-5104,150449,22713,23865,8.1,2976487
1136,T001038,Total male and female,PV28  ,Zuid-Holland (PV),2012JJ00,2012,3552407,1265,40814,11.5,29411,8.3,11403,173343,48.7,44295,129048,173291,48.7,44266,-13488,129025,52,11528,3.2,3563935
1137,T001038,Total male and female,PV28  ,Zuid-Holland (PV),2013JJ00,2013,3563935,1270,39350,11,29248,8.2,10102,175092,49,45599,129493,172208,48.2,43901,-11557,128307,2884,13097,3.7,3577032
1138,T001038,Total male and female,PV28  ,Zuid-Holland (PV),2014JJ00,2014,3577032,1275,40779,11.4,28731,8,12048,186013,51.8,48361,137652,175060,48.8,40918,-8138,134142,10953,22979,6.4,3600011
1139,T001038,Total male and female,PV28  ,Zuid-Holland (PV),2015JJ00,2015,3600011,1283,39337,10.9,30286,8.4,9051,197513,54.7,50490,147023,184056,51,41586,-7573,142470,13457,22292,6.2,3622303
1140,T001038,Total male and female,PV28  ,Zuid-Holland (PV),2016JJ00,2016,3622303,1287,40155,11,30744,8.5,9411,215352,59.2,52740,162612,196672,54.1,43049,-9025,153623,18680,27919,7.7,3650222
1141,T001038,Total male and female,PV28  ,Zuid-Holland (PV),2017JJ00,2017,3650222,1297,39428,10.8,30873,8.4,8555,226617,61.8,56476,170141,204094,55.7,42544,-9022,161550,22523,30822,8.4,3681044
1142,T001038,Total male and female,PV28  ,Zuid-Holland (PV),2018JJ00,2018,3681044,1311,39316,10.6,31532,8.5,7784,219782,59.5,58797,160985,199170,53.9,41151,-6643,158019,20612,28117,7.6,3709161
1143,T001038,Total male and female,PV28  ,Zuid-Holland (PV),2019JJ00,2019,3673893,1361,39290,10.6,30871,8.4,8419,225369,61.1,65164,160205,198860,53.9,40468,-5244,158392,26509,34803,9.5,3708696
1144,T001038,Total male and female,PV28  ,Zuid-Holland (PV),2020JJ00,2020,3708696,1374,38598,10.4,34734,9.3,3864,223529,60.1,53501,170028,209833,56.4,40433,-6912,169400,13696,17354,4.7,3726050
1145,T001038,Total male and female,PV28  ,Zuid-Holland (PV),2021JJ00,2021,3726050,1380,40523,10.8,34288,9.2,6235,231507,61.9,59024,172483,209731,56.1,35462,-3937,174269,21776,27894,7.5,3753944
1146,T001038,Total male and female,PV28  ,Zuid-Holland (PV),2022JJ00,2022,3753944,1391,37858,10,34220,9.1,3638,259332,68.6,89004,170328,211873,56.1,43584,-6319,168289,47459,50962,13.6,3804906
1147,T001038,Total male and female,PV28  ,Zuid-Holland (PV),2023JJ00,2023,3804906,1410,37427,9.8,33760,8.8,3667,253221,66.2,73897,179324,221139,57.8,47726,-8209,173413,32082,35554,9.3,3840460
1218,T001038,Total male and female,PV29  ,Zeeland (PV),2012JJ00,2012,381407,214,3635,9.5,3753,9.8,-118,15150,39.7,3662,11488,15349,40.3,2773,-883,12576,-199,-330,-0.9,381077
1219,T001038,Total male and female,PV29  ,Zeeland (PV),2013JJ00,2013,381077,214,3513,9.2,3827,10,-314,15066,39.6,3519,11547,15212,39.9,2365,-492,12847,-146,-456,-1.2,380621
1220,T001038,Total male and female,PV29  ,Zeeland (PV),2014JJ00,2014,380621,213,3647,9.6,3532,9.3,115,15262,40.1,3326,11936,15274,40.1,2705,-521,12569,-12,105,0.3,380726
1221,T001038,Total male and female,PV29  ,Zeeland (PV),2015JJ00,2015,380726,213,3604,9.5,3930,10.3,-326,16107,42.3,3597,12510,15257,40,2568,-509,12689,850,526,1.4,381252
1222,T001038,Total male and female,PV29  ,Zeeland (PV),2016JJ00,2016,381252,214,3459,9.1,3885,10.2,-426,17736,46.5,4050,13686,16995,44.6,2607,-488,14388,741,316,0.8,381568
1223,T001038,Total male and female,PV29  ,Zeeland (PV),2017JJ00,2017,381568,214,3439,9,3944,10.3,-505,18425,48.2,3732,14693,17162,44.9,2602,-433,14560,1263,736,1.9,382304
1224,T001038,Total male and female,PV29  ,Zeeland (PV),2018JJ00,2018,382304,215,3378,8.8,4043,10.6,-665,18471,48.3,4286,14185,17094,44.7,2854,-522,14240,1377,728,1.9,383032
1225,T001038,Total male and female,PV29  ,Zeeland (PV),2019JJ00,2019,383032,215,3422,8.9,3934,10.3,-512,18154,47.4,4282,13872,17188,44.8,2972,-511,14216,966,456,1.2,383488
1226,T001038,Total male and female,PV29  ,Zeeland (PV),2020JJ00,2020,383488,215,3424,8.9,4139,10.8,-715,19001,49.4,3989,15012,16363,42.6,2532,-393,13831,2638,1912,5,385400
1227,T001038,Total male and female,PV29  ,Zeeland (PV),2021JJ00,2021,385400,216,3592,9.3,4733,12.3,-1141,18556,48.1,3982,14574,16042,41.6,2840,-526,13202,2514,1367,3.5,386767
1228,T001038,Total male and female,PV29  ,Zeeland (PV),2022JJ00,2022,386767,217,3476,8.9,4421,11.4,-945,22686,58.3,7549,15137,17360,44.6,3754,-544,13606,5326,4357,11.3,391124
1229,T001038,Total male and female,PV29  ,Zeeland (PV),2023JJ00,2023,391124,220,3359,8.6,4419,11.3,-1060,20207,51.6,5318,14889,18629,47.6,3714,-696,14915,1578,510,1.3,391634
1300,T001038,Total male and female,PV30  ,Noord-Brabant (PV),2012JJ00,2012,2463686,501,24027,9.7,20456,8.3,3571,102092,41.4,19613,82479,98401,39.9,16178,-3102,82223,3691,7325,3,2471011
1301,T001038,Total male and female,PV30  ,Noord-Brabant (PV),2013JJ00,2013,2471011,503,23558,9.5,20545,8.3,3013,106614,43.1,21321,85293,101416,41,16629,-1867,84787,5198,8263,3.3,2479274
1302,T001038,Total male and female,PV30  ,Noord-Brabant (PV),2014JJ00,2014,2479274,505,24243,9.8,20823,8.4,3420,114325,46,23725,90600,108262,43.6,18715,-3276,89547,6063,9477,3.8,2488751
1303,T001038,Total male and female,PV30  ,Noord-Brabant (PV),2015JJ00,2015,2488751,507,23556,9.4,21938,8.8,1618,123053,49.3,27396,95657,114687,46,19088,-3284,95599,8366,9998,4,2498749
1304,T001038,Total male and female,PV30  ,Noord-Brabant (PV),2016JJ00,2016,2498749,509,24007,9.6,22356,8.9,1651,139618,55.7,33676,105942,127469,50.9,19650,-3630,107819,12149,13782,5.5,2512531
1305,T001038,Total male and female,PV30  ,Noord-Brabant (PV),2017JJ00,2017,2512531,512,23529,9.3,22702,9,827,143553,57,32125,111428,128529,51,19272,-3129,109257,15024,15755,6.3,2528286
1306,T001038,Total male and female,PV30  ,Noord-Brabant (PV),2018JJ00,2018,2528286,515,23492,9.3,23150,9.1,342,139701,55.1,33647,106054,123468,48.7,21076,-3940,102392,16233,16520,6.5,2544806
1307,T001038,Total male and female,PV30  ,Noord-Brabant (PV),2019JJ00,2019,2544806,519,23459,9.2,22886,9,573,141525,55.4,36843,104682,123919,48.5,21732,-4133,102187,17606,18149,7.1,2562955
1308,T001038,Total male and female,PV30  ,Noord-Brabant (PV),2020JJ00,2020,2562955,522,23413,9.1,26555,10.3,-3142,144060,56.1,33837,110223,129881,50.6,19695,-3334,110186,14179,10994,4.3,2573949
1309,T001038,Total male and female,PV30  ,Noord-Brabant (PV),2021JJ00,2021,2573949,525,25542,9.9,25665,9.9,-123,149534,57.9,39078,110456,130485,50.5,20221,-3022,110264,19049,18925,7.4,2592874
1310,T001038,Total male and female,PV30  ,Noord-Brabant (PV),2022JJ00,2022,2592874,529,23816,9.1,25700,9.8,-1884,167986,64.4,61248,106738,132753,50.9,24163,-3426,108590,35233,33336,12.9,2626210
1311,T001038,Total male and female,PV30  ,Noord-Brabant (PV),2023JJ00,2023,2626210,536,23425,8.9,26071,9.9,-2646,166006,63,56000,110006,144833,55,26592,-4737,118241,21173,18529,7.1,2644739
1382,T001038,Total male and female,PV31  ,Limburg (PV),2012JJ00,2012,1123075,522,9109,8.1,10991,9.8,-1882,49283,43.9,11813,37470,48565,43.3,8895,-1182,39670,718,-1184,-1.1,1121891
1383,T001038,Total male and female,PV31  ,Limburg (PV),2013JJ00,2013,1121891,522,9011,8,11059,9.9,-2048,48804,43.5,12045,36759,48645,43.4,9558,-1096,39087,159,-1885,-1.7,1120006
1384,T001038,Total male and female,PV31  ,Limburg (PV),2014JJ00,2014,1120006,521,8841,7.9,10923,9.8,-2082,51824,46.3,13193,38631,51779,46.3,10164,-1131,41615,45,-2065,-1.8,1117941
1385,T001038,Total male and female,PV31  ,Limburg (PV),2015JJ00,2015,1117941,520,8739,7.8,11814,10.6,-3075,55391,49.6,14592,40799,53985,48.3,10850,-1221,43135,1406,-1681,-1.5,1116260
1386,T001038,Total male and female,PV31  ,Limburg (PV),2016JJ00,2016,1116260,520,8994,8.1,11539,10.3,-2545,59852,53.6,14834,45018,55987,50.1,10210,-1017,45777,3865,1286,1.2,1117546
1387,T001038,Total male and female,PV31  ,Limburg (PV),2017JJ00,2017,1117546,520,8821,7.9,11845,10.6,-3024,61174,54.7,14391,46783,58439,52.3,11056,-1220,47383,2735,-348,-0.3,1117198
1388,T001038,Total male and female,PV31  ,Limburg (PV),2018JJ00,2018,1117198,520,8710,7.8,11916,10.7,-3206,59740,53.5,15148,44592,57582,51.6,12147,-1277,45435,2158,-1061,-0.9,1116137
1389,T001038,Total male and female,PV31  ,Limburg (PV),2019JJ00,2019,1116137,520,8668,7.8,12007,10.8,-3339,61590,55.2,16975,44615,57140,51.2,12126,-1151,45014,4450,1064,1,1117201
1390,T001038,Total male and female,PV31  ,Limburg (PV),2020JJ00,2020,1117201,520,8652,7.7,13625,12.2,-4973,62695,56.2,15044,47651,59004,52.8,12868,-1023,46136,3691,-1329,-1.2,1115872
1391,T001038,Total male and female,PV31  ,Limburg (PV),2021JJ00,2021,1115872,520,9435,8.4,13925,12.5,-4490,64465,57.7,16356,48109,57480,51.5,12323,-1455,45157,6985,2430,2.2,1118302
1392,T001038,Total male and female,PV31  ,Limburg (PV),2022JJ00,2022,1118302,521,8923,7.9,13022,11.6,-4099,72101,64.2,25182,46919,57906,51.5,14519,-1652,43387,14195,10065,9,1128367
1393,T001038,Total male and female,PV31  ,Limburg (PV),2023JJ00,2023,1128367,526,8781,7.8,13234,11.7,-4453,69141,61.1,21955,47186,59766,52.9,15247,-2194,44519,9375,4888,4.3,1133255
1464,T001038,Total male and female,CR01  ,Oost-Groningen (CR),2012JJ00,2012,150782,182,1353,9,1691,11.3,-338,6495,43.2,635,5860,7093,47.2,638,-210,6455,-598,-944,-6.3,149838
1465,T001038,Total male and female,CR01  ,Oost-Groningen (CR),2013JJ00,2013,149838,182,1269,8.5,1730,11.6,-461,6350,42.5,998,5352,6784,45.4,556,-101,6228,-434,-894,-6,148944
1466,T001038,Total male and female,CR01  ,Oost-Groningen (CR),2014JJ00,2014,148944,180,1258,8.4,1651,11.1,-393,8340,56,2799,5541,7912,53.1,544,-105,7368,428,22,0.1,148966
1467,T001038,Total male and female,CR01  ,Oost-Groningen (CR),2015JJ00,2015,148966,180,1224,8.2,1689,11.4,-465,11256,75.7,5092,6164,11175,75.1,676,-199,10499,81,-383,-2.6,148583
1468,T001038,Total male and female,CR01  ,Oost-Groningen (CR),2016JJ00,2016,148583,180,1299,8.8,1779,12,-480,11951,80.8,4926,7025,12652,85.5,557,-138,12095,-701,-1190,-8,147393
1469,T001038,Total male and female,CR01  ,Oost-Groningen (CR),2017JJ00,2017,147393,179,1158,7.9,1745,11.9,-587,9701,66,2221,7480,9716,66.1,613,-267,9103,-15,-610,-4.1,146783
1470,T001038,Total male and female,CR01  ,Oost-Groningen (CR),2018JJ00,2018,134770,181,1031,7.6,1699,12.6,-668,15521,115.1,9377,6144,14823,110,413,-51,14410,698,52,0.4,134822
1471,T001038,Total male and female,CR01  ,Oost-Groningen (CR),2019JJ00,2019,134822,181,1073,7.9,1611,11.9,-538,14956,110.8,8261,6695,14068,104.2,490,-144,13578,888,386,2.9,135208
1472,T001038,Total male and female,CR01  ,Oost-Groningen (CR),2020JJ00,2020,135208,181,1031,7.6,1662,12.3,-631,14268,105.3,7010,7258,13042,96.2,454,-116,12588,1226,631,4.7,135839
1473,T001038,Total male and female,CR01  ,Oost-Groningen (CR),2021JJ00,2021,135839,182,1078,7.9,1905,14,-827,21614,158.7,14282,7332,20110,147.6,333,-27,19777,1504,766,5.6,136605
1474,T001038,Total male and female,CR01  ,Oost-Groningen (CR),2022JJ00,2022,136605,183,1130,8.2,1775,12.9,-645,23788,173.4,16844,6944,22051,160.8,635,-164,21416,1737,1131,8.3,137736
1475,T001038,Total male and female,CR01  ,Oost-Groningen (CR),2023JJ00,2023,137736,185,1005,7.3,1843,13.4,-838,23784,172.6,17194,6590,22861,165.9,768,-205,22093,923,184,1.3,137920
1546,T001038,Total male and female,CR02  ,Delfzijl en omgeving (CR),2012JJ00,2012,48724,182,432,8.9,557,11.5,-125,2131,43.9,360,1771,2368,48.8,299,-164,2069,-237,-354,-7.3,48370
1547,T001038,Total male and female,CR02  ,Delfzijl en omgeving (CR),2013JJ00,2013,48370,181,384,8,563,11.7,-179,2067,42.9,362,1705,2300,47.8,240,-84,2060,-233,-412,-8.5,47958
1548,T001038,Total male and female,CR02  ,Delfzijl en omgeving (CR),2014JJ00,2014,47958,179,401,8.4,559,11.7,-158,2444,51.2,614,1830,2685,56.2,229,-61,2456,-241,-398,-8.3,47560
1549,T001038,Total male and female,CR02  ,Delfzijl en omgeving (CR),2015JJ00,2015,47560,178,371,7.8,584,12.3,-213,2571,54.3,598,1973,2811,59.4,220,-62,2591,-240,-449,-9.4,47111
1550,T001038,Total male and female,CR02  ,Delfzijl en omgeving (CR),2016JJ00,2016,47111,176,425,9,590,12.6,-165,2920,62.2,457,2463,3014,64.2,189,-60,2825,-94,-261,-5.5,46850
1551,T001038,Total male and female,CR02  ,Delfzijl en omgeving (CR),2017JJ00,2017,46850,175,380,8.2,558,12,-178,2556,54.8,236,2320,2831,60.7,188,-75,2643,-275,-454,-9.7,46396
1552,T001038,Total male and female,CR02  ,Delfzijl en omgeving (CR),2018JJ00,2018,46396,173,343,7.4,574,12.4,-231,2555,55.3,357,2198,2672,57.8,166,-34,2506,-117,-345,-7.4,46051
1553,T001038,Total male and female,CR02  ,Delfzijl en omgeving (CR),2019JJ00,2019,46051,172,383,8.3,551,12,-168,2619,57,393,2226,2651,57.7,184,-36,2467,-32,-194,-4.2,45857
1554,T001038,Total male and female,CR02  ,Delfzijl en omgeving (CR),2020JJ00,2020,45857,171,344,7.5,557,12.2,-213,2467,54,350,2117,2528,55.3,148,-10,2380,-61,-270,-5.9,45587
1555,T001038,Total male and female,CR02  ,Delfzijl en omgeving (CR),2021JJ00,2021,45587,170,416,9.1,640,14.1,-224,2059,45.3,291,1768,2034,44.7,193,-27,1841,25,-198,-4.3,45389
1556,T001038,Total male and female,CR02  ,Delfzijl en omgeving (CR),2022JJ00,2022,45389,169,356,7.8,589,13,-233,2642,58.2,508,2134,2409,53.1,252,-66,2157,233,5,0.1,45394
1557,T001038,Total male and female,CR02  ,Delfzijl en omgeving (CR),2023JJ00,2023,45394,169,392,8.7,579,12.8,-187,2219,49,330,1889,2323,51.3,213,-33,2110,-104,-288,-6.3,45106
1628,T001038,Total male and female,CR03  ,Overig Groningen (CR),2012JJ00,2012,381369,310,3819,10,3212,8.4,607,26095,68.2,5252,20843,24579,64.3,4521,-826,20058,1516,2128,5.6,383497
1629,T001038,Total male and female,CR03  ,Overig Groningen (CR),2013JJ00,2013,383497,311,3673,9.5,3094,8,579,26703,69.4,5234,21469,24958,64.9,4401,-941,20557,1745,2329,6.1,385826
1630,T001038,Total male and female,CR03  ,Overig Groningen (CR),2014JJ00,2014,385826,313,3755,9.7,3115,8.1,640,27939,72.3,5564,22375,26995,69.8,5162,-1360,21833,944,1590,4.1,387416
1631,T001038,Total male and female,CR03  ,Overig Groningen (CR),2015JJ00,2015,387416,315,3734,9.6,3208,8.3,526,28536,73.6,5921,22615,28468,73.4,4922,-1054,23546,68,611,1.6,388027
1632,T001038,Total male and female,CR03  ,Overig Groningen (CR),2016JJ00,2016,388027,315,3682,9.5,3214,8.3,468,31039,79.9,6773,24266,30189,77.7,5229,-1169,24960,850,1311,3.4,389338
1633,T001038,Total male and female,CR03  ,Overig Groningen (CR),2017JJ00,2017,389338,316,3554,9.1,3361,8.6,193,30720,78.9,6586,24134,30475,78.2,5350,-1221,25125,245,427,1.1,389765
1634,T001038,Total male and female,CR03  ,Overig Groningen (CR),2018JJ00,2018,401778,306,3559,8.8,3377,8.4,182,30415,75.6,7364,23051,29252,72.7,5030,-714,24222,1163,1339,3.3,403117
1635,T001038,Total male and female,CR03  ,Overig Groningen (CR),2019JJ00,2019,403117,307,3586,8.9,3338,8.3,248,28088,69.5,8010,20078,26631,65.9,5565,-872,21066,1457,1684,4.2,404801
1636,T001038,Total male and female,CR03  ,Overig Groningen (CR),2020JJ00,2020,404801,309,3581,8.8,3497,8.6,84,27220,67.2,6683,20537,26582,65.6,5804,-941,20778,638,710,1.8,405511
1637,T001038,Total male and female,CR03  ,Overig Groningen (CR),2021JJ00,2021,405511,309,3812,9.4,3656,9,156,27967,68.7,8002,19965,25437,62.5,5139,-673,20298,2530,2665,6.6,408176
1638,T001038,Total male and female,CR03  ,Overig Groningen (CR),2022JJ00,2022,408176,313,3508,8.5,3828,9.3,-320,30860,75.2,11298,19562,25752,62.7,5574,-434,20178,5108,4769,11.7,412945
1639,T001038,Total male and female,CR03  ,Overig Groningen (CR),2023JJ00,2023,412945,317,3446,8.3,3757,9,-311,32970,79.3,9192,23778,27262,65.6,6483,-774,20779,5708,5376,13,418321
1710,T001038,Total male and female,CR04  ,Noord-Friesland (CR),2012JJ00,2012,332742,204,3484,10.5,2979,9,505,14997,45.1,2039,12958,15307,46,1701,-56,13606,-310,196,0.6,332938
1711,T001038,Total male and female,CR04  ,Noord-Friesland (CR),2013JJ00,2013,332938,206,3289,9.9,2977,8.9,312,15629,47,2104,13525,16074,48.3,1781,-149,14293,-445,-116,-0.3,332822
1712,T001038,Total male and female,CR04  ,Noord-Friesland (CR),2014JJ00,2014,324368,211,3244,10,2863,8.8,381,15785,48.7,2310,13475,16414,50.6,1918,-222,14496,-629,-265,-0.8,324103
1713,T001038,Total male and female,CR04  ,Noord-Friesland (CR),2015JJ00,2015,324103,210,3086,9.5,2934,9.1,152,16103,49.7,2299,13804,16276,50.2,1538,-65,14738,-173,-26,-0.1,324077
1714,T001038,Total male and female,CR04  ,Noord-Friesland (CR),2016JJ00,2016,324077,210,3118,9.6,3052,9.4,66,17537,54.1,2262,15275,17307,53.4,1626,-70,15681,230,290,0.9,324367
1715,T001038,Total male and female,CR04  ,Noord-Friesland (CR),2017JJ00,2017,324367,211,3101,9.6,3133,9.7,-32,17971,55.4,2234,15737,17968,55.4,1962,-399,16006,3,-37,-0.1,324330
1716,T001038,Total male and female,CR04  ,Noord-Friesland (CR),2018JJ00,2018,318919,215,2946,9.2,3098,9.7,-152,16759,52.5,2647,14112,16251,50.9,1809,-241,14442,508,358,1.1,319277
1717,T001038,Total male and female,CR04  ,Noord-Friesland (CR),2019JJ00,2019,319277,215,2984,9.3,3045,9.5,-61,17146,53.6,2940,14206,15712,49.1,1730,-131,13982,1434,1370,4.3,320647
1718,T001038,Total male and female,CR04  ,Noord-Friesland (CR),2020JJ00,2020,320647,216,2900,9,3082,9.6,-182,16696,52,2317,14379,15588,48.5,1795,-219,13793,1108,915,2.9,321562
1719,T001038,Total male and female,CR04  ,Noord-Friesland (CR),2021JJ00,2021,321562,216,3220,10,3540,11,-320,17087,53,2309,14778,14959,46.4,1659,-336,13300,2128,1797,5.6,323359
1720,T001038,Total male and female,CR04  ,Noord-Friesland (CR),2022JJ00,2022,323359,217,2939,9,3378,10.4,-439,18883,58.1,4985,13898,15210,46.8,2353,-428,12857,3673,3224,10,326583
1721,T001038,Total male and female,CR04  ,Noord-Friesland (CR),2023JJ00,2023,326583,219,2947,9,3320,10.1,-373,19289,58.9,4164,15125,16748,51.1,2875,-750,13873,2541,2153,6.6,328736
1792,T001038,Total male and female,CR05  ,Zuidwest-Friesland (CR),2012JJ00,2012,106392,176,1048,9.8,990,9.3,58,3111,29.2,348,2763,3157,29.7,342,-59,2815,-46,9,0.1,106401
1793,T001038,Total male and female,CR05  ,Zuidwest-Friesland (CR),2013JJ00,2013,106401,177,1048,9.9,1041,9.8,7,3157,29.7,333,2824,3316,31.2,312,-24,3004,-159,-164,-1.5,106237
1794,T001038,Total male and female,CR05  ,Zuidwest-Friesland (CR),2014JJ00,2014,135594,168,1214,9,1167,8.6,47,4086,30.2,432,3654,4331,32,397,-53,3934,-245,-217,-1.6,135377
1795,T001038,Total male and female,CR05  ,Zuidwest-Friesland (CR),2015JJ00,2015,135377,168,1188,8.8,1272,9.4,-84,4238,31.3,398,3840,4226,31.2,333,-4,3893,12,-64,-0.5,135313
1796,T001038,Total male and female,CR05  ,Zuidwest-Friesland (CR),2016JJ00,2016,135313,168,1273,9.4,1263,9.3,10,5064,37.4,491,4573,4639,34.2,365,-22,4274,425,430,3.2,135743
1797,T001038,Total male and female,CR05  ,Zuidwest-Friesland (CR),2017JJ00,2017,135743,168,1188,8.7,1226,9,-38,5694,41.9,567,5127,5481,40.4,410,-77,5071,213,182,1.3,135925
1798,T001038,Total male and female,CR05  ,Zuidwest-Friesland (CR),2018JJ00,2018,141336,162,1208,8.6,1416,10,-208,5298,37.5,693,4605,5286,37.4,467,-94,4819,12,-196,-1.4,141140
1799,T001038,Total male and female,CR05  ,Zuidwest-Friesland (CR),2019JJ00,2019,141140,161,1319,9.3,1352,9.6,-33,5391,38.1,640,4751,4950,35,440,-83,4510,441,411,2.9,141551
1800,T001038,Total male and female,CR05  ,Zuidwest-Friesland (CR),2020JJ00,2020,141551,162,1292,9.1,1410,10,-118,5498,38.8,498,5000,5153,36.4,336,-58,4817,345,226,1.6,141777
1801,T001038,Total male and female,CR05  ,Zuidwest-Friesland (CR),2021JJ00,2021,141777,162,1332,9.4,1530,10.8,-198,6031,42.5,507,5524,5713,40.3,356,-41,5357,318,120,0.8,141897
1802,T001038,Total male and female,CR05  ,Zuidwest-Friesland (CR),2022JJ00,2022,141897,162,1230,8.6,1570,11,-340,6932,48.7,1556,5376,5613,39.4,630,-77,4983,1319,978,6.9,142875
1803,T001038,Total male and female,CR05  ,Zuidwest-Friesland (CR),2023JJ00,2023,142875,163,1185,8.3,1573,11,-388,5855,41.1,737,5118,5996,42,640,-81,5356,-141,-525,-3.7,142350
1874,T001038,Total male and female,CR06  ,Zuidoost-Friesland (CR),2012JJ00,2012,208080,188,1970,9.5,1913,9.2,57,7544,36.3,759,6785,8167,39.3,663,-149,7504,-623,-557,-2.7,207523
1875,T001038,Total male and female,CR06  ,Zuidoost-Friesland (CR),2013JJ00,2013,207523,187,1926,9.3,1919,9.3,7,7765,37.4,822,6943,8080,39,528,-58,7552,-315,-265,-1.3,207258
1876,T001038,Total male and female,CR06  ,Zuidoost-Friesland (CR),2014JJ00,2014,186355,191,1852,9.9,1753,9.4,99,8098,43.4,1001,7097,7787,41.7,552,-115,7235,311,422,2.3,186777
1877,T001038,Total male and female,CR06  ,Zuidoost-Friesland (CR),2015JJ00,2015,186777,191,1737,9.3,1853,9.9,-116,8088,43.3,893,7195,8100,43.4,564,-58,7536,-12,-127,-0.7,186650
1878,T001038,Total male and female,CR06  ,Zuidoost-Friesland (CR),2016JJ00,2016,186650,191,1626,8.7,1971,10.6,-345,8890,47.6,830,8060,8428,45.1,636,-124,7792,462,114,0.6,186764
1879,T001038,Total male and female,CR06  ,Zuidoost-Friesland (CR),2017JJ00,2017,186764,191,1678,9,1905,10.2,-227,9022,48.3,668,8354,8542,45.7,552,-92,7990,480,249,1.3,187013
1880,T001038,Total male and female,CR06  ,Zuidoost-Friesland (CR),2018JJ00,2018,187013,192,1625,8.7,1912,10.2,-287,8912,47.6,700,8212,8383,44.8,537,-82,7846,529,242,1.3,187255
1881,T001038,Total male and female,CR06  ,Zuidoost-Friesland (CR),2019JJ00,2019,187255,192,1654,8.8,1859,9.9,-205,8865,47.3,917,7948,8154,43.5,506,-42,7648,711,504,2.7,187759
1882,T001038,Total male and female,CR06  ,Zuidoost-Friesland (CR),2020JJ00,2020,187759,192,1649,8.8,1961,10.4,-312,8761,46.6,698,8063,8107,43.1,401,-57,7706,654,337,1.8,188096
1883,T001038,Total male and female,CR06  ,Zuidoost-Friesland (CR),2021JJ00,2021,188096,193,1767,9.4,1999,10.6,-232,8910,47.3,533,8377,8004,42.5,505,-156,7499,906,667,3.5,188763
1884,T001038,Total male and female,CR06  ,Zuidoost-Friesland (CR),2022JJ00,2022,188763,194,1632,8.6,2150,11.3,-518,9757,51.5,1707,8050,7899,41.7,753,-131,7146,1858,1330,7,190093
1885,T001038,Total male and female,CR06  ,Zuidoost-Friesland (CR),2023JJ00,2023,190093,195,1566,8.2,2140,11.2,-574,9550,50.1,1303,8247,8238,43.3,773,-148,7465,1312,725,3.8,190818
1956,T001038,Total male and female,CR07  ,Noord-Drenthe (CR),2012JJ00,2012,189816,182,1693,8.9,1839,9.7,-146,7775,41,565,7210,7800,41.1,560,-63,7240,-25,-169,-0.9,189647
1957,T001038,Total male and female,CR07  ,Noord-Drenthe (CR),2013JJ00,2013,189647,182,1572,8.3,1786,9.4,-214,7918,41.8,640,7278,7862,41.5,470,51,7392,56,-154,-0.8,189493
1958,T001038,Total male and female,CR07  ,Noord-Drenthe (CR),2014JJ00,2014,189493,182,1637,8.6,1686,8.9,-49,8141,43,621,7520,8231,43.5,538,-21,7693,-90,-134,-0.7,189359
1959,T001038,Total male and female,CR07  ,Noord-Drenthe (CR),2015JJ00,2015,189359,182,1506,7.9,1948,10.3,-442,10039,53,1343,8696,9355,49.4,587,-17,8768,684,238,1.3,189597
1960,T001038,Total male and female,CR07  ,Noord-Drenthe (CR),2016JJ00,2016,189597,182,1608,8.4,1888,9.9,-280,20196,105.7,10186,10010,17027,89.1,603,-25,16424,3169,2900,15.3,192497
1961,T001038,Total male and female,CR07  ,Noord-Drenthe (CR),2017JJ00,2017,192497,185,1598,8.3,1995,10.4,-397,28237,146.8,17830,10407,28216,146.7,569,-104,27647,21,-395,-2.1,192102
1962,T001038,Total male and female,CR07  ,Noord-Drenthe (CR),2018JJ00,2018,192102,185,1575,8.2,2068,10.8,-493,10904,56.8,810,10094,10974,57.2,552,-38,10422,-70,-587,-3.1,191515
1963,T001038,Total male and female,CR07  ,Noord-Drenthe (CR),2019JJ00,2019,191515,184,1526,8,1987,10.4,-461,10935,57,1173,9762,9614,50.1,464,2,9150,1321,854,4.5,192369
1964,T001038,Total male and female,CR07  ,Noord-Drenthe (CR),2020JJ00,2020,192369,185,1603,8.3,2152,11.2,-549,10812,56.1,686,10126,9821,51,391,-17,9430,991,439,2.3,192808
1965,T001038,Total male and female,CR07  ,Noord-Drenthe (CR),2021JJ00,2021,192808,185,1723,8.9,2184,11.3,-461,11076,57.3,570,10506,9704,50.2,535,-102,9169,1372,898,4.7,193706
1966,T001038,Total male and female,CR07  ,Noord-Drenthe (CR),2022JJ00,2022,193706,186,1577,8.1,2248,11.6,-671,12174,62.6,2299,9875,9900,50.9,832,-87,9068,2274,1602,8.3,195308
1967,T001038,Total male and female,CR07  ,Noord-Drenthe (CR),2023JJ00,2023,195308,188,1579,8.1,2208,11.3,-629,11649,59.5,1466,10183,10261,52.4,1002,-296,9259,1388,752,3.9,196060
2038,T001038,Total male and female,CR08  ,Zuidoost-Drenthe (CR),2012JJ00,2012,170578,188,1467,8.6,1755,10.3,-288,6061,35.6,1025,5036,6527,38.3,891,-321,5636,-466,-759,-4.4,169819
2039,T001038,Total male and female,CR08  ,Zuidoost-Drenthe (CR),2013JJ00,2013,169819,187,1403,8.3,1710,10.1,-307,6093,35.9,1055,5038,6156,36.3,736,-244,5420,-63,-371,-2.2,169448
2040,T001038,Total male and female,CR08  ,Zuidoost-Drenthe (CR),2014JJ00,2014,169448,187,1412,8.3,1707,10.1,-295,5814,34.4,1049,4765,6147,36.3,740,-201,5407,-333,-636,-3.8,168812
2041,T001038,Total male and female,CR08  ,Zuidoost-Drenthe (CR),2015JJ00,2015,168812,186,1334,7.9,1761,10.4,-427,6477,38.4,1095,5382,6516,38.7,736,-234,5780,-39,-476,-2.8,168336
2042,T001038,Total male and female,CR08  ,Zuidoost-Drenthe (CR),2016JJ00,2016,168336,186,1415,8.4,1839,10.9,-424,6878,40.9,1037,5841,6664,39.6,695,-136,5969,214,-205,-1.2,168131
2043,T001038,Total male and female,CR08  ,Zuidoost-Drenthe (CR),2017JJ00,2017,168131,186,1364,8.1,1836,10.9,-472,7336,43.7,730,6606,7147,42.5,560,-84,6587,189,-289,-1.7,167842
2044,T001038,Total male and female,CR08  ,Zuidoost-Drenthe (CR),2018JJ00,2018,167842,185,1299,7.7,1858,11.1,-559,7329,43.6,808,6521,6639,39.5,524,-30,6115,690,126,0.8,167968
2045,T001038,Total male and female,CR08  ,Zuidoost-Drenthe (CR),2019JJ00,2019,167968,185,1401,8.3,1843,11,-442,7383,44,852,6531,6967,41.5,782,-235,6185,416,-64,-0.4,167904
2046,T001038,Total male and female,CR08  ,Zuidoost-Drenthe (CR),2020JJ00,2020,167904,185,1363,8.1,1970,11.7,-607,7201,42.9,609,6592,6527,38.9,556,-91,5971,674,35,0.2,167939
2047,T001038,Total male and female,CR08  ,Zuidoost-Drenthe (CR),2021JJ00,2021,167939,185,1445,8.6,2084,12.4,-639,7921,47,631,7290,6143,36.5,558,-158,5585,1778,1115,6.6,169054
2048,T001038,Total male and female,CR08  ,Zuidoost-Drenthe (CR),2022JJ00,2022,169054,187,1355,8,2151,12.7,-796,8442,49.7,1782,6660,6280,37,708,-167,5572,2162,1330,7.9,170384
2049,T001038,Total male and female,CR08  ,Zuidoost-Drenthe (CR),2023JJ00,2023,170384,188,1345,7.9,2065,12.1,-720,8256,48.4,1536,6720,6797,39.8,997,-199,5800,1459,701,4.1,171085
2120,T001038,Total male and female,CR09  ,Zuidwest-Drenthe (CR),2012JJ00,2012,130413,190,1246,9.6,1246,9.6,0,4727,36.2,403,4324,4691,36,276,25,4415,36,39,0.3,130452
2121,T001038,Total male and female,CR09  ,Zuidwest-Drenthe (CR),2013JJ00,2013,130452,190,1199,9.2,1293,9.9,-94,4369,33.5,376,3993,4675,35.9,334,-26,4341,-306,-405,-3.1,130047
2122,T001038,Total male and female,CR09  ,Zuidwest-Drenthe (CR),2014JJ00,2014,130047,189,1253,9.6,1224,9.4,29,5104,39.2,529,4575,4785,36.7,374,-26,4411,319,358,2.8,130405
2123,T001038,Total male and female,CR09  ,Zuidwest-Drenthe (CR),2015JJ00,2015,130405,190,1189,9.1,1266,9.7,-77,6093,46.7,1345,4748,5728,43.9,388,-30,5340,365,291,2.2,130696
2124,T001038,Total male and female,CR09  ,Zuidwest-Drenthe (CR),2016JJ00,2016,130696,190,1185,9.1,1357,10.4,-172,7066,54,1073,5993,6424,49.1,373,-62,6051,642,468,3.6,131164
2125,T001038,Total male and female,CR09  ,Zuidwest-Drenthe (CR),2017JJ00,2017,131164,191,1229,9.3,1371,10.4,-142,6969,52.9,642,6327,5830,44.3,302,5,5528,1139,992,7.6,132156
2126,T001038,Total male and female,CR09  ,Zuidwest-Drenthe (CR),2018JJ00,2018,132156,193,1118,8.4,1414,10.7,-296,6883,52,843,6040,6063,45.8,568,-192,5495,820,528,4,132684
2127,T001038,Total male and female,CR09  ,Zuidwest-Drenthe (CR),2019JJ00,2019,132684,193,1183,8.9,1313,9.9,-130,6645,49.9,675,5970,5787,43.5,421,-57,5366,858,725,5.5,133409
2128,T001038,Total male and female,CR09  ,Zuidwest-Drenthe (CR),2020JJ00,2020,133409,194,1169,8.7,1429,10.7,-260,6685,50,595,6090,5817,43.5,335,-48,5482,868,615,4.6,134024
2129,T001038,Total male and female,CR09  ,Zuidwest-Drenthe (CR),2021JJ00,2021,134024,195,1275,9.5,1608,12,-333,7094,52.7,664,6430,5798,43.1,439,-108,5359,1296,959,7.2,134983
2130,T001038,Total male and female,CR09  ,Zuidwest-Drenthe (CR),2022JJ00,2022,134983,197,1104,8.1,1631,12,-527,7869,58,1748,6121,5971,44,641,-149,5330,1898,1376,10.2,136359
2131,T001038,Total male and female,CR09  ,Zuidwest-Drenthe (CR),2023JJ00,2023,136359,199,1117,8.2,1522,11.1,-405,7441,54.4,1168,6273,6404,46.9,786,-223,5618,1037,625,4.6,136984
2202,T001038,Total male and female,CR10  ,Noord-Overijssel (CR),2012JJ00,2012,358148,252,4466,12.4,2672,7.4,1794,12742,35.5,1476,11266,12876,35.9,1363,-215,11513,-134,1658,4.6,359806
2203,T001038,Total male and female,CR10  ,Noord-Overijssel (CR),2013JJ00,2013,359806,254,4324,12,2727,7.6,1597,12515,34.7,1462,11053,13175,36.6,1428,-203,11747,-660,941,2.6,360747
2204,T001038,Total male and female,CR10  ,Noord-Overijssel (CR),2014JJ00,2014,360747,254,4319,12,2813,7.8,1506,13264,36.7,1471,11793,13834,38.3,1483,-237,12351,-570,947,2.6,361694
2205,T001038,Total male and female,CR10  ,Noord-Overijssel (CR),2015JJ00,2015,361694,255,4211,11.6,2853,7.9,1358,15216,41.9,2086,13130,13987,38.5,1339,-112,12648,1229,2606,7.2,364300
2206,T001038,Total male and female,CR10  ,Noord-Overijssel (CR),2016JJ00,2016,364300,257,4250,11.6,2898,7.9,1352,15895,43.5,1697,14198,15219,41.7,1478,-102,13741,676,2019,5.5,366319
2207,T001038,Total male and female,CR10  ,Noord-Overijssel (CR),2017JJ00,2017,366319,258,4091,11.1,2960,8.1,1131,16878,45.9,1761,15117,15504,42.2,1365,-171,14139,1374,2500,6.8,368819
2208,T001038,Total male and female,CR10  ,Noord-Overijssel (CR),2018JJ00,2018,368819,261,4081,11,3081,8.3,1000,17172,46.4,1945,15227,15385,41.6,1392,-115,13993,1787,2789,7.6,371608
2209,T001038,Total male and female,CR10  ,Noord-Overijssel (CR),2019JJ00,2019,371608,263,4118,11,2942,7.9,1176,16687,44.7,2291,14396,14801,39.7,1491,-174,13310,1886,3051,8.2,374659
2210,T001038,Total male and female,CR10  ,Noord-Overijssel (CR),2020JJ00,2020,374659,265,4092,10.9,3258,8.7,834,16785,44.6,1878,14907,14975,39.8,1233,-150,13742,1810,2633,7,377292
2211,T001038,Total male and female,CR10  ,Noord-Overijssel (CR),2021JJ00,2021,377292,267,4232,11.2,3278,8.7,954,16543,43.7,1767,14776,14860,39.2,1351,-223,13509,1683,2619,6.9,379911
2212,T001038,Total male and female,CR10  ,Noord-Overijssel (CR),2022JJ00,2022,379911,269,4127,10.8,3413,8.9,714,20298,53,5126,15172,15457,40.4,2126,-269,13331,4841,5562,14.6,385473
2213,T001038,Total male and female,CR10  ,Noord-Overijssel (CR),2023JJ00,2023,385473,273,3889,10.1,3265,8.4,624,18029,46.6,3109,14920,16485,42.6,2195,-405,14290,1544,2150,5.6,387623
2284,T001038,Total male and female,CR11  ,Zuidwest-Overijssel (CR),2012JJ00,2012,152934,367,1651,10.8,1265,8.3,386,5638,36.9,1202,4436,6144,40.2,894,-198,5250,-506,-116,-0.8,152818
2285,T001038,Total male and female,CR11  ,Zuidwest-Overijssel (CR),2013JJ00,2013,152818,367,1563,10.2,1314,8.6,249,5871,38.4,1261,4610,6329,41.4,1102,-375,5227,-458,-207,-1.4,152611
2286,T001038,Total male and female,CR11  ,Zuidwest-Overijssel (CR),2014JJ00,2014,152611,367,1569,10.3,1309,8.6,260,6426,42.1,1457,4969,6314,41.3,921,-211,5393,112,371,2.4,152982
2287,T001038,Total male and female,CR11  ,Zuidwest-Overijssel (CR),2015JJ00,2015,152982,367,1463,9.5,1338,8.7,125,6925,45.2,1377,5548,6573,42.9,850,-97,5723,352,473,3.1,153455
2288,T001038,Total male and female,CR11  ,Zuidwest-Overijssel (CR),2016JJ00,2016,153455,369,1559,10.1,1308,8.5,251,7456,48.5,1330,6126,6998,45.5,1090,-426,5908,458,704,4.6,154159
2289,T001038,Total male and female,CR11  ,Zuidwest-Overijssel (CR),2017JJ00,2017,154159,370,1476,9.6,1428,9.2,48,7724,50,1099,6625,7095,45.9,842,-188,6253,629,675,4.4,154834
2290,T001038,Total male and female,CR11  ,Zuidwest-Overijssel (CR),2018JJ00,2018,154834,373,1484,9.6,1459,9.4,25,7382,47.6,1260,6122,6707,43.2,730,-115,5977,675,705,4.6,155539
2291,T001038,Total male and female,CR11  ,Zuidwest-Overijssel (CR),2019JJ00,2019,155539,374,1453,9.3,1476,9.5,-23,7599,48.7,1401,6198,6423,41.1,883,-145,5540,1176,1144,7.4,156683
2292,T001038,Total male and female,CR11  ,Zuidwest-Overijssel (CR),2020JJ00,2020,156683,377,1489,9.5,1628,10.4,-139,7424,47.3,984,6440,6462,41.1,597,-32,5865,962,825,5.3,157508
2293,T001038,Total male and female,CR11  ,Zuidwest-Overijssel (CR),2021JJ00,2021,157508,379,1512,9.6,1584,10,-72,7212,45.7,998,6214,6571,41.6,747,-116,5824,641,574,3.6,158082
2294,T001038,Total male and female,CR11  ,Zuidwest-Overijssel (CR),2022JJ00,2022,158082,381,1532,9.6,1600,10.1,-68,8106,51,1930,6176,6151,38.7,732,-84,5419,1955,1881,11.9,159963
2295,T001038,Total male and female,CR11  ,Zuidwest-Overijssel (CR),2023JJ00,2023,159963,385,1436,9,1624,10.1,-188,7768,48.5,1492,6276,6931,43.2,1156,-331,5775,837,641,4,160604
2366,T001038,Total male and female,CR12  ,Twente (CR),2012JJ00,2012,626586,421,6250,10,5484,8.8,766,21982,35.1,4195,17787,22605,36.1,3902,-689,18703,-623,140,0.2,626726
2367,T001038,Total male and female,CR12  ,Twente (CR),2013JJ00,2013,626726,421,6264,10,5712,9.1,552,21466,34.3,3902,17564,22415,35.8,4053,-677,18362,-949,-387,-0.6,626339
2368,T001038,Total male and female,CR12  ,Twente (CR),2014JJ00,2014,626339,421,6204,9.9,5501,8.8,703,22128,35.3,3962,18166,23179,37,4094,-701,19085,-1051,-363,-0.6,625976
2369,T001038,Total male and female,CR12  ,Twente (CR),2015JJ00,2015,625976,420,6091,9.7,5794,9.3,297,24004,38.3,5212,18792,23742,37.9,4078,-642,19664,262,549,0.9,626525
2370,T001038,Total male and female,CR12  ,Twente (CR),2016JJ00,2016,626525,421,5919,9.4,5928,9.5,-9,26647,42.5,5143,21504,25944,41.4,4027,-745,21917,703,684,1.1,627209
2371,T001038,Total male and female,CR12  ,Twente (CR),2017JJ00,2017,627209,421,5778,9.2,5866,9.3,-88,26841,42.8,4869,21972,26101,41.6,3824,-527,22277,740,639,1,627848
2372,T001038,Total male and female,CR12  ,Twente (CR),2018JJ00,2018,627848,422,5613,8.9,5970,9.5,-357,26332,41.9,5465,20867,24523,39,3692,-257,20831,1809,1436,2.3,629284
2373,T001038,Total male and female,CR12  ,Twente (CR),2019JJ00,2019,629284,423,5654,9,6060,9.6,-406,27273,43.3,6226,21047,25049,39.7,4239,-769,20810,2224,1780,2.8,631064
2374,T001038,Total male and female,CR12  ,Twente (CR),2020JJ00,2020,631064,424,5518,8.7,6676,10.6,-1158,26962,42.7,5373,21589,25120,39.8,3793,-685,21327,1842,669,1.1,631733
2375,T001038,Total male and female,CR12  ,Twente (CR),2021JJ00,2021,631733,424,5884,9.3,6826,10.8,-942,27470,43.4,5969,21501,24333,38.5,3848,-648,20485,3137,2184,3.5,633917
2376,T001038,Total male and female,CR12  ,Twente (CR),2022JJ00,2022,633917,426,5642,8.9,6706,10.5,-1064,31401,49.3,10149,21252,25321,39.8,4895,-791,20426,6080,4980,7.9,638897
2377,T001038,Total male and female,CR12  ,Twente (CR),2023JJ00,2023,638897,429,5610,8.8,6638,10.4,-1028,30442,47.6,7673,22769,27494,43,5360,-1199,22134,2948,1909,3,640806
2448,T001038,Total male and female,CR13  ,Veluwe (CR),2012JJ00,2012,659218,360,7129,10.8,5588,8.5,1541,26676,40.4,4004,22672,25512,38.6,3380,-640,22132,1164,2767,4.2,661985
2449,T001038,Total male and female,CR13  ,Veluwe (CR),2013JJ00,2013,661985,362,7066,10.7,5608,8.5,1458,27101,40.9,4247,22854,26491,40,4190,-1156,22301,610,2082,3.1,664067
2450,T001038,Total male and female,CR13  ,Veluwe (CR),2014JJ00,2014,664067,363,7123,10.7,5519,8.3,1604,29854,44.8,4693,25161,27622,41.5,4009,-581,23613,2232,3879,5.8,667946
2451,T001038,Total male and female,CR13  ,Veluwe (CR),2015JJ00,2015,667946,365,7091,10.6,5762,8.6,1329,31148,46.5,5258,25890,28426,42.4,4057,-761,24369,2722,4081,6.1,672027
2452,T001038,Total male and female,CR13  ,Veluwe (CR),2016JJ00,2016,672027,367,7238,10.7,6011,8.9,1227,33925,50.3,4852,29073,29515,43.7,4225,-756,25290,4410,5635,8.4,677662
2453,T001038,Total male and female,CR13  ,Veluwe (CR),2017JJ00,2017,677662,371,7080,10.4,5922,8.7,1158,35504,52.2,5424,30080,31045,45.6,4211,-891,26834,4459,5578,8.2,683240
2454,T001038,Total male and female,CR13  ,Veluwe (CR),2018JJ00,2018,683240,374,7150,10.4,6173,9,977,35638,51.9,5546,30092,31067,45.3,4174,-635,26893,4571,5559,8.1,688799
2455,T001038,Total male and female,CR13  ,Veluwe (CR),2019JJ00,2019,688799,377,7214,10.4,6279,9.1,935,36490,52.7,5860,30630,30717,44.4,4029,-587,26688,5773,6701,9.7,695500
2456,T001038,Total male and female,CR13  ,Veluwe (CR),2020JJ00,2020,695500,380,7304,10.5,6861,9.8,443,36399,52.1,4966,31433,31342,44.9,3529,-491,27813,5057,5475,7.9,700975
2457,T001038,Total male and female,CR13  ,Veluwe (CR),2021JJ00,2021,700975,383,7685,10.9,6880,9.8,805,35961,51.1,5274,30687,30842,43.8,3466,-542,27376,5119,5913,8.4,706888
2458,T001038,Total male and female,CR13  ,Veluwe (CR),2022JJ00,2022,706888,387,7248,10.2,7025,9.9,223,39510,55.5,10598,28912,30824,43.3,4512,-744,26312,8686,8904,12.6,715792
2459,T001038,Total male and female,CR13  ,Veluwe (CR),2023JJ00,2023,715792,392,6963,9.7,6787,9.4,176,39512,54.9,7765,31747,32959,45.8,5423,-1077,27536,6553,6701,9.4,722493
2530,T001038,Total male and female,CR14  ,Achterhoek (CR),2012JJ00,2012,401476,260,3334,8.3,3786,9.4,-452,14496,36.1,1546,12950,14795,36.9,1264,-242,13531,-299,-749,-1.9,400727
2531,T001038,Total male and female,CR14  ,Achterhoek (CR),2013JJ00,2013,400727,259,3251,8.1,3840,9.6,-589,14351,35.9,1603,12748,14799,37,1288,-154,13511,-448,-1020,-2.5,399707
2532,T001038,Total male and female,CR14  ,Achterhoek (CR),2014JJ00,2014,399707,259,3263,8.2,3765,9.4,-502,15120,37.9,1944,13176,15548,38.9,1304,-164,14244,-428,-935,-2.3,398772
2533,T001038,Total male and female,CR14  ,Achterhoek (CR),2015JJ00,2015,398772,258,3178,8,3957,9.9,-779,16625,41.7,2360,14265,15357,38.5,1141,-116,14216,1268,488,1.2,399260
2534,T001038,Total male and female,CR14  ,Achterhoek (CR),2016JJ00,2016,399260,258,3144,7.9,3990,10,-846,20837,52.1,4801,16036,19322,48.4,1227,-91,18095,1515,661,1.7,399921
2535,T001038,Total male and female,CR14  ,Achterhoek (CR),2017JJ00,2017,399921,259,3184,8,4146,10.4,-962,19375,48.4,1691,17684,17911,44.8,1267,-181,16644,1464,495,1.2,400416
2536,T001038,Total male and female,CR14  ,Achterhoek (CR),2018JJ00,2018,400416,259,3098,7.7,4198,10.5,-1100,18023,45,1841,16182,16655,41.6,1304,-176,15351,1368,269,0.7,400685
2537,T001038,Total male and female,CR14  ,Achterhoek (CR),2019JJ00,2019,400685,259,3231,8.1,4223,10.5,-992,18153,45.3,1915,16238,16640,41.5,1373,-282,15267,1513,508,1.3,401193
2538,T001038,Total male and female,CR14  ,Achterhoek (CR),2020JJ00,2020,401193,260,3205,8,4490,11.2,-1285,18377,45.7,1514,16863,16047,39.9,1096,-198,14951,2330,1046,2.6,402239
2539,T001038,Total male and female,CR14  ,Achterhoek (CR),2021JJ00,2021,402239,260,3325,8.3,4726,11.7,-1401,18551,46.1,1356,17195,15976,39.7,1142,-134,14834,2575,1157,2.9,403396
2540,T001038,Total male and female,CR14  ,Achterhoek (CR),2022JJ00,2022,403396,261,3119,7.7,4772,11.8,-1653,20292,50.1,3727,16565,15769,39,1765,-296,14004,4523,2865,7.1,406261
2541,T001038,Total male and female,CR14  ,Achterhoek (CR),2023JJ00,2023,406261,263,3232,8,4687,11.5,-1455,18993,46.7,2424,16569,16999,41.8,1840,-303,15159,1994,524,1.3,406785
2612,T001038,Total male and female,CR15  ,Arnhem/Nijmegen (CR),2012JJ00,2012,714049,794,7041,9.8,6161,8.6,880,38560,53.9,5093,33467,37098,51.9,5259,-1300,31839,1462,2342,3.3,716391
2613,T001038,Total male and female,CR15  ,Arnhem/Nijmegen (CR),2013JJ00,2013,716391,798,6918,9.6,6117,8.5,801,39155,54.6,5305,33850,37504,52.3,5185,-1140,32319,1651,2451,3.4,718842
2614,T001038,Total male and female,CR15  ,Arnhem/Nijmegen (CR),2014JJ00,2014,718842,801,7019,9.7,5915,8.2,1104,40830,56.7,5400,35430,38460,53.4,5014,-880,33446,2370,3470,4.8,722312
2615,T001038,Total male and female,CR15  ,Arnhem/Nijmegen (CR),2015JJ00,2015,722312,804,6888,9.5,6220,8.6,668,42708,59,6491,36217,39931,55.2,5034,-960,34897,2777,3447,4.8,725759
2616,T001038,Total male and female,CR15  ,Arnhem/Nijmegen (CR),2016JJ00,2016,725759,808,6689,9.2,6276,8.6,413,49558,68.1,8136,41422,45276,62.2,5311,-1034,39965,4282,4669,6.4,730428
2617,T001038,Total male and female,CR15  ,Arnhem/Nijmegen (CR),2017JJ00,2017,730428,814,6831,9.3,6580,9,251,50457,68.9,7737,42720,45889,62.6,5303,-1200,40586,4568,4775,6.5,735203
2618,T001038,Total male and female,CR15  ,Arnhem/Nijmegen (CR),2018JJ00,2018,735203,820,6654,9,6652,9,2,46881,63.6,8066,38815,43656,59.2,5457,-1171,38199,3225,3233,4.4,738436
2619,T001038,Total male and female,CR15  ,Arnhem/Nijmegen (CR),2019JJ00,2019,738436,824,6551,8.8,6610,8.9,-59,48682,65.7,10318,38364,44392,59.9,5579,-1188,38813,4290,4258,5.8,742694
2620,T001038,Total male and female,CR15  ,Arnhem/Nijmegen (CR),2020JJ00,2020,742694,829,6834,9.2,7265,9.8,-431,46641,62.7,7832,38809,44172,59.4,4884,-912,39288,2469,2021,2.7,744715
2621,T001038,Total male and female,CR15  ,Arnhem/Nijmegen (CR),2021JJ00,2021,744715,831,6989,9.4,7315,9.8,-326,47819,64,9061,38758,42988,57.6,4386,-1017,38602,4831,4505,6,749220
2622,T001038,Total male and female,CR15  ,Arnhem/Nijmegen (CR),2022JJ00,2022,749220,837,6668,8.9,7410,9.8,-742,52871,70.2,14738,38133,44333,58.9,5568,-1073,38765,8538,7775,10.4,756995
2623,T001038,Total male and female,CR15  ,Arnhem/Nijmegen (CR),2023JJ00,2023,756995,845,6651,8.7,7324,9.6,-673,54590,71.8,13603,40987,46773,61.5,6255,-1383,40518,7817,7143,9.4,764138
2694,T001038,Total male and female,CR16  ,Zuidwest-Gelderland (CR),2012JJ00,2012,236002,339,2331,9.9,1800,7.6,531,8594,36.4,1118,7476,8442,35.7,736,-75,7706,152,686,2.9,236688
2695,T001038,Total male and female,CR16  ,Zuidwest-Gelderland (CR),2013JJ00,2013,236688,340,2448,10.3,1761,7.4,687,8401,35.5,1138,7263,8697,36.7,841,-68,7856,-296,388,1.6,237076
2696,T001038,Total male and female,CR16  ,Zuidwest-Gelderland (CR),2014JJ00,2014,237076,341,2446,10.3,1827,7.7,619,9045,38.1,1242,7803,9197,38.8,891,-48,8306,-152,472,2,237548
2697,T001038,Total male and female,CR16  ,Zuidwest-Gelderland (CR),2015JJ00,2015,237548,341,2368,10,1951,8.2,417,9899,41.6,1266,8633,9566,40.2,966,-119,8600,333,757,3.2,238305
2698,T001038,Total male and female,CR16  ,Zuidwest-Gelderland (CR),2016JJ00,2016,238305,343,2428,10.2,1847,7.7,581,11146,46.6,1239,9907,10129,42.4,892,-88,9237,1017,1585,6.7,239890
2699,T001038,Total male and female,CR16  ,Zuidwest-Gelderland (CR),2017JJ00,2017,239890,345,2439,10.1,1969,8.2,470,12264,51,1334,10930,11377,47.3,1015,-154,10362,887,1354,5.6,241244
2700,T001038,Total male and female,CR16  ,Zuidwest-Gelderland (CR),2018JJ00,2018,241244,347,2445,10.1,1994,8.2,451,13304,54.8,2772,10532,10955,45.1,1064,-155,9891,2349,2808,11.6,244052
2701,T001038,Total male and female,CR16  ,Zuidwest-Gelderland (CR),2019JJ00,2019,244052,351,2430,9.9,1967,8,463,13140,53.6,2716,10424,11076,45.2,1546,-409,9530,2064,2513,10.3,246565
2702,T001038,Total male and female,CR16  ,Zuidwest-Gelderland (CR),2020JJ00,2020,246565,355,2542,10.3,2327,9.4,215,14155,57.2,3089,11066,12254,49.5,2244,-605,10010,1901,2109,8.6,248674
2703,T001038,Total male and female,CR16  ,Zuidwest-Gelderland (CR),2021JJ00,2021,248674,358,2772,11.1,2366,9.5,406,13950,55.8,2986,10964,12063,48.3,2224,-485,9839,1887,2294,9.2,250968
2704,T001038,Total male and female,CR16  ,Zuidwest-Gelderland (CR),2022JJ00,2022,250968,363,2528,10,2274,9,254,16103,63.7,5425,10678,12656,50.1,3002,-834,9654,3447,3692,14.7,254660
2705,T001038,Total male and female,CR16  ,Zuidwest-Gelderland (CR),2023JJ00,2023,254660,368,2551,10,2159,8.5,392,14056,55.1,3550,10506,13445,52.7,3216,-1340,10229,611,995,3.9,255655
2776,T001038,Total male and female,CR17  ,Utrecht (CR),2012JJ00,2012,1237117,894,14878,12,8933,7.2,5945,62452,50.3,9387,53065,60177,48.5,8740,-1255,51437,2275,8177,6.6,1245294
2777,T001038,Total male and female,CR17  ,Utrecht (CR),2013JJ00,2013,1245294,901,14313,11.5,9101,7.3,5212,63826,51.1,9930,53896,60711,48.6,9017,-895,51694,3115,8378,6.7,1253672
2778,T001038,Total male and female,CR17  ,Utrecht (CR),2014JJ00,2014,1253672,907,14821,11.8,9087,7.2,5734,70317,55.9,10698,59619,66179,52.6,9025,-760,57154,4138,9900,7.9,1263572
2779,T001038,Total male and female,CR17  ,Utrecht (CR),2015JJ00,2015,1263572,914,14371,11.3,9484,7.5,4887,75636,59.6,11886,63750,70480,55.6,9292,-1011,61188,5156,10041,7.9,1273613
2780,T001038,Total male and female,CR17  ,Utrecht (CR),2016JJ00,2016,1273613,923,14465,11.3,9609,7.5,4856,80496,62.9,12337,68159,74478,58.2,8476,-720,66002,6018,10891,8.6,1284504
2781,T001038,Total male and female,CR17  ,Utrecht (CR),2017JJ00,2017,1284504,931,14532,11.3,9701,7.5,4831,81093,62.9,12091,69002,74931,58.1,9015,-1107,65916,6162,10980,8.5,1295484
2782,T001038,Total male and female,CR17  ,Utrecht (CR),2018JJ00,2018,1295484,940,14354,11,9869,7.6,4485,80073,61.5,13205,66868,73127,56.2,9293,-841,63834,6946,11406,8.8,1306890
2783,T001038,Total male and female,CR17  ,Utrecht (CR),2019JJ00,2019,1342158,904,14935,11.1,10176,7.5,4759,82811,61.4,14980,67831,74849,55.5,9837,-882,65012,7962,12676,9.4,1354834
2784,T001038,Total male and female,CR17  ,Utrecht (CR),2020JJ00,2020,1354834,912,14776,10.9,11179,8.2,3597,81545,60,11847,69698,78787,58,8888,-386,69899,2758,6319,4.7,1361153
2785,T001038,Total male and female,CR17  ,Utrecht (CR),2021JJ00,2021,1361153,916,15784,11.6,11323,8.3,4461,84727,62,13268,71459,80428,58.9,8436,-802,71992,4299,8720,6.4,1369873
2786,T001038,Total male and female,CR17  ,Utrecht (CR),2022JJ00,2022,1369873,923,14229,10.3,11461,8.3,2768,93899,68.1,22557,71342,78868,57.2,10283,-662,68585,15031,17770,13,1387643
2787,T001038,Total male and female,CR17  ,Utrecht (CR),2023JJ00,2023,1387643,935,14070,10.1,11557,8.3,2513,91748,65.8,16902,74846,81825,58.7,11255,-1433,70570,9923,12414,8.9,1400057
2858,T001038,Total male and female,CR18  ,Kop van Noord-Holland (CR),2012JJ00,2012,372017,344,3662,9.8,2947,7.9,715,13138,35.3,1897,11241,14004,37.7,1700,-330,12304,-866,-152,-0.4,371865
2859,T001038,Total male and female,CR18  ,Kop van Noord-Holland (CR),2013JJ00,2013,371865,344,3471,9.3,3025,8.1,446,12733,34.3,2100,10633,13408,36.1,1573,-121,11835,-675,-249,-0.7,371616
2860,T001038,Total male and female,CR18  ,Kop van Noord-Holland (CR),2014JJ00,2014,371616,344,3629,9.8,3035,8.2,594,13939,37.5,2574,11365,14082,37.9,1858,-183,12224,-143,479,1.3,372095
2861,T001038,Total male and female,CR18  ,Kop van Noord-Holland (CR),2015JJ00,2015,372095,344,3464,9.3,3242,8.7,222,15731,42.2,2938,12793,15468,41.5,1958,-191,13510,263,511,1.4,372606
2862,T001038,Total male and female,CR18  ,Kop van Noord-Holland (CR),2016JJ00,2016,372606,344,3570,9.6,3235,8.7,335,16853,45.2,2722,14131,16524,44.3,1850,-227,14674,329,660,1.8,373266
2863,T001038,Total male and female,CR18  ,Kop van Noord-Holland (CR),2017JJ00,2017,373266,345,3521,9.4,3348,9,173,17792,47.6,2467,15325,16758,44.8,1858,-171,14900,1034,1195,3.2,374461
2864,T001038,Total male and female,CR18  ,Kop van Noord-Holland (CR),2018JJ00,2018,374461,346,3402,9.1,3384,9,18,17523,46.7,2790,14733,16331,43.5,1799,-270,14532,1192,1198,3.2,375659
2865,T001038,Total male and female,CR18  ,Kop van Noord-Holland (CR),2019JJ00,2019,375659,347,3371,8.9,3429,9.1,-58,18463,49,4128,14335,16285,43.2,2237,-430,14048,2178,2110,5.6,377769
2866,T001038,Total male and female,CR18  ,Kop van Noord-Holland (CR),2020JJ00,2020,377769,349,3411,9,3598,9.5,-187,18768,49.6,3488,15280,17052,45,2659,-579,14393,1716,1535,4.1,379304
2867,T001038,Total male and female,CR18  ,Kop van Noord-Holland (CR),2021JJ00,2021,379304,350,3642,9.6,3889,10.2,-247,19090,50.2,3103,15987,17071,44.9,2734,-449,14337,2019,1762,4.6,381066
2868,T001038,Total male and female,CR18  ,Kop van Noord-Holland (CR),2022JJ00,2022,381066,352,3568,9.3,3761,9.8,-193,22673,59.1,6794,15879,17787,46.4,3674,-704,14113,4886,4677,12.3,385743
2869,T001038,Total male and female,CR18  ,Kop van Noord-Holland (CR),2023JJ00,2023,385743,356,3361,8.7,3962,10.3,-601,19470,50.4,4297,15173,18043,46.7,3539,-753,14504,1427,811,2.1,386554
2940,T001038,Total male and female,CR19  ,Alkmaar en omgeving (CR),2012JJ00,2012,232531,865,2343,10.1,1895,8.1,448,10390,44.7,1438,8952,10659,45.8,1506,-221,9153,-269,194,0.8,232725
2941,T001038,Total male and female,CR19  ,Alkmaar en omgeving (CR),2013JJ00,2013,232725,866,2239,9.6,1889,8.1,350,10540,45.2,1501,9039,10265,44,1095,-70,9170,275,634,2.7,233359
2942,T001038,Total male and female,CR19  ,Alkmaar en omgeving (CR),2014JJ00,2014,233359,868,2325,9.9,1832,7.8,493,10975,47,1657,9318,10734,45.9,1122,1,9612,241,740,3.2,234099
2943,T001038,Total male and female,CR19  ,Alkmaar en omgeving (CR),2015JJ00,2015,240505,833,2251,9.3,2038,8.5,213,12925,53.6,1910,11015,12015,49.8,1242,-58,10773,910,1116,4.6,241621
2944,T001038,Total male and female,CR19  ,Alkmaar en omgeving (CR),2016JJ00,2016,241621,838,2284,9.4,2166,8.9,118,14969,61.7,2405,12564,13080,53.9,1341,-181,11739,1889,2011,8.3,243632
2945,T001038,Total male and female,CR19  ,Alkmaar en omgeving (CR),2017JJ00,2017,243632,845,2239,9.2,2042,8.4,197,14834,60.7,1605,13229,13460,55.1,1187,-115,12273,1374,1564,6.4,245196
2946,T001038,Total male and female,CR19  ,Alkmaar en omgeving (CR),2018JJ00,2018,245196,845,2270,9.2,2124,8.6,146,13908,56.5,1661,12247,12504,50.8,1264,-263,11240,1404,1534,6.3,246730
2947,T001038,Total male and female,CR19  ,Alkmaar en omgeving (CR),2019JJ00,2019,246730,850,2244,9.1,2072,8.4,172,14487,58.4,1753,12734,12392,50,1161,-140,11231,2095,2263,9.2,248993
2948,T001038,Total male and female,CR19  ,Alkmaar en omgeving (CR),2020JJ00,2020,248993,858,2252,9,2368,9.5,-116,14401,57.7,1427,12974,12791,51.2,1064,-107,11727,1610,1484,6,250477
2949,T001038,Total male and female,CR19  ,Alkmaar en omgeving (CR),2021JJ00,2021,250477,863,2470,9.8,2432,9.7,38,14308,56.9,1434,12874,12209,48.5,1145,-152,11064,2099,2141,8.5,252618
2950,T001038,Total male and female,CR19  ,Alkmaar en omgeving (CR),2022JJ00,2022,252618,871,2192,8.6,2553,10.1,-361,15013,59.1,3193,11820,11983,47.2,1512,-255,10471,3030,2658,10.5,255276
2951,T001038,Total male and female,CR19  ,Alkmaar en omgeving (CR),2023JJ00,2023,255276,881,2211,8.6,2525,9.9,-314,14011,54.7,2032,11979,12334,48.2,1715,-420,10619,1677,1348,5.3,256624
3022,T001038,Total male and female,CR20  ,IJmond (CR),2012JJ00,2012,193769,1217,1789,9.2,1805,9.3,-16,7851,40.5,1047,6804,7829,40.4,946,-235,6883,22,3,0,193772
3023,T001038,Total male and female,CR20  ,IJmond (CR),2013JJ00,2013,193772,1219,1790,9.2,1804,9.3,-14,7720,39.8,1040,6680,7548,38.9,892,-141,6656,172,151,0.8,193923
3024,T001038,Total male and female,CR20  ,IJmond (CR),2014JJ00,2014,193923,1220,1790,9.2,1775,9.1,15,8526,43.9,1027,7499,8329,42.9,1004,-184,7325,197,215,1.1,194138
3025,T001038,Total male and female,CR20  ,IJmond (CR),2015JJ00,2015,194138,1221,1798,9.2,1883,9.7,-85,9610,49.4,1133,8477,8634,44.4,1074,-227,7560,976,891,4.6,195029
3026,T001038,Total male and female,CR20  ,IJmond (CR),2016JJ00,2016,195029,1227,1840,9.4,1927,9.9,-87,10184,52.1,1128,9056,8933,45.7,952,-229,7981,1251,1151,5.9,196180
3027,T001038,Total male and female,CR20  ,IJmond (CR),2017JJ00,2017,196180,1234,1809,9.2,1906,9.7,-97,10205,51.9,1112,9093,9100,46.3,1057,-200,8043,1105,1002,5.1,197182
3028,T001038,Total male and female,CR20  ,IJmond (CR),2018JJ00,2018,197182,1234,1737,8.8,1981,10,-244,9538,48.3,1405,8133,8493,43,1123,-192,7370,1045,806,4.1,197988
3029,T001038,Total male and female,CR20  ,IJmond (CR),2019JJ00,2019,197988,1239,1798,9.1,1918,9.7,-120,10181,51.3,1332,8849,8942,45,1116,-227,7826,1239,1120,5.7,199108
3030,T001038,Total male and female,CR20  ,IJmond (CR),2020JJ00,2020,199108,1246,1853,9.3,2152,10.8,-299,10073,50.6,1150,8923,9493,47.6,892,-123,8601,580,281,1.4,199389
3031,T001038,Total male and female,CR20  ,IJmond (CR),2021JJ00,2021,199389,1248,1944,9.7,2135,10.7,-191,9434,47.3,998,8436,9051,45.4,888,-132,8163,383,192,1,199581
3032,T001038,Total male and female,CR20  ,IJmond (CR),2022JJ00,2022,199581,1252,1824,9.1,2133,10.7,-309,10813,54,1979,8834,9325,46.6,1090,-157,8235,1488,1168,5.9,200749
3033,T001038,Total male and female,CR20  ,IJmond (CR),2023JJ00,2023,200749,1259,1804,9,2279,11.3,-475,10530,52.4,1698,8832,9478,47.1,1222,-223,8256,1052,576,2.9,201325
3104,T001038,Total male and female,CR21  ,Agglomeratie Haarlem (CR),2012JJ00,2012,222241,1716,2388,10.7,2313,10.4,75,12439,55.8,2145,10294,11030,49.5,1832,-414,9198,1409,1483,6.7,223724
3105,T001038,Total male and female,CR21  ,Agglomeratie Haarlem (CR),2013JJ00,2013,223724,1727,2348,10.4,2273,10.1,75,12862,57.2,2134,10728,10985,48.9,1648,-134,9337,1877,1956,8.7,225680
3106,T001038,Total male and female,CR21  ,Agglomeratie Haarlem (CR),2014JJ00,2014,225680,1742,2439,10.8,2150,9.5,289,14466,63.8,2208,12258,12785,56.4,2173,-559,10612,1681,1967,8.7,227647
3107,T001038,Total male and female,CR21  ,Agglomeratie Haarlem (CR),2015JJ00,2015,227647,1757,2396,10.5,2419,10.6,-23,15371,67.2,2237,13134,13417,58.7,1848,-170,11569,1954,1925,8.5,229572
3108,T001038,Total male and female,CR21  ,Agglomeratie Haarlem (CR),2016JJ00,2016,229572,1774,2340,10.1,2386,10.3,-46,16546,71.8,2866,13680,14509,62.9,2024,-233,12485,2037,1983,8.6,231555
3109,T001038,Total male and female,CR21  ,Agglomeratie Haarlem (CR),2017JJ00,2017,231555,1789,2364,10.2,2387,10.3,-23,16446,70.8,2757,13689,15130,65.2,2112,-314,13018,1316,1279,5.5,232834
3110,T001038,Total male and female,CR21  ,Agglomeratie Haarlem (CR),2018JJ00,2018,232834,1799,2396,10.2,2352,10.1,44,16367,69.9,3180,13187,14100,60.3,1996,-150,12104,2267,2305,9.9,235139
3111,T001038,Total male and female,CR21  ,Agglomeratie Haarlem (CR),2019JJ00,2019,228972,2077,2365,10.3,2272,9.9,93,16293,70.9,3450,12843,14526,63.2,2105,-250,12421,1767,1851,8.1,230823
3112,T001038,Total male and female,CR21  ,Agglomeratie Haarlem (CR),2020JJ00,2020,230823,2094,2282,9.9,2463,10.7,-181,16006,69.4,2766,13240,15899,68.9,1983,-254,13916,107,-89,-0.4,230734
3113,T001038,Total male and female,CR21  ,Agglomeratie Haarlem (CR),2021JJ00,2021,230734,2093,2403,10.4,2461,10.7,-58,16091,69.7,2702,13389,15456,66.9,2011,-227,13445,635,560,2.4,231294
3114,T001038,Total male and female,CR21  ,Agglomeratie Haarlem (CR),2022JJ00,2022,231294,2098,2250,9.7,2526,10.8,-276,18579,79.7,4841,13738,14953,64.2,2340,-238,12613,3626,3344,14.5,234638
3115,T001038,Total male and female,CR21  ,Agglomeratie Haarlem (CR),2023JJ00,2023,234638,2129,2128,9,2472,10.5,-344,17652,74.9,3564,14088,15449,65.6,2561,-329,12888,2203,1846,7.9,236484
3186,T001038,Total male and female,CR22  ,Zaanstreek (CR),2012JJ00,2012,164062,1457,1706,10.4,1383,8.4,323,6427,39,1147,5280,5457,33.1,1134,-300,4323,970,1300,7.9,165362
3187,T001038,Total male and female,CR22  ,Zaanstreek (CR),2013JJ00,2013,165362,1469,1689,10.2,1396,8.4,293,6401,38.6,1175,5226,5694,34.3,1260,-303,4434,707,1013,6.1,166375
3188,T001038,Total male and female,CR22  ,Zaanstreek (CR),2014JJ00,2014,166375,1478,1777,10.7,1353,8.1,424,6401,38.4,1274,5127,6047,36.3,1188,-310,4859,354,783,4.7,167158
3189,T001038,Total male and female,CR22  ,Zaanstreek (CR),2015JJ00,2015,167158,1485,1765,10.5,1503,9,262,7128,42.5,1306,5822,6429,38.3,1142,-221,5287,699,972,5.8,168130
3190,T001038,Total male and female,CR22  ,Zaanstreek (CR),2016JJ00,2016,168130,1495,1897,11.2,1507,8.9,390,7848,46.5,1318,6530,6861,40.6,1225,-186,5636,987,1369,8.1,169499
3191,T001038,Total male and female,CR22  ,Zaanstreek (CR),2017JJ00,2017,169499,1507,1797,10.6,1466,8.6,331,8072,47.4,1434,6638,7040,41.4,1075,-135,5965,1032,1361,8,170860
3192,T001038,Total male and female,CR22  ,Zaanstreek (CR),2018JJ00,2018,170860,1519,1799,10.5,1458,8.5,341,8524,49.7,1701,6823,7508,43.8,1141,-110,6367,1016,1354,7.9,172214
3193,T001038,Total male and female,CR22  ,Zaanstreek (CR),2019JJ00,2019,172214,1531,1846,10.7,1390,8.1,456,8301,48.1,1800,6501,7911,45.8,1219,-272,6692,390,850,4.9,173064
3194,T001038,Total male and female,CR22  ,Zaanstreek (CR),2020JJ00,2020,173064,1539,1703,9.8,1716,9.9,-13,8264,47.7,1667,6597,8065,46.6,1047,-155,7018,199,170,1,173234
3195,T001038,Total male and female,CR22  ,Zaanstreek (CR),2021JJ00,2021,173234,1541,1846,10.6,1605,9.3,241,8282,47.8,1632,6650,8211,47.4,1139,-199,7072,71,313,1.8,173547
3196,T001038,Total male and female,CR22  ,Zaanstreek (CR),2022JJ00,2022,173547,1546,1711,9.8,1703,9.7,8,10975,62.8,3019,7956,8300,47.5,1303,-185,6997,2675,2683,15.5,176230
3197,T001038,Total male and female,CR22  ,Zaanstreek (CR),2023JJ00,2023,176230,1570,1701,9.6,1643,9.3,58,10476,59.2,2630,7846,8814,49.8,1724,-381,7090,1662,1711,9.7,177941
3268,T001038,Total male and female,CR23  ,Groot-Amsterdam (CR),2012JJ00,2012,1280160,1790,15671,12.2,9280,7.2,6391,78449,61,26183,52266,73300,57,25391,-6888,47909,5149,11575,9,1291735
3269,T001038,Total male and female,CR23  ,Groot-Amsterdam (CR),2013JJ00,2013,1291735,1807,15676,12.1,9131,7,6545,80704,62.2,26786,53918,73852,56.9,25012,-5566,48840,6852,13572,10.5,1305307
3270,T001038,Total male and female,CR23  ,Groot-Amsterdam (CR),2014JJ00,2014,1305307,1826,15692,12,8956,6.8,6736,89374,68.1,31504,57870,81194,61.8,25132,-4841,56062,8180,14988,11.5,1320295
3271,T001038,Total male and female,CR23  ,Groot-Amsterdam (CR),2015JJ00,2015,1313889,1890,15536,11.8,9280,7,6256,95717,72.4,34214,61503,86313,65.3,25250,-2727,61063,9404,15683,11.9,1329572
3272,T001038,Total male and female,CR23  ,Groot-Amsterdam (CR),2016JJ00,2016,1329572,1917,15686,11.7,9428,7.1,6258,101053,75.6,38070,62983,92208,69,26002,-2491,66206,8845,15087,11.3,1344659
3273,T001038,Total male and female,CR23  ,Groot-Amsterdam (CR),2017JJ00,2017,1344659,1939,15351,11.4,9120,6.7,6231,105194,77.9,43454,61740,98374,72.8,28575,-4750,69799,6820,13016,9.7,1357675
3274,T001038,Total male and female,CR23  ,Groot-Amsterdam (CR),2018JJ00,2018,1357675,1958,15201,11.1,9463,6.9,5738,108961,79.9,48789,60172,101647,74.5,30001,-3772,71646,7314,12984,9.6,1370659
3275,T001038,Total male and female,CR23  ,Groot-Amsterdam (CR),2019JJ00,2019,1376826,1932,15224,11,9339,6.7,5885,116006,83.8,53653,62353,105981,76.5,30335,-2956,75646,10025,15869,11.5,1392695
3276,T001038,Total male and female,CR23  ,Groot-Amsterdam (CR),2020JJ00,2020,1392695,1954,15115,10.8,10262,7.4,4853,106388,76.3,39392,66996,107629,77.2,27686,-904,79943,-1241,3544,2.5,1396239
3277,T001038,Total male and female,CR23  ,Groot-Amsterdam (CR),2021JJ00,2021,1396239,1959,15990,11.4,10497,7.5,5493,116544,83,47412,69132,107115,76.3,25204,-709,81911,9429,14818,10.6,1411057
3278,T001038,Total male and female,CR23  ,Groot-Amsterdam (CR),2022JJ00,2022,1411057,1982,14659,10.2,10644,7.4,4015,134996,93.5,67313,67683,114495,79.3,30263,-2198,84232,20501,24364,17,1456187
3279,T001038,Total male and female,CR23  ,Groot-Amsterdam (CR),2023JJ00,2023,1456187,1983,14226,9.7,10465,7.1,3761,131177,89.6,59217,71960,118077,80.6,34430,-2759,83647,13100,16606,11.4,1472793
3350,T001038,Total male and female,CR24  ,Het Gooi en Vechtstreek (CR),2012JJ00,2012,245042,1242,2232,9.1,2495,10.2,-263,13581,55.4,2031,11550,13237,54,1845,-440,11392,344,75,0.3,245117
3351,T001038,Total male and female,CR24  ,Het Gooi en Vechtstreek (CR),2013JJ00,2013,245117,1242,2099,8.6,2508,10.2,-409,13232,54,2001,11231,12845,52.4,1773,-134,11072,387,-8,0,245109
3352,T001038,Total male and female,CR24  ,Het Gooi en Vechtstreek (CR),2014JJ00,2014,245109,1242,2307,9.4,2516,10.2,-209,15478,63,2321,13157,13882,56.5,1881,-228,12001,1596,1388,5.7,246497
3353,T001038,Total male and female,CR24  ,Het Gooi en Vechtstreek (CR),2015JJ00,2015,246497,1249,2299,9.3,2667,10.8,-368,16910,68.3,2631,14279,14724,59.5,1915,-218,12809,2186,1827,7.4,248324
3354,T001038,Total male and female,CR24  ,Het Gooi en Vechtstreek (CR),2016JJ00,2016,248324,1261,2259,9.1,2627,10.5,-368,17556,70.4,2742,14814,14826,59.4,1844,-210,12982,2730,2368,9.5,250692
3355,T001038,Total male and female,CR24  ,Het Gooi en Vechtstreek (CR),2017JJ00,2017,250692,1273,2312,9.2,2597,10.3,-285,18333,72.8,2794,15539,15759,62.6,1800,-155,13959,2574,2282,9.1,252974
3356,T001038,Total male and female,CR24  ,Het Gooi en Vechtstreek (CR),2018JJ00,2018,252974,1285,2448,9.6,2662,10.5,-214,17301,68.1,3187,14114,15092,59.4,1954,-194,13138,2209,1996,7.9,254970
3357,T001038,Total male and female,CR24  ,Het Gooi en Vechtstreek (CR),2019JJ00,2019,254970,1295,2406,9.4,2666,10.4,-260,18299,71.5,3334,14965,15944,62.3,1940,-176,14004,2355,2105,8.3,257075
3358,T001038,Total male and female,CR24  ,Het Gooi en Vechtstreek (CR),2020JJ00,2020,257075,1305,2415,9.4,2922,11.3,-507,18808,72.9,2731,16077,16262,63,1766,-172,14496,2546,2034,7.9,259109
3359,T001038,Total male and female,CR24  ,Het Gooi en Vechtstreek (CR),2021JJ00,2021,259109,1316,2624,10.1,2953,11.4,-329,18540,71.3,2781,15759,16647,64.1,1866,-170,14781,1893,1555,6,260664
3360,T001038,Total male and female,CR24  ,Het Gooi en Vechtstreek (CR),2022JJ00,2022,260664,1326,2204,9.1,2571,10.6,-367,19296,79.8,5188,14108,15022,62.1,2158,-159,12864,4274,3901,16.3,243799
3361,T001038,Total male and female,CR24  ,Het Gooi en Vechtstreek (CR),2023JJ00,2023,243799,1402,2114,8.7,2731,11.2,-617,17176,70.3,3623,13553,15584,63.8,2139,-239,13445,1592,967,4,244766
3432,T001038,Total male and female,CR25  ,Agglomeratie Leiden en Bollenstreek (CR),2012JJ00,2012,409129,1480,4191,10.2,3268,8,923,21825,53.2,4268,17557,20541,50.1,3872,-732,16669,1284,2222,5.4,411351
3433,T001038,Total male and female,CR25  ,Agglomeratie Leiden en Bollenstreek (CR),2013JJ00,2013,411351,1489,4072,9.9,3347,8.1,725,21765,52.8,4474,17291,20735,50.3,3764,-503,16971,1030,1750,4.3,413101
3434,T001038,Total male and female,CR25  ,Agglomeratie Leiden en Bollenstreek (CR),2014JJ00,2014,413101,1495,4174,10.1,3402,8.2,772,23197,56,4473,18724,21967,53,4060,-709,17907,1230,2005,4.9,415106
3435,T001038,Total male and female,CR25  ,Agglomeratie Leiden en Bollenstreek (CR),2015JJ00,2015,415106,1502,3941,9.5,3383,8.1,558,26212,62.9,5917,20295,23836,57.2,4048,-551,19788,2376,2917,7,418023
3436,T001038,Total male and female,CR25  ,Agglomeratie Leiden en Bollenstreek (CR),2016JJ00,2016,418023,1512,4054,9.7,3422,8.2,632,28470,67.8,5541,22929,25814,61.5,4639,-900,21175,2656,3273,7.8,421296
3437,T001038,Total male and female,CR25  ,Agglomeratie Leiden en Bollenstreek (CR),2017JJ00,2017,421296,1524,4092,9.7,3479,8.2,613,28890,68.3,5857,23033,26131,61.8,5061,-1154,21070,2759,3361,8,424657
3438,T001038,Total male and female,CR25  ,Agglomeratie Leiden en Bollenstreek (CR),2018JJ00,2018,424657,1536,4079,9.6,3734,8.8,345,26823,63,5930,20893,24615,57.8,4494,-673,20121,2208,2560,6,427217
3439,T001038,Total male and female,CR25  ,Agglomeratie Leiden en Bollenstreek (CR),2019JJ00,2019,427217,1545,4100,9.6,3588,8.4,512,27145,63.3,6298,20847,24507,57.2,4221,-449,20286,2638,3141,7.4,430358
3440,T001038,Total male and female,CR25  ,Agglomeratie Leiden en Bollenstreek (CR),2020JJ00,2020,430358,1557,3996,9.3,3905,9.1,91,27240,63.2,4703,22537,26092,60.5,4259,-864,21833,1148,1237,2.9,431595
3441,T001038,Total male and female,CR25  ,Agglomeratie Leiden en Bollenstreek (CR),2021JJ00,2021,431595,1561,4247,9.8,3933,9.1,314,27369,63.2,5289,22080,24751,57.2,3458,-322,21293,2618,2932,6.8,434527
3442,T001038,Total male and female,CR25  ,Agglomeratie Leiden en Bollenstreek (CR),2022JJ00,2022,434527,1574,3937,9,3946,9,-9,31368,71.7,9030,22338,25577,58.5,4409,-418,21168,5791,5785,13.3,440312
3443,T001038,Total male and female,CR25  ,Agglomeratie Leiden en Bollenstreek (CR),2023JJ00,2023,440312,1595,3994,9,3999,9,-5,32618,73.6,7307,25311,27164,61.3,4707,-557,22457,5454,5444,12.4,445756
3514,T001038,Total male and female,CR26  ,Agglomeratie 's-Gravenhage (CR),2012JJ00,2012,819646,3259,10336,12.6,6845,8.3,3491,47323,57.5,15839,31484,45470,55.3,14412,-3620,31058,1853,5372,6.6,825018
3515,T001038,Total male and female,CR26  ,Agglomeratie 's-Gravenhage (CR),2013JJ00,2013,825018,3281,9919,12,6561,7.9,3358,49166,59.4,16955,32211,47351,57.2,16519,-5221,30832,1815,5219,6.3,830237
3516,T001038,Total male and female,CR26  ,Agglomeratie 's-Gravenhage (CR),2014JJ00,2014,830237,3302,10329,12.4,6730,8.1,3599,51726,62,17775,33951,47388,56.8,13919,-2873,33469,4338,7778,9.4,838015
3517,T001038,Total male and female,CR26  ,Agglomeratie 's-Gravenhage (CR),2015JJ00,2015,838015,3333,10145,12.1,7004,8.3,3141,53519,63.6,17502,36017,49014,58.2,13559,-1891,35455,4505,7410,8.8,845425
3518,T001038,Total male and female,CR26  ,Agglomeratie 's-Gravenhage (CR),2016JJ00,2016,845425,3350,10256,12.1,7134,8.4,3122,58108,68.4,18815,39293,52533,61.8,14718,-3113,37815,5575,8562,10.1,853987
3519,T001038,Total male and female,CR26  ,Agglomeratie 's-Gravenhage (CR),2017JJ00,2017,853987,3384,9943,11.6,6916,8.1,3027,60175,70,20445,39730,52933,61.6,13491,-2045,39442,7242,10142,11.9,864129
3520,T001038,Total male and female,CR26  ,Agglomeratie 's-Gravenhage (CR),2018JJ00,2018,864129,3435,9896,11.4,7060,8.1,2836,58578,67.5,21005,37573,52981,61,14171,-2585,38810,5597,8082,9.4,872211
3521,T001038,Total male and female,CR26  ,Agglomeratie 's-Gravenhage (CR),2019JJ00,2019,872211,3467,9860,11.2,6997,8,2863,62261,70.9,23625,38636,53554,61,13329,-1399,40225,8707,11509,13.2,883720
3522,T001038,Total male and female,CR26  ,Agglomeratie 's-Gravenhage (CR),2020JJ00,2020,883720,3512,9394,10.6,7709,8.7,1685,59781,67.5,19168,40613,57225,64.6,14556,-2957,42669,2556,4143,4.7,887863
3523,T001038,Total male and female,CR26  ,Agglomeratie 's-Gravenhage (CR),2021JJ00,2021,887863,3529,9609,10.8,7789,8.7,1820,63364,71,21154,42210,56520,63.4,11651,-473,44869,6844,8608,9.7,896471
3524,T001038,Total male and female,CR26  ,Agglomeratie 's-Gravenhage (CR),2022JJ00,2022,896471,3564,8962,9.9,7887,8.7,1075,71540,79.2,29965,41575,58645,64.9,15085,-1988,43560,12895,13881,15.5,910352
3525,T001038,Total male and female,CR26  ,Agglomeratie 's-Gravenhage (CR),2023JJ00,2023,910352,3620,9000,9.8,7518,8.2,1482,67155,73.5,25407,41748,61347,67.1,16623,-2601,44724,5808,7206,7.9,917558
3596,T001038,Total male and female,CR27  ,Delft en Westland (CR),2012JJ00,2012,218880,1462,2084,9.5,1546,7,538,13721,62.5,5329,8392,13084,59.6,4555,-1394,8529,637,1166,5.3,220046
3597,T001038,Total male and female,CR27  ,Delft en Westland (CR),2013JJ00,2013,220046,1470,2110,9.6,1642,7.4,468,14594,66.1,5629,8965,13354,60.5,4715,-969,8639,1240,1697,7.7,221743
3598,T001038,Total male and female,CR27  ,Delft en Westland (CR),2014JJ00,2014,221743,1481,2075,9.3,1548,6.9,527,16016,71.9,6391,9625,14223,63.8,4942,-992,9281,1793,2298,10.4,224041
3599,T001038,Total male and female,CR27  ,Delft en Westland (CR),2015JJ00,2015,224041,1496,2121,9.4,1693,7.5,428,16134,71.9,6618,9516,15725,70.1,6027,-1817,9698,409,826,3.7,224867
3600,T001038,Total male and female,CR27  ,Delft en Westland (CR),2016JJ00,2016,224867,1485,2209,9.8,1630,7.2,579,16860,74.8,6723,10137,16241,72,5789,-1494,10452,619,1180,5.2,226047
3601,T001038,Total male and female,CR27  ,Delft en Westland (CR),2017JJ00,2017,226047,1493,2052,9,1725,7.6,327,18791,82.6,7271,11520,16064,70.6,5417,-1389,10647,2727,3036,13.4,229083
3602,T001038,Total male and female,CR27  ,Delft en Westland (CR),2018JJ00,2018,229083,1516,2149,9.3,1691,7.3,458,18272,79.4,7355,10917,16653,72.4,5977,-994,10676,1619,2074,9.1,231157
3603,T001038,Total male and female,CR27  ,Delft en Westland (CR),2019JJ00,2019,231157,1530,2248,9.7,1642,7.1,606,18401,79.2,7383,11018,16841,72.5,5702,-1015,11139,1560,2154,9.3,233311
3604,T001038,Total male and female,CR27  ,Delft en Westland (CR),2020JJ00,2020,233311,1544,2166,9.3,1911,8.2,255,17656,75.5,5860,11796,16831,72,5324,-841,11507,825,1066,4.6,234377
3605,T001038,Total male and female,CR27  ,Delft en Westland (CR),2021JJ00,2021,234377,1551,2340,9.9,1869,7.9,471,18389,78.1,6525,11864,16726,71,4308,-800,12418,1663,2127,9.1,236504
3606,T001038,Total male and female,CR27  ,Delft en Westland (CR),2022JJ00,2022,236504,1570,2156,9,1954,8.2,202,20189,84.7,8865,11324,16438,68.9,4661,-927,11777,3751,3941,16.7,240445
3607,T001038,Total male and female,CR27  ,Delft en Westland (CR),2023JJ00,2023,240445,1596,2122,8.7,1897,7.8,225,21877,90.2,7678,14199,17642,72.7,5364,-1113,12278,4235,4450,18.5,244895
3678,T001038,Total male and female,CR28  ,Oost-Zuid-Holland (CR),2012JJ00,2012,294376,699,3114,10.6,2210,7.5,904,9500,32.3,1256,8244,10554,35.9,1258,-258,9296,-1054,-139,-0.5,294237
3679,T001038,Total male and female,CR28  ,Oost-Zuid-Holland (CR),2013JJ00,2013,294237,699,3025,10.3,2163,7.3,862,10194,34.6,1400,8794,10505,35.7,1107,-63,9398,-311,578,2,294815
3680,T001038,Total male and female,CR28  ,Oost-Zuid-Holland (CR),2014JJ00,2014,294815,700,3219,10.9,2230,7.5,989,10929,37,1535,9394,10464,35.4,1227,-168,9237,465,1489,5.1,296304
3681,T001038,Total male and female,CR28  ,Oost-Zuid-Holland (CR),2015JJ00,2015,318688,670,3311,10.4,2566,8,745,13016,40.7,1768,11248,11650,36.4,1282,-225,10368,1366,2070,6.5,320758
3682,T001038,Total male and female,CR28  ,Oost-Zuid-Holland (CR),2016JJ00,2016,320758,675,3324,10.3,2580,8,744,15504,48.1,2516,12988,12940,40.1,1791,-311,11149,2564,3296,10.3,324054
3683,T001038,Total male and female,CR28  ,Oost-Zuid-Holland (CR),2017JJ00,2017,324054,682,3401,10.4,2557,7.8,844,16868,51.8,2335,14533,13925,42.7,1917,-453,12008,2943,3767,11.6,327821
3684,T001038,Total male and female,CR28  ,Oost-Zuid-Holland (CR),2018JJ00,2018,327821,694,3410,10.3,2625,8,785,16604,50.4,2539,14065,13593,41.2,1963,-493,11630,3011,3800,11.6,331621
3685,T001038,Total male and female,CR28  ,Oost-Zuid-Holland (CR),2019JJ00,2019,331621,702,3546,10.6,2708,8.1,838,15874,47.7,2500,13374,13710,41.2,1886,-245,11824,2164,2996,9,334617
3686,T001038,Total male and female,CR28  ,Oost-Zuid-Holland (CR),2020JJ00,2020,334617,708,3587,10.7,2975,8.8,612,16831,50.1,2236,14595,14261,42.4,1523,-172,12738,2570,3181,9.5,337798
3687,T001038,Total male and female,CR28  ,Oost-Zuid-Holland (CR),2021JJ00,2021,337798,715,3896,11.5,2918,8.6,978,15684,46.2,2100,13584,13974,41.2,1578,-346,12396,1710,2683,7.9,340481
3688,T001038,Total male and female,CR28  ,Oost-Zuid-Holland (CR),2022JJ00,2022,340481,721,3673,10.7,3064,8.9,609,18997,55.4,4480,14517,14510,42.3,2284,-678,12226,4487,5089,14.9,345570
3689,T001038,Total male and female,CR28  ,Oost-Zuid-Holland (CR),2023JJ00,2023,345570,732,3717,10.7,3071,8.8,646,17542,50.5,2935,14607,15174,43.7,2356,-648,12818,2368,3009,8.7,348579
3760,T001038,Total male and female,CR29  ,Groot-Rijnmond (CR),2012JJ00,2012,1412582,1136,16432,11.6,12202,8.6,4230,66263,46.9,15626,50637,68403,48.4,17843,-6952,50560,-2140,2108,1.5,1414690
3761,T001038,Total male and female,CR29  ,Groot-Rijnmond (CR),2013JJ00,2013,1414690,1140,15806,11.2,12207,8.6,3599,65054,45.9,15049,50005,65572,46.3,15820,-4588,49752,-518,3131,2.2,1417821
3762,T001038,Total male and female,CR29  ,Groot-Rijnmond (CR),2014JJ00,2014,1417821,1142,16321,11.5,11522,8.1,4799,69138,48.6,16163,52975,65554,46.1,14505,-3004,51049,3584,8495,6,1426316
3763,T001038,Total male and female,CR29  ,Groot-Rijnmond (CR),2015JJ00,2015,1403932,1184,15542,11,12080,8.6,3462,72525,51.5,16614,55911,67676,48.1,14664,-2762,53012,4849,8390,6,1412322
3764,T001038,Total male and female,CR29  ,Groot-Rijnmond (CR),2016JJ00,2016,1412322,1184,16011,11.3,12365,8.7,3646,78531,55.4,17096,61435,72044,50.8,14378,-2987,57666,6487,10143,7.2,1422465
3765,T001038,Total male and female,CR29  ,Groot-Rijnmond (CR),2017JJ00,2017,1422465,1192,15552,10.9,12532,8.8,3020,82173,57.6,18432,63741,76351,53.5,14814,-3663,61537,5822,8780,6.2,1431245
3766,T001038,Total male and female,CR29  ,Groot-Rijnmond (CR),2018JJ00,2018,1431245,1202,15458,10.8,12718,8.9,2740,80986,56.4,19506,61480,73548,51.2,12682,-1520,60866,7438,10207,7.1,1441452
3767,T001038,Total male and female,CR29  ,Groot-Rijnmond (CR),2019JJ00,2019,1441452,1211,15619,10.8,12596,8.7,3023,84963,58.7,22953,62010,74684,51.6,13731,-1912,60953,10279,13268,9.2,1454720
3768,T001038,Total male and female,CR29  ,Groot-Rijnmond (CR),2020JJ00,2020,1454720,1222,15601,10.7,14461,9.9,1140,84905,58.2,19372,65533,79266,54.4,13443,-1902,65823,5639,6692,4.6,1461412
3769,T001038,Total male and female,CR29  ,Groot-Rijnmond (CR),2021JJ00,2021,1461412,1227,16168,11,13895,9.5,2273,88259,60.2,21842,66417,80911,55.2,12927,-1803,67984,7348,9581,6.6,1470993
3770,T001038,Total male and female,CR29  ,Groot-Rijnmond (CR),2022JJ00,2022,1470993,1234,15157,10.2,13784,9.3,1373,96206,65,31089,65117,80072,54.1,14921,-1965,65151,16134,17482,11.9,1488475
3771,T001038,Total male and female,CR29  ,Groot-Rijnmond (CR),2023JJ00,2023,1488475,1249,14782,9.9,13689,9.2,1093,94746,63.4,27385,67361,81663,54.6,16153,-2561,65510,13083,14107,9.5,1502582
3842,T001038,Total male and female,CR30  ,Zuidoost-Zuid-Holland (CR),2012JJ00,2012,397794,853,4657,11.7,3340,8.4,1317,14711,36.9,1977,12734,15239,38.3,2326,-532,12913,-528,799,2,398593
3843,T001038,Total male and female,CR30  ,Zuidoost-Zuid-Holland (CR),2013JJ00,2013,398593,855,4418,11.1,3328,8.3,1090,14319,35.9,2092,12227,14691,36.8,1976,-213,12715,-372,722,1.8,399315
3844,T001038,Total male and female,CR30  ,Zuidoost-Zuid-Holland (CR),2014JJ00,2014,399315,857,4661,11.7,3299,8.3,1362,15007,37.5,2024,12983,15464,38.7,2265,-392,13199,-457,914,2.3,400229
3845,T001038,Total male and female,CR30  ,Zuidoost-Zuid-Holland (CR),2015JJ00,2015,400229,859,4277,10.7,3560,8.9,717,16107,40.2,2071,14036,16155,40.3,2006,-327,14149,-48,679,1.7,400908
3846,T001038,Total male and female,CR30  ,Zuidoost-Zuid-Holland (CR),2016JJ00,2016,400908,861,4301,10.7,3613,9,688,17879,44.5,2049,15830,17100,42.6,1734,-220,15366,779,1465,3.7,402373
3847,T001038,Total male and female,CR30  ,Zuidoost-Zuid-Holland (CR),2017JJ00,2017,402373,864,4388,10.9,3664,9.1,724,19720,48.9,2136,17584,18690,46.3,1844,-318,16846,1030,1736,4.3,404109
3848,T001038,Total male and female,CR30  ,Zuidoost-Zuid-Holland (CR),2018JJ00,2018,404109,869,4324,10.7,3704,9.2,620,18519,45.7,2462,16057,17780,43.9,1864,-378,15916,739,1394,3.4,405503
3849,T001038,Total male and female,CR30  ,Zuidoost-Zuid-Holland (CR),2019JJ00,2019,370235,1034,3917,10.6,3340,9,577,16725,45.1,2405,14320,15564,41.9,1599,-224,13965,1161,1735,4.7,371970
3850,T001038,Total male and female,CR30  ,Zuidoost-Zuid-Holland (CR),2020JJ00,2020,371970,1039,3854,10.3,3773,10.1,81,17116,46,2162,14954,16158,43.4,1328,-176,14830,958,1035,2.8,373005
3851,T001038,Total male and female,CR30  ,Zuidoost-Zuid-Holland (CR),2021JJ00,2021,373005,1042,4263,11.4,3884,10.4,379,18442,49.3,2114,16328,16849,45.1,1540,-193,15309,1593,1963,5.3,374968
3852,T001038,Total male and female,CR30  ,Zuidoost-Zuid-Holland (CR),2022JJ00,2022,374968,1053,3973,10.5,3585,9.5,388,21032,55.7,5575,15457,16631,44.1,2224,-343,14407,4401,4784,12.8,379752
3853,T001038,Total male and female,CR30  ,Zuidoost-Zuid-Holland (CR),2023JJ00,2023,379752,1066,3812,10,3586,9.4,226,19283,50.7,3185,16098,18149,47.7,2523,-729,15626,1134,1338,3.5,381090
3924,T001038,Total male and female,CR31  ,Zeeuwsch-Vlaanderen (CR),2012JJ00,2012,106266,145,865,8.1,1169,11,-304,3641,34.3,1452,2189,3469,32.7,947,-164,2522,172,-137,-1.3,106129
3925,T001038,Total male and female,CR31  ,Zeeuwsch-Vlaanderen (CR),2013JJ00,2013,106129,145,847,8,1185,11.2,-338,3610,34,1395,2215,3479,32.8,940,-159,2539,131,-212,-2,105917
3926,T001038,Total male and female,CR31  ,Zeeuwsch-Vlaanderen (CR),2014JJ00,2014,105917,145,893,8.4,1097,10.4,-204,3572,33.8,1354,2218,3605,34.1,1114,-190,2491,-33,-233,-2.2,105684
3927,T001038,Total male and female,CR31  ,Zeeuwsch-Vlaanderen (CR),2015JJ00,2015,105684,144,894,8.5,1268,12,-374,3627,34.3,1355,2272,3267,30.9,988,-164,2279,360,-16,-0.2,105668
3928,T001038,Total male and female,CR31  ,Zeeuwsch-Vlaanderen (CR),2016JJ00,2016,105668,144,841,8,1179,11.2,-338,4232,40.1,1715,2517,3918,37.1,994,-117,2924,314,-27,-0.3,105641
3929,T001038,Total male and female,CR31  ,Zeeuwsch-Vlaanderen (CR),2017JJ00,2017,105641,144,826,7.8,1244,11.8,-418,3966,37.6,1506,2460,3744,35.5,1001,-146,2743,222,-203,-1.9,105438
3930,T001038,Total male and female,CR31  ,Zeeuwsch-Vlaanderen (CR),2018JJ00,2018,105438,144,817,7.7,1210,11.5,-393,4174,39.6,1776,2398,3734,35.4,1054,-74,2680,440,61,0.6,105499
3931,T001038,Total male and female,CR31  ,Zeeuwsch-Vlaanderen (CR),2019JJ00,2019,105499,144,745,7.1,1221,11.6,-476,3973,37.7,1606,2367,3805,36.1,1082,-143,2723,168,-307,-2.9,105192
3932,T001038,Total male and female,CR31  ,Zeeuwsch-Vlaanderen (CR),2020JJ00,2020,105192,144,797,7.6,1304,12.4,-507,4123,39.2,1532,2591,3596,34.2,986,-84,2610,527,12,0.1,105204
3933,T001038,Total male and female,CR31  ,Zeeuwsch-Vlaanderen (CR),2021JJ00,2021,105204,144,867,8.2,1367,13,-500,4071,38.7,1488,2583,3603,34.3,1063,-125,2540,468,-29,-0.3,105175
3934,T001038,Total male and female,CR31  ,Zeeuwsch-Vlaanderen (CR),2022JJ00,2022,105175,144,788,7.5,1376,13,-588,5167,49,2436,2731,3912,37.1,1386,-206,2526,1255,657,6.2,105832
3935,T001038,Total male and female,CR31  ,Zeeuwsch-Vlaanderen (CR),2023JJ00,2023,105832,145,851,8,1362,12.9,-511,4436,42,1820,2616,4147,39.2,1243,-204,2904,289,-220,-2.1,105612
4006,T001038,Total male and female,CR32  ,Overig Zeeland (CR),2012JJ00,2012,275141,261,2770,10.1,2584,9.4,186,11509,41.8,2210,9299,11880,43.2,1826,-719,10054,-371,-193,-0.7,274948
4007,T001038,Total male and female,CR32  ,Overig Zeeland (CR),2013JJ00,2013,274948,261,2666,9.7,2642,9.6,24,11456,41.7,2124,9332,11733,42.7,1425,-333,10308,-277,-244,-0.9,274704
4008,T001038,Total male and female,CR32  ,Overig Zeeland (CR),2014JJ00,2014,274704,261,2754,10,2435,8.9,319,11690,42.5,1972,9718,11669,42.5,1591,-331,10078,21,338,1.2,275042
4009,T001038,Total male and female,CR32  ,Overig Zeeland (CR),2015JJ00,2015,275042,261,2710,9.8,2662,9.7,48,12480,45.3,2242,10238,11990,43.6,1580,-345,10410,490,542,2,275584
4010,T001038,Total male and female,CR32  ,Overig Zeeland (CR),2016JJ00,2016,275584,262,2618,9.5,2706,9.8,-88,13504,49,2335,11169,13077,47.4,1613,-371,11464,427,343,1.2,275927
4011,T001038,Total male and female,CR32  ,Overig Zeeland (CR),2017JJ00,2017,275927,262,2613,9.5,2700,9.8,-87,14459,52.3,2226,12233,13418,48.5,1601,-287,11817,1041,939,3.4,276866
4012,T001038,Total male and female,CR32  ,Overig Zeeland (CR),2018JJ00,2018,276866,264,2561,9.2,2833,10.2,-272,14297,51.6,2510,11787,13360,48.2,1800,-448,11560,937,667,2.4,277533
4013,T001038,Total male and female,CR32  ,Overig Zeeland (CR),2019JJ00,2019,277533,264,2677,9.6,2713,9.8,-36,14181,51,2676,11505,13383,48.2,1890,-368,11493,798,763,2.7,278296
4014,T001038,Total male and female,CR32  ,Overig Zeeland (CR),2020JJ00,2020,278296,265,2627,9.4,2835,10.2,-208,14878,53.3,2457,12421,12767,45.7,1546,-309,11221,2111,1900,6.8,280196
4015,T001038,Total male and female,CR32  ,Overig Zeeland (CR),2021JJ00,2021,280196,267,2725,9.7,3366,12,-641,14485,51.6,2494,11991,12439,44.3,1777,-401,10662,2046,1396,5,281592
4016,T001038,Total male and female,CR32  ,Overig Zeeland (CR),2022JJ00,2022,281592,268,2688,9.5,3045,10.7,-357,17519,61.8,5113,12406,13448,47.4,2368,-338,11080,4071,3700,13.1,285292
4017,T001038,Total male and female,CR32  ,Overig Zeeland (CR),2023JJ00,2023,285292,272,2508,8.8,3057,10.7,-549,15771,55.2,3498,12273,14482,50.7,2471,-492,12011,1289,730,2.6,286022
4088,T001038,Total male and female,CR33  ,West-Noord-Brabant (CR),2012JJ00,2012,618563,507,5921,9.6,5508,8.9,413,24589,39.7,4997,19592,23411,37.8,4268,-821,19143,1178,1642,2.7,620205
4089,T001038,Total male and female,CR33  ,West-Noord-Brabant (CR),2013JJ00,2013,620205,508,5850,9.4,5536,8.9,314,25986,41.8,5480,20506,24472,39.4,4477,-372,19995,1514,1847,3,622052
4090,T001038,Total male and female,CR33  ,West-Noord-Brabant (CR),2014JJ00,2014,622052,510,5945,9.5,5600,9,345,27754,44.6,5989,21765,26256,42.1,5122,-775,21134,1498,1830,2.9,623882
4091,T001038,Total male and female,CR33  ,West-Noord-Brabant (CR),2015JJ00,2015,623882,511,5826,9.3,5866,9.4,-40,29586,47.4,6589,22997,28111,45,5311,-869,22800,1475,1437,2.3,625319
4092,T001038,Total male and female,CR33  ,West-Noord-Brabant (CR),2016JJ00,2016,625319,513,5912,9.4,5978,9.5,-66,32137,51.3,6989,25148,29396,46.9,5332,-917,24064,2741,2648,4.2,627967
4093,T001038,Total male and female,CR33  ,West-Noord-Brabant (CR),2017JJ00,2017,627967,516,5830,9.3,6056,9.6,-226,34331,54.5,7840,26491,30621,48.6,5671,-1131,24950,3710,3456,5.5,631423
4094,T001038,Total male and female,CR33  ,West-Noord-Brabant (CR),2018JJ00,2018,631423,519,5780,9.1,6070,9.6,-290,33281,52.6,8369,24912,30354,48,6334,-1283,24020,2927,2607,4.1,634030
4095,T001038,Total male and female,CR33  ,West-Noord-Brabant (CR),2019JJ00,2019,634030,521,5698,9,6074,9.6,-376,32796,51.6,7974,24822,30534,48.1,6744,-1704,23790,2262,1874,3,635904
4096,T001038,Total male and female,CR33  ,West-Noord-Brabant (CR),2020JJ00,2020,635904,522,5602,8.8,6658,10.5,-1056,31733,49.9,6623,25110,29530,46.4,5116,-828,24414,2203,1127,1.8,637031
4097,T001038,Total male and female,CR33  ,West-Noord-Brabant (CR),2021JJ00,2021,637031,523,6166,9.7,6768,10.6,-602,32096,50.3,6960,25136,28457,44.6,5365,-900,23092,3639,3030,4.8,640061
4098,T001038,Total male and female,CR33  ,West-Noord-Brabant (CR),2022JJ00,2022,640061,526,5686,8.8,6695,10.4,-1009,36122,56.1,10658,25464,28444,44.2,6182,-877,22262,7678,6657,10.4,646718
4099,T001038,Total male and female,CR33  ,West-Noord-Brabant (CR),2023JJ00,2023,646718,531,5636,8.7,6761,10.4,-1125,35714,55,8871,26843,30116,46.4,6688,-1065,23428,5598,4457,6.9,651175
4170,T001038,Total male and female,CR34  ,Midden-Noord-Brabant (CR),2012JJ00,2012,461329,512,4577,9.9,3750,8.1,827,20092,43.5,3817,16275,19216,41.6,2944,-389,16272,876,1709,3.7,463038
4171,T001038,Total male and female,CR34  ,Midden-Noord-Brabant (CR),2013JJ00,2013,463038,514,4555,9.8,3768,8.1,787,21090,45.4,4279,16811,19680,42.4,2977,-191,16703,1410,2216,4.8,465254
4172,T001038,Total male and female,CR34  ,Midden-Noord-Brabant (CR),2014JJ00,2014,465254,516,4591,9.9,3877,8.3,714,21795,46.8,4460,17335,21081,45.2,3566,-924,17515,714,1429,3.1,466683
4173,T001038,Total male and female,CR34  ,Midden-Noord-Brabant (CR),2015JJ00,2015,466683,518,4513,9.6,4008,8.6,505,23989,51.3,5528,18461,22010,47,3536,-732,18474,1979,2501,5.4,469184
4174,T001038,Total male and female,CR34  ,Midden-Noord-Brabant (CR),2016JJ00,2016,469184,522,4625,9.8,4059,8.6,566,28644,60.9,8391,20253,26663,56.7,3838,-936,22825,1981,2553,5.4,471737
4175,T001038,Total male and female,CR34  ,Midden-Noord-Brabant (CR),2017JJ00,2017,471737,525,4485,9.5,4221,8.9,264,28020,59.2,6364,21656,24776,52.3,3420,-359,21356,3244,3486,7.4,475223
4176,T001038,Total male and female,CR34  ,Midden-Noord-Brabant (CR),2018JJ00,2018,475223,530,4552,9.5,4342,9.1,210,28105,58.9,7349,20756,24585,51.5,4121,-944,20464,3520,3734,7.9,478957
4177,T001038,Total male and female,CR34  ,Midden-Noord-Brabant (CR),2019JJ00,2019,478957,534,4440,9.2,4163,8.7,277,27688,57.6,7883,19805,23757,49.4,4164,-748,19593,3931,4226,8.8,483183
4178,T001038,Total male and female,CR34  ,Midden-Noord-Brabant (CR),2020JJ00,2020,483183,539,4477,9.2,5006,10.3,-529,29804,61.5,8193,21611,26730,55.2,4565,-1046,22165,3074,2555,5.3,485738
4179,T001038,Total male and female,CR34  ,Midden-Noord-Brabant (CR),2021JJ00,2021,493004,534,5013,10.1,4815,9.7,198,31094,62.8,9983,21111,27036,54.6,4380,-688,22656,4058,4262,8.6,497266
4180,T001038,Total male and female,CR34  ,Midden-Noord-Brabant (CR),2022JJ00,2022,497266,539,4630,9.3,4950,9.9,-320,35666,71.3,14766,20900,28824,57.6,5225,-737,23599,6842,6532,13.1,503798
4181,T001038,Total male and female,CR34  ,Midden-Noord-Brabant (CR),2023JJ00,2023,503798,547,4620,9.1,4875,9.6,-255,36150,71.5,14824,21326,32247,63.8,6020,-1086,26227,3903,3676,7.3,507474
4252,T001038,Total male and female,CR35  ,Noordoost-Noord-Brabant (CR),2012JJ00,2012,641417,474,6234,9.7,5134,8,1100,24961,38.9,3522,21439,24738,38.5,2967,-602,21771,223,1332,2.1,642749
4253,T001038,Total male and female,CR35  ,Noordoost-Noord-Brabant (CR),2013JJ00,2013,642749,475,6062,9.4,5110,7.9,952,25060,39,3819,21241,25120,39.1,2903,-406,22217,-60,893,1.4,643642
4254,T001038,Total male and female,CR35  ,Noordoost-Noord-Brabant (CR),2014JJ00,2014,643642,476,6384,9.9,5119,7.9,1265,27621,42.8,4592,23029,26876,41.7,3149,-439,23727,745,2021,3.1,645663
4255,T001038,Total male and female,CR35  ,Noordoost-Noord-Brabant (CR),2015JJ00,2015,645663,477,6039,9.3,5474,8.5,565,29774,46,5065,24709,28372,43.9,3234,-629,25138,1402,1968,3,647631
4256,T001038,Total male and female,CR35  ,Noordoost-Noord-Brabant (CR),2016JJ00,2016,647631,479,6239,9.6,5628,8.7,611,32365,49.8,5180,27185,29541,45.5,3241,-626,26300,2824,3433,5.3,651064
4257,T001038,Total male and female,CR35  ,Noordoost-Noord-Brabant (CR),2017JJ00,2017,651064,481,6160,9.4,5729,8.8,431,32943,50.5,4459,28484,29596,45.3,3143,-584,26453,3347,3758,5.8,654822
4258,T001038,Total male and female,CR35  ,Noordoost-Noord-Brabant (CR),2018JJ00,2018,654822,484,6057,9.2,5908,9,149,32445,49.4,5169,27276,28799,43.9,3276,-632,25523,3646,3794,5.8,658616
4259,T001038,Total male and female,CR35  ,Noordoost-Noord-Brabant (CR),2019JJ00,2019,658616,487,6120,9.3,5863,8.9,257,33149,50.2,5750,27399,28741,43.5,3560,-679,25181,4408,4641,7,663257
4260,T001038,Total male and female,CR35  ,Noordoost-Noord-Brabant (CR),2020JJ00,2020,663257,490,6184,9.3,7057,10.6,-873,33995,51.1,5080,28915,29568,44.5,2975,-517,26593,4427,3533,5.3,666790
4261,T001038,Total male and female,CR35  ,Noordoost-Noord-Brabant (CR),2021JJ00,2021,659524,497,6564,9.9,6522,9.9,42,34130,51.6,5170,28960,29222,44.1,3368,-636,25854,4908,4948,7.5,664472
4262,T001038,Total male and female,CR35  ,Noordoost-Noord-Brabant (CR),2022JJ00,2022,664472,502,6289,9.4,6546,9.8,-257,35942,53.8,9515,26427,27631,41.3,4346,-815,23285,8311,8042,12.1,672514
4263,T001038,Total male and female,CR35  ,Noordoost-Noord-Brabant (CR),2023JJ00,2023,672514,508,6037,8.9,6751,10,-714,34473,51.1,7258,27215,29354,43.5,4605,-1118,24749,5119,4400,6.5,676914
4334,T001038,Total male and female,CR36  ,Zuidoost-Noord-Brabant (CR),2012JJ00,2012,742377,516,7295,9.8,6064,8.2,1231,32450,43.6,7277,25173,31036,41.7,5999,-1290,25037,1414,2642,3.6,745019
4335,T001038,Total male and female,CR36  ,Zuidoost-Noord-Brabant (CR),2013JJ00,2013,745019,518,7091,9.5,6131,8.2,960,34478,46.2,7743,26735,32144,43,6272,-898,25872,2334,3307,4.4,748326
4336,T001038,Total male and female,CR36  ,Zuidoost-Noord-Brabant (CR),2014JJ00,2014,748326,520,7323,9.8,6227,8.3,1096,37155,49.5,8684,28471,34049,45.4,6878,-1138,27171,3106,4197,5.6,752523
4337,T001038,Total male and female,CR36  ,Zuidoost-Noord-Brabant (CR),2015JJ00,2015,752523,523,7178,9.5,6590,8.7,588,39704,52.6,10214,29490,36194,48,7007,-1054,29187,3510,4092,5.4,756615
4338,T001038,Total male and female,CR36  ,Zuidoost-Noord-Brabant (CR),2016JJ00,2016,756615,526,7231,9.5,6691,8.8,540,46472,61.2,13116,33356,41869,55.1,7239,-1151,34630,4603,5148,6.8,761763
4339,T001038,Total male and female,CR36  ,Zuidoost-Noord-Brabant (CR),2017JJ00,2017,761763,529,7054,9.2,6696,8.8,358,48259,63.1,13462,34797,43536,57,7038,-1055,36498,4723,5055,6.6,766818
4340,T001038,Total male and female,CR36  ,Zuidoost-Noord-Brabant (CR),2018JJ00,2018,766818,533,7103,9.2,6830,8.9,273,45870,59.6,12760,33110,39730,51.6,7345,-1081,32385,6140,6385,8.3,773203
4341,T001038,Total male and female,CR36  ,Zuidoost-Noord-Brabant (CR),2019JJ00,2019,773203,537,7201,9.3,6786,8.7,415,47892,61.6,15236,32656,40887,52.6,7264,-1002,33623,7005,7408,9.6,780611
4342,T001038,Total male and female,CR36  ,Zuidoost-Noord-Brabant (CR),2020JJ00,2020,780611,543,7150,9.1,7834,10,-684,48528,62,13941,34587,44053,56.3,7039,-943,37014,4475,3779,4.8,784390
4343,T001038,Total male and female,CR36  ,Zuidoost-Noord-Brabant (CR),2021JJ00,2021,784390,545,7799,9.9,7560,9.6,239,52214,66.3,16965,35249,45770,58.1,7108,-798,38662,6444,6685,8.5,791075
4344,T001038,Total male and female,CR36  ,Zuidoost-Noord-Brabant (CR),2022JJ00,2022,791075,550,7211,9,7509,9.4,-298,60256,75.6,26309,33947,47854,60,8410,-997,39444,12402,12105,15.3,803180
4345,T001038,Total male and female,CR36  ,Zuidoost-Noord-Brabant (CR),2023JJ00,2023,803180,559,7132,8.8,7684,9.5,-552,59669,74,25047,34622,53116,65.9,9279,-1468,43837,6553,5996,7.5,809176
4416,T001038,Total male and female,CR37  ,Noord-Limburg (CR),2012JJ00,2012,280443,337,2564,9.1,2301,8.2,263,8896,31.7,2234,6662,9190,32.8,1587,-204,7603,-294,-25,-0.1,280418
4417,T001038,Total male and female,CR37  ,Noord-Limburg (CR),2013JJ00,2013,280418,337,2515,9,2380,8.5,135,8843,31.5,2369,6474,8881,31.7,1450,-189,7431,-38,99,0.4,280517
4418,T001038,Total male and female,CR37  ,Noord-Limburg (CR),2014JJ00,2014,280517,337,2408,8.6,2274,8.1,134,9815,35,2768,7047,9919,35.4,1616,-185,8303,-104,35,0.1,280552
4419,T001038,Total male and female,CR37  ,Noord-Limburg (CR),2015JJ00,2015,280552,337,2279,8.1,2562,9.1,-283,9966,35.6,2487,7479,10256,36.6,2024,-453,8232,-290,-581,-2.1,279971
4420,T001038,Total male and female,CR37  ,Noord-Limburg (CR),2016JJ00,2016,279971,336,2512,8.9,2475,8.8,37,11588,41.3,3124,8464,10075,35.9,1684,-251,8391,1513,1543,5.5,281514
4421,T001038,Total male and female,CR37  ,Noord-Limburg (CR),2017JJ00,2017,281514,338,2421,8.6,2540,9,-119,11565,41.1,2756,8809,11462,40.7,1954,-383,9508,103,-28,-0.1,281486
4422,T001038,Total male and female,CR37  ,Noord-Limburg (CR),2018JJ00,2018,281486,338,2456,8.7,2604,9.2,-148,10972,38.9,2907,8065,10246,36.4,1901,-375,8345,726,581,2.1,282067
4423,T001038,Total male and female,CR37  ,Noord-Limburg (CR),2019JJ00,2019,282067,339,2330,8.3,2659,9.4,-329,11431,40.5,3384,8047,10554,37.4,2057,-414,8497,877,538,1.9,282605
4424,T001038,Total male and female,CR37  ,Noord-Limburg (CR),2020JJ00,2020,282605,340,2323,8.2,2941,10.4,-618,11944,42.2,3425,8519,10580,37.4,2197,-291,8383,1364,745,2.6,283350
4425,T001038,Total male and female,CR37  ,Noord-Limburg (CR),2021JJ00,2021,283350,341,2607,9.2,2903,10.2,-296,12527,44.1,3629,8898,10411,36.6,2286,-501,8125,2116,1807,6.4,285157
4426,T001038,Total male and female,CR37  ,Noord-Limburg (CR),2022JJ00,2022,285157,343,2411,8.4,2824,9.8,-413,15474,53.9,6727,8747,10971,38.2,3084,-587,7887,4503,4091,14.3,289248
4427,T001038,Total male and female,CR37  ,Noord-Limburg (CR),2023JJ00,2023,289248,348,2313,8,2957,10.2,-644,14462,49.9,5809,8653,12665,43.7,3694,-752,8971,1797,1144,4,290392
4498,T001038,Total male and female,CR38  ,Midden-Limburg (CR),2012JJ00,2012,235418,354,1976,8.4,2191,9.3,-215,9488,40.3,1917,7571,9109,38.7,1298,-177,7811,379,155,0.7,235573
4499,T001038,Total male and female,CR38  ,Midden-Limburg (CR),2013JJ00,2013,235573,354,1955,8.3,2238,9.5,-283,9284,39.4,1840,7444,9249,39.3,1396,-244,7853,35,-238,-1,235335
4500,T001038,Total male and female,CR38  ,Midden-Limburg (CR),2014JJ00,2014,235335,354,1876,8,2235,9.5,-359,9939,42.2,2309,7630,9551,40.6,1327,-183,8224,388,16,0.1,235351
4501,T001038,Total male and female,CR38  ,Midden-Limburg (CR),2015JJ00,2015,235351,354,1983,8.4,2450,10.4,-467,10585,45,2227,8358,10049,42.7,1516,-227,8533,536,78,0.3,235429
4502,T001038,Total male and female,CR38  ,Midden-Limburg (CR),2016JJ00,2016,235429,354,1991,8.4,2341,9.9,-350,12090,51.3,2246,9844,11158,47.3,1403,-249,9755,932,566,2.4,235995
4503,T001038,Total male and female,CR38  ,Midden-Limburg (CR),2017JJ00,2017,235995,355,1939,8.2,2379,10.1,-440,12554,53.1,2038,10516,11410,48.3,1390,-184,10020,1144,692,2.9,236687
4504,T001038,Total male and female,CR38  ,Midden-Limburg (CR),2018JJ00,2018,236687,356,1839,7.8,2406,10.2,-567,11904,50.3,2189,9715,11318,47.8,1470,-284,9848,586,15,0.1,236702
4505,T001038,Total male and female,CR38  ,Midden-Limburg (CR),2019JJ00,2019,236702,356,1850,7.8,2435,10.3,-585,12603,53.2,2778,9825,11293,47.6,1729,-422,9564,1310,710,3,237412
4506,T001038,Total male and female,CR38  ,Midden-Limburg (CR),2020JJ00,2020,237412,357,1909,8,2770,11.6,-861,13023,54.8,2206,10817,11292,47.5,1545,-320,9747,1731,856,3.6,238268
4507,T001038,Total male and female,CR38  ,Midden-Limburg (CR),2021JJ00,2021,238268,358,2139,9,2968,12.4,-829,12550,52.6,2215,10335,10877,45.6,1705,-449,9172,1673,830,3.5,239098
4508,T001038,Total male and female,CR38  ,Midden-Limburg (CR),2022JJ00,2022,239098,360,2003,8.3,2786,11.6,-783,14485,60.3,4008,10477,11330,47.2,2304,-554,9026,3155,2369,9.9,241467
4509,T001038,Total male and female,CR38  ,Midden-Limburg (CR),2023JJ00,2023,241467,364,2011,8.3,2802,11.6,-791,13341,55.1,3292,10049,11425,47.2,2465,-762,8960,1916,1106,4.6,242573
4580,T001038,Total male and female,CR39  ,Zuid-Limburg (CR),2012JJ00,2012,607214,933,4569,7.5,6499,10.7,-1930,30899,50.9,7662,23237,30266,49.9,6010,-801,24256,633,-1314,-2.2,605900
4581,T001038,Total male and female,CR39  ,Zuid-Limburg (CR),2013JJ00,2013,605900,932,4541,7.5,6441,10.6,-1900,30677,50.7,7836,22841,30515,50.4,6712,-663,23803,162,-1746,-2.9,604154
4582,T001038,Total male and female,CR39  ,Zuid-Limburg (CR),2014JJ00,2014,604154,929,4557,7.6,6414,10.6,-1857,32070,53.2,8116,23954,32309,53.6,7221,-763,25088,-239,-2116,-3.5,602038
4583,T001038,Total male and female,CR39  ,Zuid-Limburg (CR),2015JJ00,2015,602038,925,4477,7.4,6802,11.3,-2325,34840,57.9,9878,24962,33680,56,7310,-541,26370,1160,-1178,-2,600860
4584,T001038,Total male and female,CR39  ,Zuid-Limburg (CR),2016JJ00,2016,600860,924,4491,7.5,6723,11.2,-2232,36174,60.2,9464,26710,34754,57.9,7123,-517,27631,1420,-823,-1.4,600037
4585,T001038,Total male and female,CR39  ,Zuid-Limburg (CR),2017JJ00,2017,600037,923,4461,7.4,6926,11.6,-2465,37055,61.8,9597,27458,35567,59.3,7712,-653,27855,1488,-1012,-1.7,599025
4586,T001038,Total male and female,CR39  ,Zuid-Limburg (CR),2018JJ00,2018,599025,921,4415,7.4,6906,11.5,-2491,36864,61.6,10052,26812,36018,60.2,8776,-618,27242,846,-1657,-2.8,597368
4587,T001038,Total male and female,CR39  ,Zuid-Limburg (CR),2019JJ00,2019,597368,919,4488,7.5,6913,11.6,-2425,37556,62.9,10813,26743,35293,59.1,8340,-315,26953,2263,-184,-0.3,597184
4588,T001038,Total male and female,CR39  ,Zuid-Limburg (CR),2020JJ00,2020,597184,919,4420,7.4,7914,13.3,-3494,37728,63.3,9413,28315,37132,62.3,9126,-412,28006,596,-2930,-4.9,594254
4589,T001038,Total male and female,CR39  ,Zuid-Limburg (CR),2021JJ00,2021,594254,914,4689,7.9,8054,13.6,-3365,39388,66.3,10512,28876,36192,60.9,8332,-505,27860,3196,-207,-0.3,594047
4590,T001038,Total male and female,CR39  ,Zuid-Limburg (CR),2022JJ00,2022,594047,915,4509,7.6,7412,12.4,-2903,42142,70.7,14447,27695,35605,59.8,9131,-511,26474,6537,3605,6.1,597652
4591,T001038,Total male and female,CR39  ,Zuid-Limburg (CR),2023JJ00,2023,597652,921,4457,7.4,7475,12.5,-3018,41338,69,12854,28484,35676,59.6,9088,-680,26588,5662,2638,4.4,600290
4662,T001038,Total male and female,CR40  ,Flevoland (CR),2012JJ00,2012,395525,279,4991,12.6,2213,5.6,2778,16014,40.3,3696,12318,15890,40,2596,-215,13294,124,2916,7.4,398441
4663,T001038,Total male and female,CR40  ,Flevoland (CR),2013JJ00,2013,398441,282,4687,11.7,2247,5.6,2440,16417,41.1,4779,11638,17415,43.6,3501,-764,13914,-998,1452,3.6,399893
4664,T001038,Total male and female,CR40  ,Flevoland (CR),2014JJ00,2014,399893,283,4922,12.3,2136,5.3,2786,18098,45.1,5993,12105,19281,48.1,3807,-498,15474,-1183,1898,4.7,401791
4665,T001038,Total male and female,CR40  ,Flevoland (CR),2015JJ00,2015,401791,284,4735,11.8,2260,5.6,2475,21202,52.6,7251,13951,21412,53.1,4267,-685,17145,-210,2277,5.7,404068
4666,T001038,Total male and female,CR40  ,Flevoland (CR),2016JJ00,2016,404068,286,4706,11.6,2377,5.9,2329,23159,57,6618,16541,21744,53.6,3792,-540,17952,1415,3750,9.3,407818
4667,T001038,Total male and female,CR40  ,Flevoland (CR),2017JJ00,2017,407818,289,4565,11.1,2282,5.6,2283,22579,55.1,4890,17689,20997,51.2,3806,-463,17191,1582,3852,9.4,411670
4668,T001038,Total male and female,CR40  ,Flevoland (CR),2018JJ00,2018,411670,292,4793,11.6,2486,6,2307,22825,55.1,5447,17378,20244,48.9,3688,-295,16556,2581,4876,11.8,416546
4669,T001038,Total male and female,CR40  ,Flevoland (CR),2019JJ00,2019,416546,295,4892,11.7,2469,5.9,2423,25055,59.7,6782,18273,20982,50,4059,-349,16923,4073,6475,15.5,423021
4670,T001038,Total male and female,CR40  ,Flevoland (CR),2020JJ00,2020,423021,300,4871,11.4,2740,6.4,2131,24357,57.2,4932,19425,21291,50,3385,-361,17906,3066,5205,12.3,428226
4671,T001038,Total male and female,CR40  ,Flevoland (CR),2021JJ00,2021,428226,303,5179,12,2945,6.8,2234,26695,61.9,5558,21137,22379,51.9,4180,-663,18199,4316,6545,15.3,434771
4672,T001038,Total male and female,CR40  ,Flevoland (CR),2022JJ00,2022,434771,308,5099,11.6,2877,6.5,2222,31718,72.1,10821,20897,23976,54.5,5689,-797,18287,7742,9930,22.8,444701
4673,T001038,Total male and female,CR40  ,Flevoland (CR),2023JJ00,2023,444701,315,4966,11.1,2912,6.5,2054,28933,64.6,7829,21104,24838,55.5,6456,-1198,18382,4095,6125,13.8,450826
4744,T001038,Total male and female,GM1680,Aa en Hunze,2012JJ00,2012,25738,93,170,6.6,260,10.1,-90,1084,42.3,89,995,1192,46.5,174,-131,1018,-108,-197,-7.7,25541
4745,T001038,Total male and female,GM1680,Aa en Hunze,2013JJ00,2013,25541,92,164,6.4,235,9.2,-71,1051,41.3,71,980,1165,45.8,75,-22,1090,-114,-184,-7.2,25357
4746,T001038,Total male and female,GM1680,Aa en Hunze,2014JJ00,2014,25357,92,159,6.3,240,9.5,-81,1103,43.6,53,1050,1177,46.6,89,-12,1088,-74,-154,-6.1,25203
4747,T001038,Total male and female,GM1680,Aa en Hunze,2015JJ00,2015,25203,91,167,6.6,250,9.9,-83,1377,54.6,69,1308,1249,49.5,66,1,1183,128,40,1.6,25243
4748,T001038,Total male and female,GM1680,Aa en Hunze,2016JJ00,2016,25243,91,136,5.4,274,10.8,-138,1457,57.7,83,1374,1280,50.7,92,-4,1188,177,43,1.7,25286
4749,T001038,Total male and female,GM1680,Aa en Hunze,2017JJ00,2017,25286,92,164,6.5,265,10.5,-101,1682,66.4,90,1592,1472,58.1,79,-13,1393,210,104,4.1,25390
4750,T001038,Total male and female,GM1680,Aa en Hunze,2018JJ00,2018,25390,92,162,6.4,283,11.1,-121,1501,59.1,87,1414,1384,54.5,81,-9,1303,117,-4,-0.2,25386
4751,T001038,Total male and female,GM1680,Aa en Hunze,2019JJ00,2019,25386,92,176,6.9,280,11,-104,1512,59.5,101,1411,1349,53.1,44,4,1305,163,59,2.3,25445
4752,T001038,Total male and female,GM1680,Aa en Hunze,2020JJ00,2020,25445,92,167,6.6,274,10.8,-107,1520,59.8,55,1465,1459,57.4,64,-12,1395,61,-46,-1.8,25399
4753,T001038,Total male and female,GM1680,Aa en Hunze,2021JJ00,2021,25399,92,199,7.8,283,11.1,-84,1501,58.9,62,1439,1237,48.5,57,-4,1180,264,180,7.1,25579
4754,T001038,Total male and female,GM1680,Aa en Hunze,2022JJ00,2022,25579,93,181,7.1,307,12,-126,1546,60.3,352,1194,1275,49.7,148,-25,1127,271,145,5.7,25724
4755,T001038,Total male and female,GM1680,Aa en Hunze,2023JJ00,2023,25724,93,187,7.3,307,11.9,-120,1550,60.1,219,1331,1310,50.8,127,-25,1183,240,121,4.7,25845
4908,T001038,Total male and female,GM0738,Aalburg,2012JJ00,2012,12749,253,146,11.4,88,6.9,58,364,28.5,48,316,396,31,49,-7,347,-32,25,2,12774
4909,T001038,Total male and female,GM0738,Aalburg,2013JJ00,2013,12774,253,141,11,100,7.8,41,375,29.3,57,318,344,26.9,22,-1,322,31,72,5.6,12846
4910,T001038,Total male and female,GM0738,Aalburg,2014JJ00,2014,12846,255,152,11.8,100,7.8,52,436,33.8,62,374,414,32.1,38,-13,376,22,76,5.9,12922
4911,T001038,Total male and female,GM0738,Aalburg,2015JJ00,2015,12922,256,160,12.3,113,8.7,47,502,38.7,82,420,440,33.9,38,-4,402,62,116,9,13038
4912,T001038,Total male and female,GM0738,Aalburg,2016JJ00,2016,13038,259,152,11.6,114,8.7,38,461,35.3,58,403,465,35.6,41,-13,424,-4,29,2.2,13067
4913,T001038,Total male and female,GM0738,Aalburg,2017JJ00,2017,13067,259,135,10.3,90,6.9,45,562,42.9,66,496,521,39.7,22,-1,499,41,86,6.6,13153
4914,T001038,Total male and female,GM0738,Aalburg,2018JJ00,2018,13153,261,153,11.6,84,6.3,69,626,47.3,97,529,545,41.2,38,-1,507,81,168,12.8,13321
4990,T001038,Total male and female,GM0358,Aalsmeer,2012JJ00,2012,30364,1486,333,10.9,211,6.9,122,1212,39.7,268,944,1083,35.5,185,-21,898,129,254,8.4,30618
4991,T001038,Total male and female,GM0358,Aalsmeer,2013JJ00,2013,30618,1501,342,11.1,221,7.2,121,1240,40.4,275,965,1218,39.7,232,-68,986,22,141,4.6,30759
4992,T001038,Total male and female,GM0358,Aalsmeer,2014JJ00,2014,30759,1508,291,9.4,228,7.4,63,1502,48.6,337,1165,1245,40.3,182,-36,1063,257,318,10.3,31077
4993,T001038,Total male and female,GM0358,Aalsmeer,2015JJ00,2015,31077,1523,293,9.4,230,7.4,63,1601,51.3,373,1228,1440,46.2,240,-63,1200,161,222,7.1,31299
4994,T001038,Total male and female,GM0358,Aalsmeer,2016JJ00,2016,31299,1555,260,8.3,243,7.8,17,1748,55.8,316,1432,1691,54,228,-60,1463,57,74,2.4,31373
4995,T001038,Total male and female,GM0358,Aalsmeer,2017JJ00,2017,31373,1559,249,7.9,274,8.7,-25,1797,57.2,309,1488,1647,52.4,265,-50,1382,150,126,4,31499
4996,T001038,Total male and female,GM0358,Aalsmeer,2018JJ00,2018,31499,1566,281,8.9,279,8.8,2,1674,53,301,1373,1447,45.8,262,-50,1185,227,229,7.3,31728
4997,T001038,Total male and female,GM0358,Aalsmeer,2019JJ00,2019,31728,1577,236,7.4,270,8.5,-34,1626,51.1,353,1273,1461,46,229,-40,1232,165,131,4.1,31859
4998,T001038,Total male and female,GM0358,Aalsmeer,2020JJ00,2020,31859,1583,271,8.5,277,8.7,-6,1865,58.4,327,1538,1725,54,220,-28,1505,140,132,4.1,31991
4999,T001038,Total male and female,GM0358,Aalsmeer,2021JJ00,2021,31991,1590,324,10.1,237,7.4,87,2073,64.3,688,1385,1697,52.7,266,-61,1431,376,461,14.4,32452
5000,T001038,Total male and female,GM0358,Aalsmeer,2022JJ00,2022,32452,1615,257,7.8,270,8.2,-13,2451,74.8,978,1473,1823,55.7,534,-121,1289,628,611,18.8,33063
5001,T001038,Total male and female,GM0358,Aalsmeer,2023JJ00,2023,33063,1645,238,7.2,298,9,-60,2547,76.8,1041,1506,2272,68.5,928,-76,1344,275,216,6.5,33279
5072,T001038,Total male and female,GM0197,Aalten,2012JJ00,2012,27305,283,256,9.4,235,8.6,21,661,24.3,61,600,906,33.3,83,-32,823,-245,-223,-8.2,27082
5073,T001038,Total male and female,GM0197,Aalten,2013JJ00,2013,27082,281,241,8.9,245,9.1,-4,637,23.6,71,566,703,26,73,0,630,-66,-69,-2.5,27013
5074,T001038,Total male and female,GM0197,Aalten,2014JJ00,2014,27013,280,227,8.4,244,9.1,-17,679,25.2,86,593,773,28.7,86,-3,687,-94,-109,-4,26904
5075,T001038,Total male and female,GM0197,Aalten,2015JJ00,2015,26904,279,249,9.3,257,9.6,-8,789,29.3,95,694,774,28.8,92,1,682,15,8,0.3,26912
5076,T001038,Total male and female,GM0197,Aalten,2016JJ00,2016,26912,279,234,8.7,255,9.5,-21,1262,46.8,288,974,1103,40.9,71,-1,1032,159,135,5,27047
5077,T001038,Total male and female,GM0197,Aalten,2017JJ00,2017,27047,280,219,8.1,268,9.9,-49,1171,43.4,140,1031,1208,44.7,99,-30,1109,-37,-85,-3.1,26962
5078,T001038,Total male and female,GM0197,Aalten,2018JJ00,2018,26962,279,220,8.2,277,10.3,-57,944,35,124,820,836,31,116,-7,720,108,49,1.8,27011
5079,T001038,Total male and female,GM0197,Aalten,2019JJ00,2019,27011,280,240,8.9,256,9.5,-16,950,35.1,123,827,823,30.4,98,-25,725,127,110,4.1,27121
5080,T001038,Total male and female,GM0197,Aalten,2020JJ00,2020,27121,281,254,9.4,289,10.7,-35,824,30.4,119,705,790,29.1,80,-12,710,34,-1,0,27120
5081,T001038,Total male and female,GM0197,Aalten,2021JJ00,2021,27120,281,257,9.5,310,11.4,-53,916,33.8,107,809,882,32.5,132,-33,750,34,-20,-0.7,27100
5082,T001038,Total male and female,GM0197,Aalten,2022JJ00,2022,27100,281,237,8.7,306,11.3,-69,969,35.7,236,733,756,27.8,130,-44,626,213,144,5.3,27244
5083,T001038,Total male and female,GM0197,Aalten,2023JJ00,2023,27244,282,220,8.1,286,10.5,-66,952,34.9,184,768,822,30.1,140,-49,682,130,64,2.3,27308
5646,T001038,Total male and female,GM0059,Achtkarspelen,2012JJ00,2012,28091,274,297,10.6,244,8.7,53,780,27.8,59,721,813,28.9,33,-10,780,-33,19,0.7,28110
5647,T001038,Total male and female,GM0059,Achtkarspelen,2013JJ00,2013,28110,275,293,10.4,222,7.9,71,682,24.3,43,639,847,30.2,61,-19,786,-165,-94,-3.3,28016
5648,T001038,Total male and female,GM0059,Achtkarspelen,2014JJ00,2014,28016,274,277,9.9,214,7.6,63,765,27.3,44,721,861,30.8,41,-7,820,-96,-33,-1.2,27983
5649,T001038,Total male and female,GM0059,Achtkarspelen,2015JJ00,2015,27983,274,289,10.3,240,8.6,49,946,33.8,64,882,972,34.7,34,-8,938,-26,24,0.9,28007
5650,T001038,Total male and female,GM0059,Achtkarspelen,2016JJ00,2016,28007,274,295,10.6,274,9.8,21,950,34,29,921,1084,38.8,61,-10,1023,-134,-114,-4.1,27893
5651,T001038,Total male and female,GM0059,Achtkarspelen,2017JJ00,2017,27893,273,269,9.6,228,8.2,41,1022,36.6,34,988,1022,36.6,43,-3,979,0,42,1.5,27935
5652,T001038,Total male and female,GM0059,Achtkarspelen,2018JJ00,2018,27935,273,263,9.4,252,9,11,1024,36.7,62,962,1117,40,46,-7,1071,-93,-83,-3,27852
5653,T001038,Total male and female,GM0059,Achtkarspelen,2019JJ00,2019,27852,272,288,10.3,234,8.4,54,1090,39.1,51,1039,1154,41.4,65,-6,1089,-64,-9,-0.3,27843
5654,T001038,Total male and female,GM0059,Achtkarspelen,2020JJ00,2020,27843,272,277,9.9,235,8.4,42,997,35.8,64,933,982,35.2,31,-6,951,15,57,2,27900
5655,T001038,Total male and female,GM0059,Achtkarspelen,2021JJ00,2021,27900,273,285,10.2,306,11,-21,1011,36.2,46,965,937,33.6,45,-14,892,74,54,1.9,27954
5656,T001038,Total male and female,GM0059,Achtkarspelen,2022JJ00,2022,27954,273,269,9.6,248,8.8,21,1203,42.9,308,895,1028,36.6,126,-55,902,175,195,7,28149
5657,T001038,Total male and female,GM0059,Achtkarspelen,2023JJ00,2023,28149,275,270,9.6,266,9.4,4,1160,41.2,230,930,1086,38.5,145,-57,941,74,77,2.7,28226
6056,T001038,Total male and female,GM0482,Alblasserdam,2012JJ00,2012,19467,2215,241,12.3,172,8.8,69,684,35,49,635,575,29.4,64,-5,511,109,176,9,19643
6057,T001038,Total male and female,GM0482,Alblasserdam,2013JJ00,2013,19643,2240,245,12.4,143,7.3,102,653,33.1,43,610,597,30.3,45,-7,552,56,158,8,19801
6058,T001038,Total male and female,GM0482,Alblasserdam,2014JJ00,2014,19801,2258,272,13.7,164,8.3,108,618,31.2,73,545,682,34.4,63,-10,619,-64,44,2.2,19845
6059,T001038,Total male and female,GM0482,Alblasserdam,2015JJ00,2015,19845,2263,247,12.4,184,9.2,63,740,37.2,83,657,693,34.8,75,-15,618,47,110,5.5,19955
6060,T001038,Total male and female,GM0482,Alblasserdam,2016JJ00,2016,19955,2270,245,12.3,174,8.7,71,752,37.6,68,684,769,38.5,57,-12,712,-17,53,2.7,20008
6061,T001038,Total male and female,GM0482,Alblasserdam,2017JJ00,2017,20008,2276,236,11.8,185,9.2,51,790,39.5,81,709,832,41.6,55,2,777,-42,6,0.3,20014
6062,T001038,Total male and female,GM0482,Alblasserdam,2018JJ00,2018,20014,2279,254,12.7,154,7.7,100,758,37.8,84,674,802,40,52,-7,750,-44,55,2.7,20069
6063,T001038,Total male and female,GM0482,Alblasserdam,2019JJ00,2019,20069,2286,226,11.2,193,9.6,33,848,42.2,78,770,785,39,40,0,745,63,96,4.8,20165
6064,T001038,Total male and female,GM0482,Alblasserdam,2020JJ00,2020,20165,2297,205,10.2,192,9.5,13,821,40.7,57,764,864,42.9,44,-4,820,-43,-29,-1.4,20136
6065,T001038,Total male and female,GM0482,Alblasserdam,2021JJ00,2021,20136,2293,257,12.8,227,11.3,30,822,40.9,63,759,899,44.7,43,-5,856,-77,-49,-2.4,20087
6066,T001038,Total male and female,GM0482,Alblasserdam,2022JJ00,2022,20087,2290,229,11.3,187,9.2,42,1139,56.3,325,814,911,45.1,96,-24,815,228,269,13.4,20356
6067,T001038,Total male and female,GM0482,Alblasserdam,2023JJ00,2023,20356,2321,227,11.2,162,8,65,920,45.2,196,724,1027,50.5,137,-61,890,-107,-42,-2.1,20314
6138,T001038,Total male and female,GM0613,Albrandswaard,2012JJ00,2012,25003,1143,264,10.5,187,7.5,77,1061,42.4,89,972,1040,41.5,41,32,999,21,98,3.9,25101
6139,T001038,Total male and female,GM0613,Albrandswaard,2013JJ00,2013,25101,1151,257,10.2,164,6.5,93,980,39.1,72,908,1105,44.1,45,39,1060,-125,-32,-1.3,25069
6140,T001038,Total male and female,GM0613,Albrandswaard,2014JJ00,2014,25069,1149,268,10.7,166,6.6,102,1171,46.6,58,1113,1196,47.6,54,38,1142,-25,79,3.2,25148
6141,T001038,Total male and female,GM0613,Albrandswaard,2015JJ00,2015,25148,1153,217,8.7,178,7.1,39,1214,48.4,82,1132,1419,56.6,101,-6,1318,-205,-163,-6.5,24985
6142,T001038,Total male and female,GM0613,Albrandswaard,2016JJ00,2016,24985,1150,236,9.4,182,7.3,54,1600,63.9,100,1500,1531,61.1,116,-15,1415,69,120,4.8,25105
6143,T001038,Total male and female,GM0613,Albrandswaard,2017JJ00,2017,25105,1155,229,9.1,172,6.8,57,1518,60.3,79,1439,1461,58.1,127,-21,1334,57,113,4.5,25218
6144,T001038,Total male and female,GM0613,Albrandswaard,2018JJ00,2018,25218,1163,209,8.3,191,7.6,18,1384,54.8,104,1280,1348,53.4,80,-28,1268,36,53,2.1,25271
6145,T001038,Total male and female,GM0613,Albrandswaard,2019JJ00,2019,25271,1165,209,8.2,157,6.2,52,1618,63.6,97,1521,1350,53.1,66,-12,1284,268,319,12.6,25590
6146,T001038,Total male and female,GM0613,Albrandswaard,2020JJ00,2020,25590,1180,226,8.8,207,8.1,19,1650,64.2,72,1578,1447,56.3,48,-5,1399,203,224,8.8,25814
6147,T001038,Total male and female,GM0613,Albrandswaard,2021JJ00,2021,25814,1190,240,9.3,191,7.4,49,1522,58.8,95,1427,1452,56.1,74,-13,1378,70,120,4.6,25934
6148,T001038,Total male and female,GM0613,Albrandswaard,2022JJ00,2022,25934,1197,237,9.1,174,6.7,63,1620,62,173,1447,1261,48.2,88,-12,1173,359,423,16.3,26357
6149,T001038,Total male and female,GM0613,Albrandswaard,2023JJ00,2023,26357,1216,214,8.1,168,6.4,46,1380,52.3,110,1270,1355,51.3,98,-9,1257,25,71,2.7,26428
6384,T001038,Total male and female,GM0361,Alkmaar,2012JJ00,2012,94269,3222,1089,11.5,784,8.3,305,4554,48.2,773,3781,4631,49.1,776,-197,3855,-77,236,2.5,94505
6385,T001038,Total male and female,GM0361,Alkmaar,2013JJ00,2013,94505,3228,1038,11,768,8.1,270,4401,46.5,790,3611,4310,45.5,539,-74,3771,91,361,3.8,94866
6386,T001038,Total male and female,GM0361,Alkmaar,2014JJ00,2014,94866,3240,1100,11.6,756,8,344,4616,48.6,874,3742,4586,48.2,524,-22,4062,30,382,4,95248
6387,T001038,Total male and female,GM0361,Alkmaar,2015JJ00,2015,107106,969,1120,10.4,895,8.3,225,5754,53.6,1121,4633,5460,50.9,648,-6,4812,294,509,4.8,107615
6388,T001038,Total male and female,GM0361,Alkmaar,2016JJ00,2016,107615,974,1150,10.6,979,9.1,171,6581,60.9,1106,5475,5997,55.5,738,-109,5259,584,758,7,108373
6389,T001038,Total male and female,GM0361,Alkmaar,2017JJ00,2017,108373,981,1089,10,862,8,227,6110,56.4,783,5327,6239,57.5,620,-85,5619,-129,97,0.9,108470
6390,T001038,Total male and female,GM0361,Alkmaar,2018JJ00,2018,108470,982,1076,9.9,898,8.3,178,5635,51.9,831,4804,5716,52.7,735,-216,4981,-81,88,0.8,108558
6391,T001038,Total male and female,GM0361,Alkmaar,2019JJ00,2019,108558,983,1109,10.2,899,8.2,210,5850,53.7,886,4964,5178,47.5,584,-71,4594,672,878,8.1,109436
6392,T001038,Total male and female,GM0361,Alkmaar,2020JJ00,2020,109436,991,1025,9.3,969,8.8,56,5841,53.3,734,5107,5423,49.5,552,-48,4871,418,460,4.2,109896
6393,T001038,Total male and female,GM0361,Alkmaar,2021JJ00,2021,109896,995,1183,10.7,1026,9.3,157,6124,55.5,762,5362,5391,48.9,620,-78,4771,733,887,8.1,110783
6394,T001038,Total male and female,GM0361,Alkmaar,2022JJ00,2022,110783,1004,1069,9.6,1089,9.8,-20,6508,58.5,1502,5006,5433,48.8,703,-127,4730,1075,1051,9.5,111834
6395,T001038,Total male and female,GM0361,Alkmaar,2023JJ00,2023,111834,1014,1002,8.9,1083,9.7,-81,5956,53.1,917,5039,5394,48.1,730,-136,4664,562,470,4.2,112304
6466,T001038,Total male and female,GM0141,Almelo,2012JJ00,2012,72757,1079,724,10,631,8.7,93,2599,35.7,537,2062,2725,37.5,378,-98,2347,-126,-28,-0.4,72729
6467,T001038,Total male and female,GM0141,Almelo,2013JJ00,2013,72729,1081,766,10.6,705,9.7,61,2447,33.7,494,1953,2783,38.3,409,-127,2374,-336,-270,-3.7,72459
6468,T001038,Total male and female,GM0141,Almelo,2014JJ00,2014,72459,1077,722,10,633,8.7,89,2378,32.9,400,1978,2633,36.4,364,-56,2269,-255,-168,-2.3,72291
6469,T001038,Total male and female,GM0141,Almelo,2015JJ00,2015,72291,1074,759,10.5,704,9.7,55,2809,38.8,543,2266,2734,37.8,366,-103,2368,75,134,1.9,72425
6470,T001038,Total male and female,GM0141,Almelo,2016JJ00,2016,72425,1076,705,9.7,745,10.3,-40,3023,41.7,599,2424,2926,40.4,348,-63,2578,97,54,0.7,72479
6471,T001038,Total male and female,GM0141,Almelo,2017JJ00,2017,72479,1077,657,9.1,742,10.2,-85,3356,46.3,490,2866,3119,43,367,-104,2752,237,150,2.1,72629
6472,T001038,Total male and female,GM0141,Almelo,2018JJ00,2018,72629,1080,639,8.8,690,9.5,-51,3359,46.2,658,2701,3087,42.4,429,-87,2658,272,220,3,72849
6473,T001038,Total male and female,GM0141,Almelo,2019JJ00,2019,72849,1083,713,9.8,702,9.6,11,3210,44,640,2570,2958,40.5,366,-95,2592,252,258,3.5,73107
6474,T001038,Total male and female,GM0141,Almelo,2020JJ00,2020,73107,1087,673,9.2,795,10.9,-122,3080,42.1,543,2537,2929,40.1,345,-82,2584,151,25,0.3,73132
6475,T001038,Total male and female,GM0141,Almelo,2021JJ00,2021,73132,1087,662,9.1,858,11.7,-196,3222,44.1,552,2670,2998,41,473,-157,2525,224,23,0.3,73155
6476,T001038,Total male and female,GM0141,Almelo,2022JJ00,2022,73155,1089,687,9.3,762,10.4,-75,4039,54.9,1145,2894,3157,42.9,513,-114,2644,882,794,10.9,73949
6477,T001038,Total male and female,GM0141,Almelo,2023JJ00,2023,73949,1101,620,8.4,806,10.9,-186,3794,51.2,878,2916,3239,43.7,599,-195,2640,555,368,5,74317
6548,T001038,Total male and female,GM0034,Almere,2012JJ00,2012,193163,1490,2488,12.8,973,5,1515,7999,41.2,1769,6230,7467,38.5,1299,248,6168,532,2050,10.6,195213
6549,T001038,Total male and female,GM0034,Almere,2013JJ00,2013,195213,1510,2319,11.9,935,4.8,1384,7722,39.5,1941,5781,8312,42.5,1789,-45,6523,-590,800,4.1,196013
6550,T001038,Total male and female,GM0034,Almere,2014JJ00,2014,196013,1516,2398,12.2,857,4.4,1541,8189,41.7,2217,5972,8806,44.8,1874,-141,6932,-617,919,4.7,196932
6551,T001038,Total male and female,GM0034,Almere,2015JJ00,2015,196932,1523,2345,11.9,932,4.7,1413,9104,46.1,2206,6898,9310,47.1,2012,-452,7298,-206,1213,6.2,198145
6552,T001038,Total male and female,GM0034,Almere,2016JJ00,2016,198145,1533,2359,11.8,980,4.9,1379,10426,52.3,2339,8087,9034,45.3,1623,-92,7411,1392,2769,14,200914
6553,T001038,Total male and female,GM0034,Almere,2017JJ00,2017,200914,1555,2299,11.4,942,4.7,1357,10805,53.4,2165,8640,9075,44.8,1511,-64,7564,1730,3076,15.3,203990
6554,T001038,Total male and female,GM0034,Almere,2018JJ00,2018,203990,1579,2362,11.5,1016,4.9,1346,11564,56.2,2469,9095,8984,43.6,1495,31,7489,2580,3914,19.2,207904
6555,T001038,Total male and female,GM0034,Almere,2019JJ00,2019,207904,1609,2558,12.2,1025,4.9,1533,12209,58.2,2685,9524,9733,46.4,1564,-46,8169,2476,3989,19.2,211893
6556,T001038,Total male and female,GM0034,Almere,2020JJ00,2020,211893,1640,2503,11.7,1084,5.1,1419,11748,55.1,2131,9617,10348,48.5,1407,-21,8941,1400,2822,13.3,214715
6557,T001038,Total male and female,GM0034,Almere,2021JJ00,2021,214715,1662,2618,12.1,1223,5.7,1395,12427,57.5,2252,10175,10710,49.5,1675,-253,9035,1717,3113,14.5,217828
6558,T001038,Total male and female,GM0034,Almere,2022JJ00,2022,217828,1686,2599,11.8,1234,5.6,1365,14907,67.7,4229,10678,11255,51.1,2113,-270,9142,3652,4997,22.9,222825
6559,T001038,Total male and female,GM0034,Almere,2023JJ00,2023,222825,1725,2543,11.3,1241,5.5,1302,13692,60.9,3457,10235,11309,50.3,2407,-454,8902,2383,3675,16.5,226500
6712,T001038,Total male and female,GM0484,Alphen aan den Rijn,2012JJ00,2012,72853,1324,841,11.5,526,7.2,315,2191,30.1,339,1852,2450,33.6,375,-91,2075,-259,60,0.8,72913
6713,T001038,Total male and female,GM0484,Alphen aan den Rijn,2013JJ00,2013,72913,1327,803,11,515,7.1,288,2289,31.3,360,1929,2406,33,345,-16,2061,-117,211,2.9,73124
6714,T001038,Total male and female,GM0484,Alphen aan den Rijn,2014JJ00,2014,106785,844,1118,10.4,752,7,366,3642,34,593,3049,3368,31.5,520,-93,2848,274,611,5.7,107396
6715,T001038,Total male and female,GM0484,Alphen aan den Rijn,2015JJ00,2015,107396,849,1093,10.2,822,7.6,271,4009,37.2,681,3328,3717,34.5,470,-66,3247,292,564,5.3,107960
6716,T001038,Total male and female,GM0484,Alphen aan den Rijn,2016JJ00,2016,107960,854,1091,10.1,842,7.8,249,4880,45,820,4060,4176,38.5,612,-96,3564,704,955,8.8,108915
6717,T001038,Total male and female,GM0484,Alphen aan den Rijn,2017JJ00,2017,108915,861,1081,9.9,817,7.5,264,4783,43.8,738,4045,4275,39.1,558,-53,3717,508,767,7,109682
6718,T001038,Total male and female,GM0484,Alphen aan den Rijn,2018JJ00,2018,109682,869,1062,9.6,843,7.6,219,5252,47.6,1026,4226,4169,37.8,709,-142,3460,1083,1304,11.9,110986
6719,T001038,Total male and female,GM0484,Alphen aan den Rijn,2019JJ00,2019,110986,879,1110,10,869,7.8,241,4918,44.1,987,3931,4250,38.1,719,-83,3531,668,911,8.2,111897
6720,T001038,Total male and female,GM0484,Alphen aan den Rijn,2020JJ00,2020,111897,886,1103,9.8,943,8.4,160,5038,44.9,772,4266,4507,40.2,575,-67,3932,531,690,6.2,112587
6721,T001038,Total male and female,GM0484,Alphen aan den Rijn,2021JJ00,2021,112587,892,1191,10.6,973,8.6,218,4744,42.1,773,3971,4622,41,546,-107,4076,122,339,3,112926
6722,T001038,Total male and female,GM0484,Alphen aan den Rijn,2022JJ00,2022,112926,897,1098,9.7,997,8.8,101,5874,51.7,1616,4258,4717,41.5,848,-295,3869,1157,1256,11.1,114182
6723,T001038,Total male and female,GM0484,Alphen aan den Rijn,2023JJ00,2023,114182,907,1146,10,968,8.4,178,5338,46.6,995,4343,4734,41.3,871,-266,3863,604,784,6.9,114966
6876,T001038,Total male and female,GM1723,Alphen-Chaam,2012JJ00,2012,9525,102,78,8.1,77,8,1,469,48.9,56,413,354,36.9,37,-4,317,115,115,12.1,9640
6877,T001038,Total male and female,GM1723,Alphen-Chaam,2013JJ00,2013,9640,104,56,5.8,71,7.3,-15,489,50.5,54,435,399,41.2,30,4,369,90,77,8,9717
6878,T001038,Total male and female,GM1723,Alphen-Chaam,2014JJ00,2014,9717,104,74,7.6,61,6.3,13,461,47.4,71,390,437,44.9,50,-7,387,24,36,3.7,9753
6879,T001038,Total male and female,GM1723,Alphen-Chaam,2015JJ00,2015,9753,105,80,8.1,67,6.8,13,552,56.1,55,497,394,40,50,-9,344,158,171,17.5,9924
6880,T001038,Total male and female,GM1723,Alphen-Chaam,2016JJ00,2016,9924,107,94,9.4,69,6.9,25,574,57.5,84,490,463,46.3,50,-5,413,111,134,13.5,10058
6881,T001038,Total male and female,GM1723,Alphen-Chaam,2017JJ00,2017,10058,108,80,7.9,88,8.7,-8,560,55.6,65,495,527,52.3,54,-4,473,33,25,2.5,10083
6882,T001038,Total male and female,GM1723,Alphen-Chaam,2018JJ00,2018,10083,108,96,9.5,76,7.5,20,557,55.1,79,478,510,50.4,48,-11,462,47,66,6.5,10149
6883,T001038,Total male and female,GM1723,Alphen-Chaam,2019JJ00,2019,10149,109,91,8.9,94,9.2,-3,548,53.9,71,477,492,48.3,77,-4,415,56,54,5.3,10203
6884,T001038,Total male and female,GM1723,Alphen-Chaam,2020JJ00,2020,10203,110,90,8.7,104,10.1,-14,700,68,93,607,515,50.1,57,7,458,185,170,16.7,10373
6885,T001038,Total male and female,GM1723,Alphen-Chaam,2021JJ00,2021,10373,111,102,9.8,93,8.9,9,546,52.5,49,497,503,48.4,75,-14,428,43,52,5,10425
6886,T001038,Total male and female,GM1723,Alphen-Chaam,2022JJ00,2022,10425,112,85,8.1,120,11.5,-35,566,54.2,116,450,494,47.3,87,-3,407,72,38,3.6,10463
6887,T001038,Total male and female,GM1723,Alphen-Chaam,2023JJ00,2023,10463,113,83,7.9,95,9.1,-12,571,54.6,111,460,567,54.2,107,-4,460,4,-8,-0.8,10455
6965,T001038,Total male and female,GM1959,Altena,2019JJ00,2019,55386,276,563,10.1,444,8,119,1968,35.3,304,1664,1507,27.1,179,-33,1328,461,581,10.5,55967
6966,T001038,Total male and female,GM1959,Altena,2020JJ00,2020,55967,279,563,10,554,9.9,9,2091,37.2,304,1787,1718,30.6,160,-37,1558,373,385,6.9,56352
6967,T001038,Total male and female,GM1959,Altena,2021JJ00,2021,56352,281,638,11.3,517,9.1,121,2190,38.6,287,1903,1654,29.2,178,-34,1476,536,657,11.7,57009
6968,T001038,Total male and female,GM1959,Altena,2022JJ00,2022,57009,285,562,9.8,514,9,48,2377,41.4,679,1698,1708,29.8,301,-52,1407,669,717,12.6,57726
6969,T001038,Total male and female,GM1959,Altena,2023JJ00,2023,57726,289,596,10.3,552,9.5,44,2470,42.6,697,1773,1963,33.8,372,-97,1591,507,551,9.5,58277
7450,T001038,Total male and female,GM0060,Ameland,2012JJ00,2012,3526,60,31,8.8,29,8.2,2,138,39.1,18,120,141,40,9,-1,132,-3,-1,-0.3,3525
7451,T001038,Total male and female,GM0060,Ameland,2013JJ00,2013,3525,60,48,13.5,23,6.5,25,192,54.1,16,176,164,46.2,17,-8,147,28,53,15,3578
7452,T001038,Total male and female,GM0060,Ameland,2014JJ00,2014,3578,61,39,10.9,26,7.3,13,168,46.9,25,143,167,46.6,3,2,164,1,12,3.4,3590
7453,T001038,Total male and female,GM0060,Ameland,2015JJ00,2015,3590,61,37,10.3,27,7.5,10,184,51.1,29,155,174,48.3,41,-2,133,10,21,5.8,3611
7454,T001038,Total male and female,GM0060,Ameland,2016JJ00,2016,3611,62,27,7.5,32,8.8,-5,212,58.5,27,185,185,51.1,26,-2,159,27,22,6.1,3633
7455,T001038,Total male and female,GM0060,Ameland,2017JJ00,2017,3633,62,36,9.9,32,8.8,4,226,62,38,188,209,57.4,14,1,195,17,21,5.8,3654
7456,T001038,Total male and female,GM0060,Ameland,2018JJ00,2018,3654,62,32,8.7,50,13.6,-18,242,66.1,41,201,205,56,24,0,181,37,19,5.2,3673
7457,T001038,Total male and female,GM0060,Ameland,2019JJ00,2019,3673,62,33,8.9,26,7,7,255,69,70,185,219,59.3,55,-12,164,36,43,11.7,3716
7458,T001038,Total male and female,GM0060,Ameland,2020JJ00,2020,3716,63,30,8,23,6.2,7,256,68.6,56,200,233,62.4,57,-14,176,23,30,8.1,3746
7459,T001038,Total male and female,GM0060,Ameland,2021JJ00,2021,3746,63,37,9.9,39,10.4,-2,271,72.2,77,194,259,69,79,-34,180,12,11,2.9,3757
7460,T001038,Total male and female,GM0060,Ameland,2022JJ00,2022,3757,66,35,9.2,35,9.2,0,315,82.9,136,179,232,61.1,66,-17,166,83,83,22.1,3840
7461,T001038,Total male and female,GM0060,Ameland,2023JJ00,2023,3840,68,35,9.1,46,12,-11,271,70.6,90,181,261,68,58,-10,203,10,-1,-0.3,3839
7614,T001038,Total male and female,GM0307,Amersfoort,2012JJ00,2012,148250,2358,1991,13.4,955,6.4,1036,6251,42,794,5457,5869,39.4,923,-205,4946,382,1412,9.5,149662
7615,T001038,Total male and female,GM0307,Amersfoort,2013JJ00,2013,149662,2382,1860,12.4,1078,7.2,782,6223,41.4,827,5396,5777,38.4,814,-114,4963,446,1235,8.3,150897
7616,T001038,Total male and female,GM0307,Amersfoort,2014JJ00,2014,150897,2402,1908,12.6,1050,6.9,858,6901,45.5,861,6040,6173,40.7,895,-115,5278,728,1584,10.5,152481
7617,T001038,Total male and female,GM0307,Amersfoort,2015JJ00,2015,152481,2427,1791,11.7,1107,7.2,684,7132,46.6,940,6192,6684,43.7,942,-117,5742,448,1121,7.4,153602
7618,T001038,Total male and female,GM0307,Amersfoort,2016JJ00,2016,153602,2447,1801,11.7,1077,7,724,7621,49.5,868,6753,7616,49.5,887,-140,6729,5,735,4.8,154337
7619,T001038,Total male and female,GM0307,Amersfoort,2017JJ00,2017,154337,2459,1792,11.6,1094,7.1,698,7821,50.5,913,6908,7631,49.3,849,-78,6782,190,889,5.8,155226
7620,T001038,Total male and female,GM0307,Amersfoort,2018JJ00,2018,155226,2479,1793,11.5,1126,7.2,667,7807,50.1,977,6830,7418,47.6,734,-111,6684,389,1060,6.8,156286
7621,T001038,Total male and female,GM0307,Amersfoort,2019JJ00,2019,156286,2496,1744,11.1,1082,6.9,662,7705,49.1,1090,6615,7376,47,807,-125,6569,329,990,6.3,157276
7622,T001038,Total male and female,GM0307,Amersfoort,2020JJ00,2020,157276,2512,1691,10.7,1153,7.3,538,7493,47.6,876,6617,7835,49.8,623,-54,7212,-342,186,1.2,157462
7623,T001038,Total male and female,GM0307,Amersfoort,2021JJ00,2021,157462,2515,1823,11.5,1215,7.7,608,8283,52.4,873,7410,7763,49.1,554,-54,7209,520,1128,7.2,158590
7624,T001038,Total male and female,GM0307,Amersfoort,2022JJ00,2022,158590,2538,1692,10.6,1250,7.8,442,9259,58,1767,7492,7526,47.1,820,-119,6706,1733,2169,13.7,160759
7625,T001038,Total male and female,GM0307,Amersfoort,2023JJ00,2023,160759,2573,1710,10.6,1211,7.5,499,8716,54,1052,7664,8125,50.4,861,-138,7264,591,1093,6.8,161852
7860,T001038,Total male and female,GM0362,Amstelveen,2012JJ00,2012,83363,2011,815,9.7,848,10.1,-33,8117,96.8,2930,5187,7071,84.3,2821,-511,4250,1046,1016,12.2,84379
7861,T001038,Total male and female,GM0362,Amstelveen,2013JJ00,2013,84379,2037,854,10.1,824,9.7,30,7853,92.7,3045,4808,7242,85.5,2998,-463,4244,611,636,7.5,85015
7862,T001038,Total male and female,GM0362,Amstelveen,2014JJ00,2014,85015,2052,895,10.4,800,9.3,95,9541,110.8,3378,6163,7515,87.3,2802,-432,4713,2026,2147,25.3,87162
7863,T001038,Total male and female,GM0362,Amstelveen,2015JJ00,2015,87162,2104,839,9.5,865,9.8,-26,9849,112.1,3661,6188,8388,95.4,3170,-638,5218,1461,1440,16.5,88602
7864,T001038,Total male and female,GM0362,Amstelveen,2016JJ00,2016,88602,2150,898,10.1,853,9.6,45,9706,109.1,3713,5993,9063,101.9,3267,-467,5796,643,692,7.8,89294
7865,T001038,Total male and female,GM0362,Amstelveen,2017JJ00,2017,89294,2167,809,9,844,9.4,-35,10330,115.3,4251,6079,9720,108.5,3398,-325,6322,610,576,6.5,89870
7866,T001038,Total male and female,GM0362,Amstelveen,2018JJ00,2018,89870,2185,821,9.1,792,8.8,29,10822,119.8,4597,6225,9877,109.3,3521,-360,6356,945,968,10.8,90838
7867,T001038,Total male and female,GM0362,Amstelveen,2019JJ00,2019,90838,2209,809,8.9,790,8.7,19,11193,122.7,4998,6195,10364,113.6,3449,-313,6915,829,837,9.2,91675
7868,T001038,Total male and female,GM0362,Amstelveen,2020JJ00,2020,91675,2229,786,8.6,916,10,-130,9656,105.8,3454,6202,10370,113.6,3213,-203,7157,-714,-846,-9.2,90829
7869,T001038,Total male and female,GM0362,Amstelveen,2021JJ00,2021,90829,2208,821,9,888,9.7,-67,11725,128,4827,6898,10155,110.9,2585,-190,7570,1570,1502,16.5,92331
7870,T001038,Total male and female,GM0362,Amstelveen,2022JJ00,2022,92331,2246,725,7.8,966,10.3,-241,13858,148.4,7066,6792,11521,123.4,3071,-261,8450,2337,2087,22.6,94418
7871,T001038,Total male and female,GM0362,Amstelveen,2023JJ00,2023,94418,2297,686,7.2,933,9.9,-247,12088,127.6,5281,6807,11243,118.7,3155,-229,8088,845,596,6.3,95014
8024,T001038,Total male and female,GM0363,Amsterdam,2012JJ00,2012,790110,4767,10992,13.8,5535,7,5457,53856,67.8,20204,33652,50170,63.1,20035,-6020,30135,3686,9168,11.6,799278
8025,T001038,Total male and female,GM0363,Amsterdam,2013JJ00,2013,799278,4818,11063,13.7,5412,6.7,5651,55689,69.2,20462,35227,50024,62.1,19324,-4662,30700,5665,11489,14.4,810767
8026,T001038,Total male and female,GM0363,Amsterdam,2014JJ00,2014,810937,4888,11216,13.7,5244,6.4,5972,59762,73.2,23764,35998,54969,67.3,19475,-4031,35494,4793,10815,13.3,821752
8027,T001038,Total male and female,GM0363,Amsterdam,2015JJ00,2015,821752,4954,11103,13.4,5453,6.6,5650,64444,77.9,26325,38119,58243,70.4,18832,-1347,39411,6201,11872,14.4,833624
8028,T001038,Total male and female,GM0363,Amsterdam,2016JJ00,2016,833624,5042,11023,13.1,5517,6.6,5506,67725,80.7,29613,38112,61888,73.7,19676,-1423,42212,5837,11323,13.6,844947
8029,T001038,Total male and female,GM0363,Amsterdam,2017JJ00,2017,844947,5111,10857,12.8,5169,6.1,5688,70866,83.4,34581,36285,67436,79.4,22279,-3991,45157,3430,9100,10.8,854047
8030,T001038,Total male and female,GM0363,Amsterdam,2018JJ00,2018,854047,5160,10661,12.4,5374,6.3,5287,73596,85.7,38829,34767,69918,81.4,23312,-2899,46606,3678,8918,10.4,862965
8031,T001038,Total male and female,GM0363,Amsterdam,2019JJ00,2019,862965,5214,10588,12.2,5248,6,5340,77607,89.4,42022,35585,73121,84.3,23770,-2173,49351,4486,9792,11.3,872757
8032,T001038,Total male and female,GM0363,Amsterdam,2020JJ00,2020,872757,5273,10345,11.8,5763,6.6,4582,69363,79.4,30917,38446,73310,84,21060,-64,52250,-3947,581,0.7,873338
8033,T001038,Total male and female,GM0363,Amsterdam,2021JJ00,2021,873338,5277,10779,12.3,5914,6.7,4865,77143,87.9,37114,40029,72635,82.7,19358,60,53277,4508,9295,10.6,882633
8034,T001038,Total male and female,GM0363,Amsterdam,2022JJ00,2022,882633,5336,9894,10.9,6002,6.6,3892,88627,97.3,49516,39111,77690,85.3,22650,-1242,55040,10937,14718,16.3,918117
8035,T001038,Total male and female,GM0363,Amsterdam,2023JJ00,2023,918117,4880,9673,10.5,5977,6.5,3696,89014,96.3,45956,43058,79281,85.7,26019,-1611,53262,9733,13181,14.4,931298
8598,T001038,Total male and female,GM0200,Apeldoorn,2012JJ00,2012,156961,462,1489,9.5,1495,9.5,-6,5501,35,746,4755,5147,32.8,721,-112,4426,354,354,2.3,157315
8599,T001038,Total male and female,GM0200,Apeldoorn,2013JJ00,2013,157315,463,1528,9.7,1526,9.7,2,5389,34.2,734,4655,5167,32.8,640,-42,4527,222,230,1.5,157545
8600,T001038,Total male and female,GM0200,Apeldoorn,2014JJ00,2014,157545,464,1467,9.3,1449,9.2,18,5791,36.7,767,5024,5296,33.6,808,-170,4488,495,554,3.5,158099
8601,T001038,Total male and female,GM0200,Apeldoorn,2015JJ00,2015,158099,465,1575,9.9,1528,9.6,47,6045,38.1,938,5107,5172,32.6,654,-84,4518,873,926,5.9,159025
8602,T001038,Total male and female,GM0200,Apeldoorn,2016JJ00,2016,159025,468,1562,9.8,1577,9.9,-15,6614,41.5,861,5753,5574,34.9,756,-163,4818,1040,1022,6.4,160047
8603,T001038,Total male and female,GM0200,Apeldoorn,2017JJ00,2017,160047,471,1504,9.4,1524,9.5,-20,6841,42.6,1116,5725,5707,35.5,705,-210,5002,1134,1109,6.9,161156
8604,T001038,Total male and female,GM0200,Apeldoorn,2018JJ00,2018,161156,474,1509,9.3,1581,9.8,-72,6856,42.4,1207,5649,5498,34,641,-129,4857,1358,1289,8,162445
8605,T001038,Total male and female,GM0200,Apeldoorn,2019JJ00,2019,162445,478,1521,9.3,1614,9.9,-93,7026,43.1,1152,5874,5553,34,836,-213,4717,1473,1373,8.5,163818
8606,T001038,Total male and female,GM0200,Apeldoorn,2020JJ00,2020,163818,482,1530,9.3,1780,10.8,-250,7335,44.6,997,6338,6123,37.3,656,-155,5467,1212,963,5.9,164781
8607,T001038,Total male and female,GM0200,Apeldoorn,2021JJ00,2021,164781,485,1639,9.9,1703,10.3,-64,6914,41.9,976,5938,6016,36.4,657,-143,5359,898,830,5,165611
8608,T001038,Total male and female,GM0200,Apeldoorn,2022JJ00,2022,165611,487,1510,9.1,1825,11,-315,8307,49.9,2470,5837,6409,38.5,920,-199,5489,1898,1580,9.5,167191
8609,T001038,Total male and female,GM0200,Apeldoorn,2023JJ00,2023,167191,492,1457,8.7,1792,10.7,-335,7998,47.7,1991,6007,6627,39.5,1153,-375,5474,1371,1020,6.1,168211
8762,T001038,Total male and female,GM0003,Appingedam,2012JJ00,2012,12053,507,112,9.3,134,11.1,-22,534,44.3,18,516,514,42.6,21,-2,493,20,0,0,12053
8763,T001038,Total male and female,GM0003,Appingedam,2013JJ00,2013,12053,507,96,8,147,12.2,-51,531,44,21,510,468,38.8,18,-1,450,63,11,0.9,12064
8764,T001038,Total male and female,GM0003,Appingedam,2014JJ00,2014,12064,508,103,8.6,145,12,-42,600,49.8,35,565,612,50.8,70,-21,542,-12,-53,-4.4,12011
8765,T001038,Total male and female,GM0003,Appingedam,2015JJ00,2015,12011,505,94,7.8,164,13.7,-70,636,53,44,592,574,47.8,18,1,556,62,-10,-0.8,12001
8766,T001038,Total male and female,GM0003,Appingedam,2016JJ00,2016,12001,505,108,9,173,14.4,-65,727,60.7,62,665,692,57.7,48,-16,644,35,-30,-2.5,11971
8767,T001038,Total male and female,GM0003,Appingedam,2017JJ00,2017,11971,503,93,7.8,152,12.8,-59,586,49.3,29,557,698,58.7,27,-10,671,-112,-170,-14.2,11801
8768,T001038,Total male and female,GM0003,Appingedam,2018JJ00,2018,11801,496,85,7.2,143,12.2,-58,601,51.1,40,561,626,53.2,24,-9,602,-25,-80,-6.8,11721
8769,T001038,Total male and female,GM0003,Appingedam,2019JJ00,2019,11721,493,79,6.8,157,13.4,-78,605,51.8,47,558,606,51.9,32,2,574,-1,-79,-6.7,11642
8770,T001038,Total male and female,GM0003,Appingedam,2020JJ00,2020,11642,490,75,6.5,157,13.6,-82,619,53.5,51,568,696,60.2,15,2,681,-77,-146,-12.5,11496
9090,T001038,Total male and female,GM0202,Arnhem,2012JJ00,2012,149271,1523,1912,12.8,1258,8.4,654,9093,60.8,1415,7678,9197,61.5,1658,-492,7539,-104,556,3.7,149827
9091,T001038,Total male and female,GM0202,Arnhem,2013JJ00,2013,149827,1529,1831,12.2,1228,8.2,603,9572,63.7,1497,8075,9179,61.1,1520,-335,7659,393,996,6.6,150823
9092,T001038,Total male and female,GM0202,Arnhem,2014JJ00,2014,150823,1540,1824,12,1241,8.2,583,9888,65.2,1301,8587,9000,59.4,1435,-319,7565,888,1470,9.7,152293
9093,T001038,Total male and female,GM0202,Arnhem,2015JJ00,2015,152293,1555,1783,11.6,1214,7.9,569,10493,68.6,1594,8899,9531,62.3,1515,-393,8016,962,1525,10,153818
9094,T001038,Total male and female,GM0202,Arnhem,2016JJ00,2016,153818,1571,1701,11,1226,7.9,475,13241,85.6,2927,10314,11841,76.5,1487,-412,10354,1400,1881,12.2,155699
9095,T001038,Total male and female,GM0202,Arnhem,2017JJ00,2017,155699,1590,1640,10.5,1282,8.2,358,12887,82.4,2753,10134,11719,74.9,1465,-468,10254,1168,1524,9.8,157223
9096,T001038,Total male and female,GM0202,Arnhem,2018JJ00,2018,157223,1607,1668,10.5,1371,8.7,297,12937,81.8,3032,9905,11206,70.8,1325,-231,9881,1731,2042,13,159265
9097,T001038,Total male and female,GM0202,Arnhem,2019JJ00,2019,159265,1628,1590,9.9,1327,8.3,263,14360,89.6,4768,9592,12552,78.3,1217,-78,11335,1808,2083,13.1,161348
9098,T001038,Total male and female,GM0202,Arnhem,2020JJ00,2020,161348,1649,1600,9.9,1406,8.7,194,13181,81.4,3424,9757,12314,76.1,1283,-201,11031,867,1076,6.7,162424
9099,T001038,Total male and female,GM0202,Arnhem,2021JJ00,2021,162424,1660,1737,10.6,1460,8.9,277,14542,89.1,4653,9889,13377,82,1350,-307,12027,1165,1464,9,163888
9100,T001038,Total male and female,GM0202,Arnhem,2022JJ00,2022,163888,1677,1598,9.7,1493,9.1,105,15809,95.9,6263,9546,14037,85.2,1632,-396,12405,1772,1882,11.5,165770
9101,T001038,Total male and female,GM0202,Arnhem,2023JJ00,2023,165770,1696,1677,10.1,1438,8.6,239,16810,100.8,7138,9672,15249,91.5,1748,-421,13501,1561,1862,11.2,167632
9254,T001038,Total male and female,GM0106,Assen,2012JJ00,2012,67208,820,735,10.9,632,9.4,103,2584,38.4,253,2331,2691,40,261,35,2430,-107,-4,-0.1,67204
9255,T001038,Total male and female,GM0106,Assen,2013JJ00,2013,67204,821,658,9.8,553,8.2,105,2612,38.9,333,2279,2729,40.6,256,13,2473,-117,-14,-0.2,67190
9256,T001038,Total male and female,GM0106,Assen,2014JJ00,2014,67190,821,689,10.3,556,8.3,133,2648,39.4,308,2340,2807,41.8,299,-53,2508,-159,-25,-0.4,67165
9257,T001038,Total male and female,GM0106,Assen,2015JJ00,2015,67165,820,599,8.9,630,9.4,-31,2798,41.7,355,2443,2872,42.8,265,-25,2607,-74,-104,-1.5,67061
9258,T001038,Total male and female,GM0106,Assen,2016JJ00,2016,67061,819,660,9.8,617,9.2,43,3793,56.4,535,3258,3334,49.5,293,-44,3041,459,490,7.3,67551
9259,T001038,Total male and female,GM0106,Assen,2017JJ00,2017,67551,825,625,9.2,681,10.1,-56,3716,54.9,300,3416,3493,51.6,220,-39,3273,223,157,2.3,67708
9260,T001038,Total male and female,GM0106,Assen,2018JJ00,2018,67708,827,588,8.7,698,10.3,-110,3762,55.5,377,3385,3389,50,247,-15,3142,373,255,3.8,67963
9261,T001038,Total male and female,GM0106,Assen,2019JJ00,2019,67963,830,576,8.4,657,9.6,-81,4033,59.1,752,3281,3309,48.5,227,-20,3082,724,636,9.4,68599
9262,T001038,Total male and female,GM0106,Assen,2020JJ00,2020,68599,838,654,9.5,683,9.9,-29,3732,54.3,298,3434,3464,50.4,192,-28,3272,268,237,3.5,68836
9263,T001038,Total male and female,GM0106,Assen,2021JJ00,2021,68836,841,676,9.8,690,10,-14,3924,56.9,297,3627,3755,54.5,314,-118,3441,169,143,2.1,68979
9264,T001038,Total male and female,GM0106,Assen,2022JJ00,2022,68979,842,591,8.5,730,10.5,-139,4176,60.3,941,3235,3603,52.1,308,-41,3295,573,435,6.3,69414
9265,T001038,Total male and female,GM0106,Assen,2023JJ00,2023,69414,848,591,8.5,736,10.6,-145,4383,63,743,3640,3946,56.7,480,-211,3466,437,287,4.1,69701
9418,T001038,Total male and female,GM0743,Asten,2012JJ00,2012,16404,234,125,7.6,150,9.1,-25,577,35.2,147,430,565,34.5,70,-11,495,12,-12,-0.7,16392
9419,T001038,Total male and female,GM0743,Asten,2013JJ00,2013,16392,234,132,8,126,7.7,6,647,39.4,147,500,604,36.8,124,-22,480,43,48,2.9,16440
9420,T001038,Total male and female,GM0743,Asten,2014JJ00,2014,16440,234,148,9,141,8.5,7,747,45.3,249,498,634,38.4,120,-27,514,113,119,7.2,16559
9421,T001038,Total male and female,GM0743,Asten,2015JJ00,2015,16559,236,119,7.2,115,6.9,4,764,46.1,277,487,747,45.1,179,-42,568,17,21,1.3,16580
9422,T001038,Total male and female,GM0743,Asten,2016JJ00,2016,16580,236,136,8.2,150,9,-14,888,53.3,232,656,741,44.5,198,-29,543,147,134,8.1,16714
9423,T001038,Total male and female,GM0743,Asten,2017JJ00,2017,16714,238,151,9,152,9.1,-1,825,49.4,201,624,817,48.9,159,-40,658,8,5,0.3,16719
9424,T001038,Total male and female,GM0743,Asten,2018JJ00,2018,16719,238,145,8.7,181,10.8,-36,754,45.1,169,585,724,43.3,175,-54,549,30,-9,-0.5,16710
9425,T001038,Total male and female,GM0743,Asten,2019JJ00,2019,16710,238,149,8.9,151,9,-2,816,48.8,286,530,802,48,205,-74,597,14,11,0.7,16721
9426,T001038,Total male and female,GM0743,Asten,2020JJ00,2020,16721,238,154,9.2,171,10.2,-17,832,49.6,189,643,724,43.2,202,-59,522,108,96,5.7,16817
9427,T001038,Total male and female,GM0743,Asten,2021JJ00,2021,16817,240,176,10.4,177,10.4,-1,963,56.8,215,748,712,42,168,-68,544,251,251,14.9,17068
9428,T001038,Total male and female,GM0743,Asten,2022JJ00,2022,17068,243,144,8.4,175,10.2,-31,971,56.6,318,653,766,44.7,192,-42,574,205,174,10.2,17242
9429,T001038,Total male and female,GM0743,Asten,2023JJ00,2023,17242,246,170,9.8,184,10.7,-14,825,47.8,222,603,750,43.4,219,-77,531,75,60,3.5,17302
9910,T001038,Total male and female,GM0744,Baarle-Nassau,2012JJ00,2012,6722,88,52,7.7,54,8,-2,234,34.9,55,179,256,38.1,60,0,196,-22,-23,-3.4,6699
9911,T001038,Total male and female,GM0744,Baarle-Nassau,2013JJ00,2013,6699,88,53,8,72,10.8,-19,288,43.3,85,203,355,53.3,90,-21,265,-67,-87,-13,6612
9912,T001038,Total male and female,GM0744,Baarle-Nassau,2014JJ00,2014,6612,87,44,6.7,78,11.8,-34,296,44.8,56,240,277,41.9,63,4,214,19,-13,-2,6599
9913,T001038,Total male and female,GM0744,Baarle-Nassau,2015JJ00,2015,6599,87,61,9.2,74,11.2,-13,298,45.1,65,233,270,40.9,44,4,226,28,12,1.8,6611
9914,T001038,Total male and female,GM0744,Baarle-Nassau,2016JJ00,2016,6611,87,54,8.1,59,8.9,-5,343,51.7,68,275,291,43.9,55,-6,236,52,46,7,6657
9915,T001038,Total male and female,GM0744,Baarle-Nassau,2017JJ00,2017,6657,87,59,8.8,69,10.3,-10,460,68.4,89,371,309,45.9,49,1,260,151,142,21.3,6799
9916,T001038,Total male and female,GM0744,Baarle-Nassau,2018JJ00,2018,6799,89,50,7.3,68,10,-18,401,58.8,81,320,334,49,50,-5,284,67,48,7.1,6847
9917,T001038,Total male and female,GM0744,Baarle-Nassau,2019JJ00,2019,6847,90,63,9.2,70,10.2,-7,386,56.3,79,307,367,53.6,64,1,303,19,12,1.8,6859
9918,T001038,Total male and female,GM0744,Baarle-Nassau,2020JJ00,2020,6859,90,50,7.3,89,12.9,-39,433,62.9,67,366,353,51.3,88,-5,265,80,40,5.8,6899
9919,T001038,Total male and female,GM0744,Baarle-Nassau,2021JJ00,2021,6899,91,51,7.4,87,12.6,-36,389,56.3,57,332,320,46.3,66,8,254,69,32,4.6,6931
9920,T001038,Total male and female,GM0744,Baarle-Nassau,2022JJ00,2022,6931,91,54,7.7,81,11.6,-27,433,61.8,97,336,266,38,42,-2,224,167,140,20.2,7071
9921,T001038,Total male and female,GM0744,Baarle-Nassau,2023JJ00,2023,7071,93,59,8.3,95,13.4,-36,421,59.5,91,330,380,53.7,113,-6,267,41,5,0.7,7076
9992,T001038,Total male and female,GM0308,Baarn,2012JJ00,2012,24352,749,208,8.6,317,13,-109,1057,43.5,117,940,1022,42,104,-7,918,35,-75,-3.1,24277
9993,T001038,Total male and female,GM0308,Baarn,2013JJ00,2013,24277,747,188,7.7,283,11.6,-95,1127,46.4,111,1016,993,40.9,122,-3,871,134,37,1.5,24314
9994,T001038,Total male and female,GM0308,Baarn,2014JJ00,2014,24314,748,213,8.7,288,11.8,-75,1370,56.2,156,1214,1204,49.4,130,-7,1074,166,92,3.8,24406
9995,T001038,Total male and female,GM0308,Baarn,2015JJ00,2015,24406,751,203,8.3,293,12,-90,1357,55.5,143,1214,1153,47.1,107,10,1046,204,115,4.7,24521
9996,T001038,Total male and female,GM0308,Baarn,2016JJ00,2016,24521,754,236,9.6,317,12.9,-81,1364,55.6,161,1203,1275,52,128,-7,1147,89,8,0.3,24529
9997,T001038,Total male and female,GM0308,Baarn,2017JJ00,2017,24529,754,196,8,327,13.3,-131,1476,60.1,188,1288,1247,50.7,113,-5,1134,229,101,4.1,24630
9998,T001038,Total male and female,GM0308,Baarn,2018JJ00,2018,24630,757,238,9.6,306,12.4,-68,1266,51.3,165,1101,1061,43,110,-3,951,205,137,5.6,24767
9999,T001038,Total male and female,GM0308,Baarn,2019JJ00,2019,24767,761,235,9.5,317,12.8,-82,1369,55.2,188,1181,1185,47.7,111,0,1074,184,101,4.1,24868
10000,T001038,Total male and female,GM0308,Baarn,2020JJ00,2020,24868,764,194,7.8,340,13.7,-146,1382,55.7,125,1257,1312,52.8,81,1,1231,70,-76,-3.1,24792
10001,T001038,Total male and female,GM0308,Baarn,2021JJ00,2021,24792,762,234,9.4,357,14.4,-123,1487,59.9,144,1343,1279,51.5,85,2,1194,208,84,3.4,24876
10002,T001038,Total male and female,GM0308,Baarn,2022JJ00,2022,24876,764,212,8.5,351,14.1,-139,1475,59.1,258,1217,1203,48.2,127,-3,1076,272,132,5.3,25008
10003,T001038,Total male and female,GM0308,Baarn,2023JJ00,2023,25008,769,205,8.2,319,12.7,-114,1420,56.7,175,1245,1250,49.9,140,-13,1110,170,57,2.3,25065
10402,T001038,Total male and female,GM0489,Barendrecht,2012JJ00,2012,47053,2373,544,11.5,277,5.9,267,2007,42.5,144,1863,1958,41.5,203,-28,1755,49,318,6.8,47371
10403,T001038,Total male and female,GM0489,Barendrecht,2013JJ00,2013,47371,2379,501,10.6,304,6.4,197,1826,38.5,147,1679,2015,42.5,218,-22,1797,-189,6,0.1,47377
10404,T001038,Total male and female,GM0489,Barendrecht,2014JJ00,2014,47377,2380,474,10,252,5.3,222,1949,41.1,206,1743,2030,42.8,198,-16,1832,-81,144,3,47521
10405,T001038,Total male and female,GM0489,Barendrecht,2015JJ00,2015,47521,2387,453,9.5,292,6.1,161,2313,48.5,194,2119,2133,44.7,207,-41,1926,180,340,7.2,47861
10406,T001038,Total male and female,GM0489,Barendrecht,2016JJ00,2016,47861,2411,481,10,304,6.3,177,2665,55.4,182,2483,2360,49.1,231,-43,2129,305,483,10.1,48344
10407,T001038,Total male and female,GM0489,Barendrecht,2017JJ00,2017,48344,2435,418,8.6,320,6.6,98,2509,51.8,216,2293,2472,51.1,189,-48,2283,37,133,2.8,48477
10408,T001038,Total male and female,GM0489,Barendrecht,2018JJ00,2018,48477,2455,449,9.2,334,6.9,115,2477,51,221,2256,2398,49.4,198,-19,2200,79,196,4,48673
10409,T001038,Total male and female,GM0489,Barendrecht,2019JJ00,2019,48673,2464,406,8.3,309,6.3,97,2411,49.5,239,2172,2464,50.6,187,-37,2277,-53,41,0.8,48714
10410,T001038,Total male and female,GM0489,Barendrecht,2020JJ00,2020,48714,2467,406,8.3,392,8.1,14,2538,52.1,231,2307,2623,53.9,150,-16,2473,-85,-71,-1.5,48643
10411,T001038,Total male and female,GM0489,Barendrecht,2021JJ00,2021,48643,2463,462,9.5,373,7.7,89,2404,49.4,169,2235,2422,49.8,142,-9,2280,-18,71,1.5,48714
10412,T001038,Total male and female,GM0489,Barendrecht,2022JJ00,2022,48714,2488,395,8.1,343,7,52,2488,51,322,2166,2440,50,208,-13,2232,48,98,2,48812
10413,T001038,Total male and female,GM0489,Barendrecht,2023JJ00,2023,48812,2493,390,8,355,7.3,35,2164,44.4,252,1912,2314,47.5,185,-3,2129,-150,-122,-2.5,48690
10484,T001038,Total male and female,GM0203,Barneveld,2012JJ00,2012,53521,304,771,14.4,393,7.3,378,1615,30.1,160,1455,1766,32.9,132,-1,1634,-151,230,4.3,53751
10485,T001038,Total male and female,GM0203,Barneveld,2013JJ00,2013,53751,305,821,15.2,417,7.7,404,1617,30,149,1468,1629,30.2,117,10,1512,-12,390,7.3,54141
10486,T001038,Total male and female,GM0203,Barneveld,2014JJ00,2014,54152,308,792,14.6,386,7.1,406,1953,35.9,159,1794,1817,33.4,169,-12,1648,136,551,10.2,54703
10487,T001038,Total male and female,GM0203,Barneveld,2015JJ00,2015,54703,311,787,14.3,385,7,402,2141,38.9,196,1945,1808,32.8,152,-8,1656,333,738,13.5,55441
10488,T001038,Total male and female,GM0203,Barneveld,2016JJ00,2016,55441,315,827,14.8,455,8.1,372,2422,43.3,178,2244,1856,33.2,161,10,1695,566,935,16.9,56376
10489,T001038,Total male and female,GM0203,Barneveld,2017JJ00,2017,56376,320,833,14.7,426,7.5,407,2608,45.9,256,2352,2053,36.1,209,-25,1844,555,963,17.1,57339
10490,T001038,Total male and female,GM0203,Barneveld,2018JJ00,2018,57339,326,839,14.6,424,7.4,415,2266,39.3,216,2050,2053,35.6,137,31,1916,213,632,11,57971
10491,T001038,Total male and female,GM0203,Barneveld,2019JJ00,2019,57971,330,824,14.1,466,8,358,2800,47.8,249,2551,2045,34.9,207,-23,1838,755,1111,19.2,59082
10492,T001038,Total male and female,GM0203,Barneveld,2020JJ00,2020,59082,336,860,14.4,470,7.9,390,2522,42.4,248,2274,2000,33.6,131,-29,1869,522,910,15.4,59992
10493,T001038,Total male and female,GM0203,Barneveld,2021JJ00,2021,59992,341,917,15.2,517,8.6,400,2394,39.7,234,2160,2200,36.5,170,-50,2030,194,592,9.9,60584
10494,T001038,Total male and female,GM0203,Barneveld,2022JJ00,2022,60584,345,864,14.1,502,8.2,362,2792,45.7,740,2052,2084,34.1,260,-81,1824,708,1071,17.7,61655
10495,T001038,Total male and female,GM0203,Barneveld,2023JJ00,2023,61655,351,848,13.7,478,7.7,370,2740,44.1,362,2378,2174,35,247,-17,1927,566,937,15.2,62592
10976,T001038,Total male and female,GM0005,Bedum,2012JJ00,2012,10508,236,106,10.1,89,8.5,17,406,38.6,25,381,377,35.8,7,1,370,29,45,4.3,10553
10977,T001038,Total male and female,GM0005,Bedum,2013JJ00,2013,10553,237,86,8.2,77,7.3,9,411,39.1,24,387,481,45.7,28,-1,453,-70,-59,-5.6,10494
10978,T001038,Total male and female,GM0005,Bedum,2014JJ00,2014,10494,236,115,11,83,7.9,32,421,40.2,24,397,507,48.4,21,-2,486,-86,-53,-5.1,10441
10979,T001038,Total male and female,GM0005,Bedum,2015JJ00,2015,10441,234,96,9.2,81,7.8,15,479,45.9,20,459,502,48.1,28,0,474,-23,-8,-0.8,10433
10980,T001038,Total male and female,GM0005,Bedum,2016JJ00,2016,10433,234,96,9.2,108,10.3,-12,542,51.8,22,520,484,46.3,16,2,468,58,46,4.4,10479
10981,T001038,Total male and female,GM0005,Bedum,2017JJ00,2017,10479,235,105,10,103,9.8,2,474,45.2,24,450,480,45.8,20,1,460,-6,-4,-0.4,10475
10982,T001038,Total male and female,GM0005,Bedum,2018JJ00,2018,10475,235,103,9.8,104,9.9,-1,455,43.4,24,431,443,42.3,26,-5,417,12,18,1.7,10493
11140,T001038,Total male and female,GM0888,Beek (L.),2012JJ00,2012,16457,783,124,7.6,148,9,-24,680,41.4,60,620,745,45.4,53,-7,692,-65,-90,-5.5,16367
11141,T001038,Total male and female,GM0888,Beek (L.),2013JJ00,2013,16367,778,103,6.3,152,9.3,-49,696,42.6,74,622,743,45.5,70,-15,673,-47,-96,-5.9,16271
11142,T001038,Total male and female,GM0888,Beek (L.),2014JJ00,2014,16271,774,130,8,138,8.5,-8,716,44.1,82,634,764,47,78,1,686,-48,-57,-3.5,16214
11143,T001038,Total male and female,GM0888,Beek (L.),2015JJ00,2015,16214,771,111,6.9,157,9.7,-46,735,45.5,63,672,835,51.7,88,-18,747,-100,-146,-9,16068
11144,T001038,Total male and female,GM0888,Beek (L.),2016JJ00,2016,16068,764,117,7.3,139,8.7,-22,824,51.5,108,716,920,57.5,82,-6,838,-96,-117,-7.3,15951
11145,T001038,Total male and female,GM0888,Beek (L.),2017JJ00,2017,15951,758,116,7.3,147,9.2,-31,822,51.6,60,762,847,53.2,66,-4,781,-25,-56,-3.5,15895
11146,T001038,Total male and female,GM0888,Beek (L.),2018JJ00,2018,15895,756,118,7.4,155,9.7,-37,957,60.1,103,854,886,55.7,59,-2,827,71,34,2.1,15929
11147,T001038,Total male and female,GM0888,Beek (L.),2019JJ00,2019,15929,757,152,9.6,184,11.6,-32,806,50.7,84,722,838,52.7,68,10,770,-32,-64,-4,15865
11148,T001038,Total male and female,GM0888,Beek (L.),2020JJ00,2020,15865,754,137,8.6,201,12.7,-64,915,57.7,76,839,841,53,87,-10,754,74,10,0.6,15875
11149,T001038,Total male and female,GM0888,Beek (L.),2021JJ00,2021,15875,755,137,8.6,179,11.3,-42,851,53.7,63,788,868,54.8,75,1,793,-17,-58,-3.7,15817
11150,T001038,Total male and female,GM0888,Beek (L.),2022JJ00,2022,15817,751,125,7.8,184,11.5,-59,1203,75.3,336,867,827,51.8,110,-12,717,376,315,19.9,16132
11151,T001038,Total male and female,GM0888,Beek (L.),2023JJ00,2023,16132,766,133,8.2,191,11.8,-58,1136,70.2,308,828,995,61.5,236,-31,759,141,83,5.1,16215
11393,T001038,Total male and female,GM1954,Beekdaelen,2019JJ00,2019,35727,456,263,7.3,381,10.6,-118,2137,59.6,183,1954,1807,50.4,135,-19,1672,330,211,5.9,35938
11394,T001038,Total male and female,GM1954,Beekdaelen,2020JJ00,2020,35938,459,281,7.8,464,12.9,-183,2161,60,162,1999,1853,51.5,123,-8,1730,308,127,3.5,36065
11395,T001038,Total male and female,GM1954,Beekdaelen,2021JJ00,2021,36065,461,287,8,508,14.1,-221,2106,58.5,156,1950,2028,56.3,164,-25,1864,78,-143,-4,35922
11396,T001038,Total male and female,GM1954,Beekdaelen,2022JJ00,2022,35922,459,269,7.5,462,12.9,-193,2130,59.3,315,1815,1893,52.7,227,-42,1666,237,44,1.2,35966
11397,T001038,Total male and female,GM1954,Beekdaelen,2023JJ00,2023,35966,459,318,8.9,463,12.9,-145,1989,55.4,238,1751,1916,53.3,193,-42,1723,73,-70,-1.9,35896
11468,T001038,Total male and female,GM0370,Beemster,2012JJ00,2012,8719,124,72,8.2,42,4.8,30,414,47.3,28,386,377,43.1,30,-8,347,37,66,7.6,8785
11469,T001038,Total male and female,GM0370,Beemster,2013JJ00,2013,8785,124,79,8.9,68,7.7,11,464,52.4,35,429,350,39.6,27,-5,323,114,125,14.2,8910
11470,T001038,Total male and female,GM0370,Beemster,2014JJ00,2014,8910,126,74,8.3,48,5.4,26,378,42.4,11,367,410,46,33,1,377,-32,-7,-0.8,8903
11471,T001038,Total male and female,GM0370,Beemster,2015JJ00,2015,8903,126,82,9.2,71,8,11,435,48.7,23,412,392,43.9,35,-2,357,43,55,6.2,8958
11472,T001038,Total male and female,GM0370,Beemster,2016JJ00,2016,8958,127,98,10.8,71,7.8,27,700,77.1,30,670,480,52.9,27,1,453,220,247,27.6,9205
11473,T001038,Total male and female,GM0370,Beemster,2017JJ00,2017,9205,130,103,11,67,7.1,36,696,74.2,27,669,387,41.3,18,-4,369,309,345,37.5,9550
11474,T001038,Total male and female,GM0370,Beemster,2018JJ00,2018,9550,135,98,10.2,72,7.5,26,648,67.2,25,623,476,49.3,23,-1,453,172,198,20.7,9748
11475,T001038,Total male and female,GM0370,Beemster,2019JJ00,2019,9748,138,106,10.7,62,6.3,44,713,72.1,30,683,483,48.9,15,-2,468,230,274,28.1,10022
11476,T001038,Total male and female,GM0370,Beemster,2020JJ00,2020,10022,142,91,9,71,7.1,20,580,57.6,19,561,512,50.9,25,0,487,68,88,8.8,10110
11477,T001038,Total male and female,GM0370,Beemster,2021JJ00,2021,10110,143,120,11.5,82,7.9,38,1067,102.5,30,1037,496,47.7,30,-2,466,571,593,58.7,10703
11796,T001038,Total male and female,GM0889,Beesel,2012JJ00,2012,13742,488,119,8.7,112,8.2,7,402,29.3,55,347,463,33.8,49,-6,414,-61,-54,-3.9,13688
11797,T001038,Total male and female,GM0889,Beesel,2013JJ00,2013,13688,487,115,8.4,116,8.5,-1,365,26.7,35,330,436,31.9,31,-4,405,-71,-71,-5.2,13617
11798,T001038,Total male and female,GM0889,Beesel,2014JJ00,2014,13617,484,105,7.7,98,7.2,7,375,27.6,39,336,487,35.9,40,-4,447,-112,-106,-7.8,13511
11799,T001038,Total male and female,GM0889,Beesel,2015JJ00,2015,13511,480,100,7.4,123,9.1,-23,379,28.2,52,327,479,35.6,36,6,443,-100,-123,-9.1,13388
11800,T001038,Total male and female,GM0889,Beesel,2016JJ00,2016,13388,477,101,7.5,123,9.2,-22,512,38.2,59,453,472,35.2,46,0,426,40,17,1.3,13405
11801,T001038,Total male and female,GM0889,Beesel,2017JJ00,2017,13405,477,107,8,122,9.1,-15,524,39,63,461,472,35.2,26,2,446,52,39,2.9,13444
11802,T001038,Total male and female,GM0889,Beesel,2018JJ00,2018,13444,480,116,8.6,129,9.6,-13,552,40.9,50,502,464,34.4,39,-1,425,88,75,5.6,13519
11803,T001038,Total male and female,GM0889,Beesel,2019JJ00,2019,13519,483,96,7.1,117,8.7,-21,472,35,47,425,488,36.1,42,-3,446,-16,-37,-2.7,13482
11804,T001038,Total male and female,GM0889,Beesel,2020JJ00,2020,13482,482,102,7.6,125,9.3,-23,518,38.5,39,479,527,39.1,53,-8,474,-9,-32,-2.4,13450
11805,T001038,Total male and female,GM0889,Beesel,2021JJ00,2021,13450,481,100,7.4,158,11.8,-58,449,33.4,53,396,433,32.2,42,0,391,16,-42,-3.1,13408
11806,T001038,Total male and female,GM0889,Beesel,2022JJ00,2022,13408,481,120,8.9,134,10,-14,515,38.4,127,388,460,34.3,48,-10,412,55,41,3.1,13449
11807,T001038,Total male and female,GM0889,Beesel,2023JJ00,2023,13449,482,102,7.6,121,9,-19,499,37.2,86,413,534,39.8,59,-6,475,-35,-55,-4.1,13394
12124,T001038,Total male and female,GM0007,Bellingwedde,2012JJ00,2012,9283,86,67,7.3,110,12,-43,469,51.3,54,415,720,78.8,123,-95,597,-251,-298,-32.1,8985
12125,T001038,Total male and female,GM0007,Bellingwedde,2013JJ00,2013,8985,83,55,6.1,112,12.5,-57,419,46.8,30,389,428,47.8,40,-8,388,-9,-65,-7.2,8920
12126,T001038,Total male and female,GM0007,Bellingwedde,2014JJ00,2014,8920,82,68,7.5,111,12.3,-43,947,104.8,462,485,673,74.5,30,11,643,274,234,26.2,9154
12127,T001038,Total male and female,GM0007,Bellingwedde,2015JJ00,2015,9154,84,60,6.6,118,13,-58,796,87.8,262,534,921,101.6,53,-6,868,-125,-183,-20,8971
12128,T001038,Total male and female,GM0007,Bellingwedde,2016JJ00,2016,8971,83,61,6.8,121,13.5,-60,887,99.2,208,679,882,98.6,53,-8,829,5,-52,-5.8,8919
12129,T001038,Total male and female,GM0007,Bellingwedde,2017JJ00,2017,8919,82,65,7.3,136,15.3,-71,699,78.8,79,620,732,82.5,69,-28,663,-33,-103,-11.5,8816
12702,T001038,Total male and female,GM1945,Berg en Dal,2016JJ00,2016,34574,400,262,7.6,444,12.8,-182,1925,55.5,226,1699,1555,44.9,142,-7,1413,370,190,5.5,34764
12703,T001038,Total male and female,GM1945,Berg en Dal,2017JJ00,2017,34764,402,250,7.2,439,12.6,-189,1912,55,200,1712,1737,50,162,-7,1575,175,-16,-0.5,34748
12704,T001038,Total male and female,GM1945,Berg en Dal,2018JJ00,2018,34748,402,249,7.2,436,12.5,-187,1842,53,208,1634,1623,46.7,183,-7,1440,219,25,0.7,34773
12705,T001038,Total male and female,GM1945,Berg en Dal,2019JJ00,2019,34798,403,286,8.2,447,12.8,-161,1921,55.1,201,1720,1566,44.9,175,-19,1391,355,194,5.6,34992
12706,T001038,Total male and female,GM1945,Berg en Dal,2020JJ00,2020,34992,405,289,8.3,452,12.9,-163,1733,49.5,173,1560,1547,44.2,129,-7,1418,186,18,0.5,35010
12707,T001038,Total male and female,GM1945,Berg en Dal,2021JJ00,2021,35010,406,305,8.7,477,13.6,-172,1637,46.8,156,1481,1523,43.5,150,-11,1373,114,-59,-1.7,34951
12708,T001038,Total male and female,GM1945,Berg en Dal,2022JJ00,2022,34951,405,282,8,469,13.3,-187,2105,59.8,594,1511,1449,41.2,181,-17,1268,656,469,13.4,35420
12709,T001038,Total male and female,GM1945,Berg en Dal,2023JJ00,2023,35420,410,253,7.1,500,14.1,-247,1983,55.9,319,1664,1677,47.3,259,-70,1418,306,54,1.5,35474
12862,T001038,Total male and female,GM0491,Bergambacht,2012JJ00,2012,9908,282,90,9.1,74,7.5,16,355,35.8,40,315,343,34.6,5,7,338,12,30,3,9938
12863,T001038,Total male and female,GM0491,Bergambacht,2013JJ00,2013,9938,283,83,8.3,85,8.5,-2,449,45.1,49,400,414,41.6,32,-11,382,35,32,3.2,9970
12864,T001038,Total male and female,GM0491,Bergambacht,2014JJ00,2014,9970,284,113,11.2,82,8.1,31,472,46.8,54,418,397,39.4,27,-2,370,75,216,21.7,10186
12944,T001038,Total male and female,GM1724,Bergeijk,2012JJ00,2012,18123,179,143,7.9,137,7.5,6,631,34.8,90,541,570,31.4,62,-14,508,61,68,3.8,18191
12945,T001038,Total male and female,GM1724,Bergeijk,2013JJ00,2013,18191,180,135,7.4,114,6.3,21,636,34.9,86,550,591,32.4,93,-10,498,45,65,3.6,18256
12946,T001038,Total male and female,GM1724,Bergeijk,2014JJ00,2014,18256,181,155,8.5,141,7.7,14,628,34.4,117,511,689,37.8,72,-2,617,-61,-47,-2.6,18209
12947,T001038,Total male and female,GM1724,Bergeijk,2015JJ00,2015,18209,180,144,7.9,163,8.9,-19,783,42.9,140,643,719,39.4,107,-16,612,64,44,2.4,18253
12948,T001038,Total male and female,GM1724,Bergeijk,2016JJ00,2016,18253,181,153,8.4,157,8.6,-4,803,43.9,140,663,711,38.9,91,-12,620,92,89,4.9,18342
12949,T001038,Total male and female,GM1724,Bergeijk,2017JJ00,2017,18342,182,137,7.5,156,8.5,-19,850,46.3,156,694,770,41.9,104,-9,666,80,56,3.1,18398
12950,T001038,Total male and female,GM1724,Bergeijk,2018JJ00,2018,18398,182,168,9.1,151,8.2,17,870,47.2,172,698,793,43,120,-14,673,77,93,5.1,18491
12951,T001038,Total male and female,GM1724,Bergeijk,2019JJ00,2019,18491,183,147,7.9,142,7.6,5,935,50.4,183,752,797,42.9,126,-6,671,138,144,7.8,18635
12952,T001038,Total male and female,GM1724,Bergeijk,2020JJ00,2020,18635,185,182,9.7,178,9.5,4,833,44.6,132,701,716,38.3,93,-18,623,117,119,6.4,18754
12953,T001038,Total male and female,GM1724,Bergeijk,2021JJ00,2021,18754,186,178,9.5,172,9.1,6,938,49.8,146,792,819,43.5,138,-28,681,119,125,6.7,18879
12954,T001038,Total male and female,GM1724,Bergeijk,2022JJ00,2022,18879,187,148,7.8,175,9.2,-27,901,47.5,239,662,662,34.9,123,-22,539,239,213,11.3,19092
12955,T001038,Total male and female,GM1724,Bergeijk,2023JJ00,2023,19092,189,153,8,174,9.1,-21,850,44.4,204,646,725,37.9,183,-46,542,125,104,5.4,19196
13026,T001038,Total male and female,GM0893,Bergen (L.),2012JJ00,2012,13286,128,110,8.3,100,7.5,10,456,34.3,67,389,478,36,74,-9,404,-22,-11,-0.8,13275
13027,T001038,Total male and female,GM0893,Bergen (L.),2013JJ00,2013,13275,128,89,6.7,116,8.8,-27,359,27.1,44,315,370,27.9,35,1,335,-11,-38,-2.9,13237
13028,T001038,Total male and female,GM0893,Bergen (L.),2014JJ00,2014,13237,128,112,8.5,126,9.5,-14,387,29.3,57,330,457,34.6,44,3,413,-70,-85,-6.4,13152
13029,T001038,Total male and female,GM0893,Bergen (L.),2015JJ00,2015,13152,127,109,8.3,155,11.8,-46,444,33.8,47,397,462,35.2,74,-5,388,-18,-62,-4.7,13090
13030,T001038,Total male and female,GM0893,Bergen (L.),2016JJ00,2016,13090,127,92,7,121,9.2,-29,483,36.9,59,424,451,34.4,35,1,416,32,5,0.4,13095
13031,T001038,Total male and female,GM0893,Bergen (L.),2017JJ00,2017,13095,127,107,8.2,118,9,-11,501,38.2,56,445,479,36.6,39,2,440,22,11,0.8,13106
13032,T001038,Total male and female,GM0893,Bergen (L.),2018JJ00,2018,13106,127,89,6.8,135,10.3,-46,521,39.7,64,457,442,33.7,30,5,412,79,34,2.6,13140
13033,T001038,Total male and female,GM0893,Bergen (L.),2019JJ00,2019,13140,127,95,7.2,152,11.6,-57,521,39.7,86,435,518,39.5,50,-5,468,3,-55,-4.2,13085
13034,T001038,Total male and female,GM0893,Bergen (L.),2020JJ00,2020,13085,127,82,6.3,132,10.1,-50,568,43.4,76,492,495,37.8,44,0,451,73,23,1.8,13108
13035,T001038,Total male and female,GM0893,Bergen (L.),2021JJ00,2021,13108,127,114,8.7,145,11.1,-31,548,41.8,76,472,518,39.5,49,2,469,30,-2,-0.2,13106
13036,T001038,Total male and female,GM0893,Bergen (L.),2022JJ00,2022,13106,127,85,6.5,133,10.1,-48,568,43.3,88,480,507,38.7,66,-6,441,61,13,1,13119
13037,T001038,Total male and female,GM0893,Bergen (L.),2023JJ00,2023,13119,127,93,7.1,133,10.1,-40,569,43.3,85,484,494,37.6,44,-1,450,75,35,2.7,13154
13108,T001038,Total male and female,GM0373,Bergen (NH.),2012JJ00,2012,30682,316,153,5,426,14,-273,1222,40.1,201,1021,1301,42.6,257,-21,1044,-79,-349,-11.4,30333
13109,T001038,Total male and female,GM0373,Bergen (NH.),2013JJ00,2013,30333,312,155,5.1,413,13.7,-258,1309,43.3,208,1101,1307,43.3,188,-1,1119,2,-257,-8.5,30076
13110,T001038,Total male and female,GM0373,Bergen (NH.),2014JJ00,2014,30076,310,163,5.4,361,12,-198,1434,47.7,270,1164,1305,43.4,168,-7,1137,129,-71,-2.4,30005
13111,T001038,Total male and female,GM0373,Bergen (NH.),2015JJ00,2015,30005,309,137,4.6,389,13,-252,1674,55.8,325,1349,1485,49.5,197,-12,1288,189,-62,-2.1,29943
13112,T001038,Total male and female,GM0373,Bergen (NH.),2016JJ00,2016,29943,308,158,5.3,413,13.8,-255,1717,57.4,249,1468,1566,52.4,184,-14,1382,151,-99,-3.3,29844
13113,T001038,Total male and female,GM0373,Bergen (NH.),2017JJ00,2017,29844,307,153,5.1,441,14.8,-288,1772,59.3,213,1559,1386,46.4,148,4,1238,386,97,3.3,29941
13114,T001038,Total male and female,GM0373,Bergen (NH.),2018JJ00,2018,29941,303,146,4.9,414,13.8,-268,1627,54.3,226,1401,1327,44.3,142,3,1185,300,33,1.1,29974
13115,T001038,Total male and female,GM0373,Bergen (NH.),2019JJ00,2019,29974,303,145,4.8,424,14.2,-279,1530,51.2,247,1283,1385,46.3,104,11,1281,145,-135,-4.5,29839
13116,T001038,Total male and female,GM0373,Bergen (NH.),2020JJ00,2020,29839,302,148,5,478,16.1,-330,1671,56.1,197,1474,1465,49.2,142,-6,1323,206,-124,-4.2,29715
13117,T001038,Total male and female,GM0373,Bergen (NH.),2021JJ00,2021,29715,300,154,5.2,417,14,-263,1578,53.1,212,1366,1309,44,120,-3,1189,269,8,0.3,29723
13118,T001038,Total male and female,GM0373,Bergen (NH.),2022JJ00,2022,29723,300,142,4.7,458,15.3,-316,2019,67.5,544,1475,1288,43,187,3,1101,731,415,14,30138
13119,T001038,Total male and female,GM0373,Bergen (NH.),2023JJ00,2023,30138,304,165,5.5,450,15,-285,1664,55.4,274,1390,1582,52.7,275,-28,1307,82,-206,-6.8,29932
13190,T001038,Total male and female,GM0748,Bergen op Zoom,2012JJ00,2012,66130,826,619,9.3,587,8.9,32,2246,33.9,472,1774,2124,32.1,411,-68,1713,122,157,2.4,66287
13191,T001038,Total male and female,GM0748,Bergen op Zoom,2013JJ00,2013,66287,825,643,9.7,597,9,46,2297,34.6,501,1796,2213,33.4,394,-39,1819,84,132,2,66419
13192,T001038,Total male and female,GM0748,Bergen op Zoom,2014JJ00,2014,66419,827,625,9.4,605,9.1,20,2357,35.5,459,1898,2470,37.2,529,-92,1941,-113,-99,-1.5,66320
13193,T001038,Total male and female,GM0748,Bergen op Zoom,2015JJ00,2015,66320,826,610,9.2,645,9.7,-35,2415,36.4,461,1954,2459,37.1,519,-67,1940,-44,-83,-1.3,66237
13194,T001038,Total male and female,GM0748,Bergen op Zoom,2016JJ00,2016,66237,829,644,9.7,687,10.4,-43,2550,38.5,470,2080,2572,38.9,488,-66,2084,-22,-73,-1.1,66164
13195,T001038,Total male and female,GM0748,Bergen op Zoom,2017JJ00,2017,66164,828,631,9.5,690,10.4,-59,2804,42.3,476,2328,2555,38.6,412,-83,2143,249,190,2.9,66354
13196,T001038,Total male and female,GM0748,Bergen op Zoom,2018JJ00,2018,66354,830,591,8.9,641,9.6,-50,2995,45,554,2441,2490,37.4,400,-28,2090,505,457,6.9,66811
13197,T001038,Total male and female,GM0748,Bergen op Zoom,2019JJ00,2019,66811,836,630,9.4,621,9.2,9,3136,46.7,618,2518,2459,36.6,394,-25,2065,677,685,10.3,67496
13198,T001038,Total male and female,GM0748,Bergen op Zoom,2020JJ00,2020,67496,844,623,9.2,789,11.7,-166,2844,42.1,584,2260,2655,39.3,299,-12,2356,189,18,0.3,67514
13199,T001038,Total male and female,GM0748,Bergen op Zoom,2021JJ00,2021,67514,844,669,9.9,771,11.4,-102,2987,44.1,593,2394,2499,36.9,431,-91,2068,488,380,5.6,67894
13200,T001038,Total male and female,GM0748,Bergen op Zoom,2022JJ00,2022,67894,849,608,8.9,693,10.1,-85,3513,51.4,981,2532,2449,35.8,528,-93,1921,1064,970,14.3,68864
13201,T001038,Total male and female,GM0748,Bergen op Zoom,2023JJ00,2023,68864,861,601,8.7,766,11.1,-165,3618,52.2,920,2698,2615,37.7,513,-59,2102,1003,830,12.1,69694
13846,T001038,Total male and female,GM1859,Berkelland,2012JJ00,2012,44911,174,350,7.8,409,9.1,-59,1301,29,113,1188,1386,30.9,99,-14,1287,-85,-142,-3.2,44769
13847,T001038,Total male and female,GM1859,Berkelland,2013JJ00,2013,44769,173,329,7.4,397,8.9,-68,1277,28.6,89,1188,1321,29.5,65,1,1256,-44,-103,-2.3,44666
13848,T001038,Total male and female,GM1859,Berkelland,2014JJ00,2014,44666,173,324,7.3,369,8.3,-45,1261,28.3,126,1135,1512,34,103,-15,1409,-251,-302,-6.8,44364
13849,T001038,Total male and female,GM1859,Berkelland,2015JJ00,2015,44364,172,327,7.4,400,9,-73,1490,33.6,198,1292,1342,30.2,76,-9,1266,148,73,1.6,44437
13850,T001038,Total male and female,GM1859,Berkelland,2016JJ00,2016,44437,172,340,7.7,427,9.6,-87,1361,30.7,139,1222,1470,33.2,75,2,1395,-109,-199,-4.5,44238
13851,T001038,Total male and female,GM1859,Berkelland,2017JJ00,2017,44238,171,312,7.1,459,10.4,-147,1452,32.9,92,1360,1515,34.3,94,-6,1421,-63,-206,-4.7,44032
13852,T001038,Total male and female,GM1859,Berkelland,2018JJ00,2018,44032,171,323,7.3,480,10.9,-157,1423,32.4,114,1309,1393,31.7,81,-9,1312,30,-128,-2.9,43904
13853,T001038,Total male and female,GM1859,Berkelland,2019JJ00,2019,43904,170,325,7.4,479,10.9,-154,1457,33.2,151,1306,1459,33.3,118,-2,1341,-2,-157,-3.6,43747
13854,T001038,Total male and female,GM1859,Berkelland,2020JJ00,2020,43747,170,310,7.1,480,11,-170,1572,35.9,136,1436,1306,29.8,78,-3,1228,266,99,2.3,43846
13855,T001038,Total male and female,GM1859,Berkelland,2021JJ00,2021,43846,170,361,8.2,493,11.2,-132,1439,32.8,102,1337,1302,29.7,73,5,1229,137,4,0.1,43850
13856,T001038,Total male and female,GM1859,Berkelland,2022JJ00,2022,43850,170,337,7.7,503,11.4,-166,1675,38.1,309,1366,1338,30.5,140,-19,1198,337,172,3.9,44022
13857,T001038,Total male and female,GM1859,Berkelland,2023JJ00,2023,44022,171,338,7.7,504,11.5,-166,1596,36.3,280,1316,1520,34.6,168,-49,1352,76,-89,-2,43933
14174,T001038,Total male and female,GM1721,Bernheze,2012JJ00,2012,29802,332,268,9,231,7.8,37,1074,36.1,147,927,1141,38.3,80,-21,1061,-67,-27,-0.9,29775
14175,T001038,Total male and female,GM1721,Bernheze,2013JJ00,2013,29775,332,272,9.1,245,8.2,27,1028,34.6,153,875,1141,38.4,114,-18,1027,-113,-85,-2.9,29690
14176,T001038,Total male and female,GM1721,Bernheze,2014JJ00,2014,29690,331,258,8.7,269,9.1,-11,1200,40.4,146,1054,1150,38.7,123,-24,1027,50,39,1.3,29729
14177,T001038,Total male and female,GM1721,Bernheze,2015JJ00,2015,29729,331,228,7.6,259,8.7,-31,1389,46.6,150,1239,1208,40.5,110,-37,1098,181,151,5.1,29880
14178,T001038,Total male and female,GM1721,Bernheze,2016JJ00,2016,29880,333,268,8.9,270,9,-2,1532,51,190,1342,1157,38.5,97,-25,1060,375,372,12.4,30252
14179,T001038,Total male and female,GM1721,Bernheze,2017JJ00,2017,30252,337,281,9.2,273,9,8,1676,55.1,228,1448,1384,45.5,127,-31,1257,292,298,9.9,30550
14180,T001038,Total male and female,GM1721,Bernheze,2018JJ00,2018,30550,340,286,9.3,303,9.9,-17,1567,51.1,264,1303,1294,42.2,107,-21,1187,273,256,8.4,30806
14181,T001038,Total male and female,GM1721,Bernheze,2019JJ00,2019,30806,343,287,9.3,278,9,9,1756,56.6,316,1440,1331,42.9,220,-67,1111,425,434,14.1,31240
14182,T001038,Total male and female,GM1721,Bernheze,2020JJ00,2020,31240,348,315,10,375,12,-60,1666,53.1,267,1399,1389,44.3,172,-61,1217,277,215,6.9,31455
14183,T001038,Total male and female,GM1721,Bernheze,2021JJ00,2021,31455,351,291,9.2,313,9.9,-22,1821,57.7,241,1580,1539,48.7,193,-63,1346,282,260,8.3,31715
14184,T001038,Total male and female,GM1721,Bernheze,2022JJ00,2022,31715,353,294,9.2,324,10.1,-30,1931,60.4,491,1440,1353,42.3,256,-61,1097,578,548,17.3,32263
14185,T001038,Total male and female,GM1721,Bernheze,2023JJ00,2023,32263,360,285,8.8,324,10,-39,1713,52.9,467,1246,1410,43.5,235,-53,1175,303,264,8.2,32527
14256,T001038,Total male and female,GM0568,Bernisse,2012JJ00,2012,12426,217,89,7.2,89,7.2,0,348,28,27,321,375,30.2,31,-3,344,-27,-28,-2.3,12398
14257,T001038,Total male and female,GM0568,Bernisse,2013JJ00,2013,12398,216,107,8.6,81,6.5,26,363,29.3,33,330,417,33.7,21,-4,396,-54,-30,-2.4,12368
14258,T001038,Total male and female,GM0568,Bernisse,2014JJ00,2014,12368,216,106,8.6,99,8,7,324,26.2,32,292,421,34,20,3,401,-97,13,1.1,12381
14338,T001038,Total male and female,GM0753,Best,2012JJ00,2012,28696,836,250,8.7,195,6.8,55,921,32.1,176,745,1036,36.1,115,-37,921,-115,-59,-2.1,28637
14339,T001038,Total male and female,GM0753,Best,2013JJ00,2013,28637,835,240,8.4,205,7.2,35,909,31.8,128,781,966,33.7,111,4,855,-57,-20,-0.7,28617
14340,T001038,Total male and female,GM0753,Best,2014JJ00,2014,28617,834,243,8.5,207,7.2,36,1097,38.3,189,908,1013,35.3,146,-17,867,84,120,4.2,28737
14341,T001038,Total male and female,GM0753,Best,2015JJ00,2015,28737,838,241,8.4,202,7,39,1223,42.4,183,1040,1023,35.5,125,-12,898,200,239,8.3,28976
14342,T001038,Total male and female,GM0753,Best,2016JJ00,2016,28976,845,249,8.6,217,7.5,32,1287,44.3,163,1124,1114,38.3,123,-23,991,173,204,7,29180
14343,T001038,Total male and female,GM0753,Best,2017JJ00,2017,29180,851,246,8.4,203,6.9,43,1512,51.5,333,1179,1238,42.2,160,-21,1078,274,317,10.9,29497
14344,T001038,Total male and female,GM0753,Best,2018JJ00,2018,29497,860,297,10,226,7.6,71,1499,50.5,311,1188,1245,42,175,-53,1070,254,324,11,29821
14345,T001038,Total male and female,GM0753,Best,2019JJ00,2019,29821,869,249,8.3,249,8.3,0,1439,48.1,324,1115,1271,42.5,191,-55,1080,168,167,5.6,29988
14346,T001038,Total male and female,GM0753,Best,2020JJ00,2020,29988,874,285,9.5,278,9.2,7,1666,55.3,304,1362,1445,48,217,-67,1228,221,228,7.6,30216
14347,T001038,Total male and female,GM0753,Best,2021JJ00,2021,30216,881,331,10.9,211,6.9,120,1744,57.3,326,1418,1471,48.4,204,-43,1267,273,392,13,30608
14348,T001038,Total male and female,GM0753,Best,2022JJ00,2022,30608,903,277,9,263,8.6,14,1687,54.9,448,1239,1414,46,267,-42,1147,273,289,9.4,30897
14349,T001038,Total male and female,GM0753,Best,2023JJ00,2023,30897,912,290,9.3,240,7.7,50,1782,57.4,499,1283,1506,48.5,300,-32,1206,276,326,10.6,31223
14502,T001038,Total male and female,GM0209,Beuningen,2012JJ00,2012,25433,582,211,8.3,168,6.6,43,880,34.7,88,792,1029,40.5,70,0,959,-149,-109,-4.3,25324
14503,T001038,Total male and female,GM0209,Beuningen,2013JJ00,2013,25324,580,222,8.8,168,6.6,54,980,38.7,72,908,1070,42.3,49,3,1021,-90,-36,-1.4,25288
14504,T001038,Total male and female,GM0209,Beuningen,2014JJ00,2014,25288,579,214,8.5,161,6.4,53,1003,39.7,88,915,1062,42,48,3,1014,-59,-6,-0.2,25282
14505,T001038,Total male and female,GM0209,Beuningen,2015JJ00,2015,25282,579,213,8.4,188,7.4,25,1209,47.8,85,1124,1230,48.6,62,2,1168,-21,7,0.3,25289
14506,T001038,Total male and female,GM0209,Beuningen,2016JJ00,2016,25289,579,221,8.7,174,6.9,47,1382,54.5,92,1290,1295,51.1,69,3,1226,87,135,5.3,25424
14507,T001038,Total male and female,GM0209,Beuningen,2017JJ00,2017,25424,582,242,9.4,206,8,36,1622,63.3,110,1512,1284,50.1,54,-1,1230,338,374,14.7,25798
14508,T001038,Total male and female,GM0209,Beuningen,2018JJ00,2018,25798,591,252,9.8,206,8,46,1288,49.8,80,1208,1245,48.2,74,-7,1171,43,84,3.3,25882
14509,T001038,Total male and female,GM0209,Beuningen,2019JJ00,2019,25882,593,239,9.2,238,9.2,1,1210,46.7,109,1101,1200,46.4,69,-7,1131,10,8,0.3,25890
14510,T001038,Total male and female,GM0209,Beuningen,2020JJ00,2020,25890,593,260,10,194,7.5,66,1368,52.6,90,1278,1163,44.7,35,4,1128,205,267,10.3,26157
14511,T001038,Total male and female,GM0209,Beuningen,2021JJ00,2021,26157,599,232,8.9,212,8.1,20,1184,45.2,63,1121,1126,43,61,1,1065,58,78,3,26235
14512,T001038,Total male and female,GM0209,Beuningen,2022JJ00,2022,26235,602,262,9.9,255,9.7,7,1437,54.4,305,1132,1107,41.9,93,-4,1014,330,338,12.9,26573
14513,T001038,Total male and female,GM0209,Beuningen,2023JJ00,2023,26573,609,235,8.8,250,9.4,-15,1311,49.2,108,1203,1144,42.9,126,-37,1018,167,152,5.7,26725
14666,T001038,Total male and female,GM0375,Beverwijk,2012JJ00,2012,39844,2173,469,11.7,392,9.8,77,2150,53.8,329,1821,2001,50.1,277,-91,1724,149,226,5.7,40070
14667,T001038,Total male and female,GM0375,Beverwijk,2013JJ00,2013,40070,2187,439,11,355,8.9,84,1885,47,333,1552,1945,48.5,294,-40,1651,-60,23,0.6,40093
14668,T001038,Total male and female,GM0375,Beverwijk,2014JJ00,2014,40093,2188,470,11.7,326,8.1,144,2040,50.8,324,1716,2097,52.2,338,-75,1759,-57,89,2.2,40182
14669,T001038,Total male and female,GM0375,Beverwijk,2015JJ00,2015,40182,2193,450,11.2,382,9.5,68,2388,59.3,394,1994,2314,57.5,375,-114,1939,74,136,3.4,40318
14670,T001038,Total male and female,GM0375,Beverwijk,2016JJ00,2016,40318,2202,439,10.8,352,8.7,87,2588,63.9,371,2217,2282,56.3,305,-115,1977,306,391,9.7,40709
14671,T001038,Total male and female,GM0375,Beverwijk,2017JJ00,2017,40709,2223,474,11.6,381,9.3,93,2608,63.8,371,2237,2329,57,384,-121,1945,279,368,9,41077
14672,T001038,Total male and female,GM0375,Beverwijk,2018JJ00,2018,41077,2232,424,10.3,430,10.5,-6,2461,59.8,448,2013,2352,57.2,403,-87,1949,109,99,2.4,41176
14673,T001038,Total male and female,GM0375,Beverwijk,2019JJ00,2019,41176,2238,457,11,399,9.6,58,2644,63.9,432,2212,2255,54.5,369,-69,1886,389,450,10.9,41626
14674,T001038,Total male and female,GM0375,Beverwijk,2020JJ00,2020,41626,2262,441,10.6,456,10.9,-15,2643,63.3,419,2224,2388,57.2,291,-23,2097,255,237,5.7,41863
14675,T001038,Total male and female,GM0375,Beverwijk,2021JJ00,2021,41863,2275,468,11.1,450,10.7,18,2452,58.4,329,2123,2248,53.6,274,-50,1974,204,221,5.3,42084
14676,T001038,Total male and female,GM0375,Beverwijk,2022JJ00,2022,42084,2293,446,10.5,421,9.9,25,2959,69.8,588,2371,2354,55.5,340,-87,2014,605,627,14.9,42711
14677,T001038,Total male and female,GM0375,Beverwijk,2023JJ00,2023,42711,2328,450,10.5,454,10.6,-4,2519,58.9,563,1956,2362,55.2,363,-87,1999,157,155,3.6,42866
14994,T001038,Total male and female,GM0063,het Bildt,2012JJ00,2012,10798,117,102,9.5,74,6.9,28,545,50.8,187,358,727,67.8,80,-40,647,-182,-152,-14.1,10646
14995,T001038,Total male and female,GM0063,het Bildt,2013JJ00,2013,10646,115,96,9,72,6.8,24,722,67.9,402,320,772,72.6,65,-32,707,-50,-20,-1.9,10626
14996,T001038,Total male and female,GM0063,het Bildt,2014JJ00,2014,10626,115,93,8.8,83,7.8,10,918,86.5,484,434,962,90.7,79,-38,883,-44,-34,-3.2,10592
14997,T001038,Total male and female,GM0063,het Bildt,2015JJ00,2015,10592,115,79,7.5,90,8.5,-11,866,82,353,513,916,86.8,69,-45,847,-50,-67,-6.3,10525
14998,T001038,Total male and female,GM0063,het Bildt,2016JJ00,2016,10525,114,109,10.4,112,10.7,-3,845,80.4,243,602,877,83.5,30,-3,847,-32,-32,-3,10493
14999,T001038,Total male and female,GM0063,het Bildt,2017JJ00,2017,10493,114,77,7.3,110,10.4,-33,951,90.3,164,787,860,81.7,99,-46,761,91,67,6.4,10560
15076,T001038,Total male and female,GM0310,De Bilt,2012JJ00,2012,42079,635,351,8.3,501,11.9,-150,2201,52.3,251,1950,2102,50,245,-40,1857,99,-47,-1.1,42032
15077,T001038,Total male and female,GM0310,De Bilt,2013JJ00,2013,42032,634,332,7.9,525,12.5,-193,2328,55.4,239,2089,2134,50.8,222,2,1912,194,4,0.1,42036
15078,T001038,Total male and female,GM0310,De Bilt,2014JJ00,2014,42036,634,326,7.7,463,11,-137,2640,62.7,252,2388,2371,56.3,201,-22,2170,269,133,3.2,42169
15079,T001038,Total male and female,GM0310,De Bilt,2015JJ00,2015,42169,636,337,8,528,12.5,-191,2923,69.1,257,2666,2527,59.8,246,-8,2281,396,206,4.9,42375
15080,T001038,Total male and female,GM0310,De Bilt,2016JJ00,2016,42375,641,355,8.3,554,13,-199,3130,73.5,259,2871,2554,60,196,3,2358,576,379,8.9,42754
15081,T001038,Total male and female,GM0310,De Bilt,2017JJ00,2017,42754,647,369,8.6,505,11.8,-136,2820,65.9,293,2527,2590,60.5,189,12,2401,230,92,2.2,42846
15082,T001038,Total male and female,GM0310,De Bilt,2018JJ00,2018,42846,648,353,8.2,527,12.3,-174,2745,64.1,328,2417,2595,60.6,197,-18,2398,150,-22,-0.5,42824
15083,T001038,Total male and female,GM0310,De Bilt,2019JJ00,2019,42824,648,363,8.4,514,12,-151,2944,68.5,379,2565,2480,57.7,230,-32,2250,464,313,7.3,43137
15084,T001038,Total male and female,GM0310,De Bilt,2020JJ00,2020,43137,652,378,8.7,541,12.5,-163,3061,70.8,284,2777,2651,61.3,198,-19,2453,410,247,5.7,43384
15085,T001038,Total male and female,GM0310,De Bilt,2021JJ00,2021,43384,656,411,9.5,541,12.5,-130,2796,64.4,293,2503,2544,58.6,168,-6,2376,252,124,2.9,43508
15086,T001038,Total male and female,GM0310,De Bilt,2022JJ00,2022,43508,657,400,9.2,533,12.2,-133,2888,66.1,534,2354,2376,54.4,241,-10,2135,512,376,8.6,43884
15087,T001038,Total male and female,GM0310,De Bilt,2023JJ00,2023,43884,663,359,8.2,579,13.2,-220,2759,63,402,2357,2702,61.7,246,-8,2456,57,-166,-3.8,43718
15240,T001038,Total male and female,GM0585,Binnenmaas,2012JJ00,2012,28962,418,266,9.2,234,8.1,32,1191,41.1,211,980,1225,42.3,96,-11,1129,-34,2,0.1,28964
15241,T001038,Total male and female,GM0585,Binnenmaas,2013JJ00,2013,28964,418,240,8.3,236,8.2,4,970,33.6,93,877,1228,42.6,114,-57,1114,-258,-254,-8.8,28710
15242,T001038,Total male and female,GM0585,Binnenmaas,2014JJ00,2014,28710,414,263,9.2,240,8.4,23,956,33.3,70,886,1033,36,53,2,980,-77,-54,-1.9,28656
15243,T001038,Total male and female,GM0585,Binnenmaas,2015JJ00,2015,28656,413,225,7.8,220,7.7,5,1106,38.5,142,964,996,34.7,85,-8,911,110,115,4,28771
15244,T001038,Total male and female,GM0585,Binnenmaas,2016JJ00,2016,28771,415,263,9.1,264,9.1,-1,1736,60,270,1466,1387,47.9,48,2,1339,349,351,12.2,29122
15245,T001038,Total male and female,GM0585,Binnenmaas,2017JJ00,2017,29122,420,286,9.8,266,9.1,20,1693,58.2,76,1617,1735,59.6,126,-47,1609,-42,-24,-0.8,29098
15246,T001038,Total male and female,GM0585,Binnenmaas,2018JJ00,2018,29098,420,241,8.3,282,9.7,-41,1360,46.6,77,1283,1118,38.3,67,5,1051,242,194,6.7,29292
15322,T001038,Total male and female,GM1728,Bladel,2012JJ00,2012,19582,260,170,8.7,172,8.8,-2,695,35.4,134,561,641,32.7,72,-7,569,54,53,2.7,19635
15323,T001038,Total male and female,GM1728,Bladel,2013JJ00,2013,19635,261,200,10.1,156,7.9,44,842,42.7,144,698,689,34.9,73,-10,616,153,199,10.1,19834
15324,T001038,Total male and female,GM1728,Bladel,2014JJ00,2014,19834,263,163,8.2,171,8.6,-8,769,38.7,133,636,721,36.3,104,-30,617,48,35,1.8,19869
15325,T001038,Total male and female,GM1728,Bladel,2015JJ00,2015,19869,264,186,9.3,209,10.5,-23,810,40.7,143,667,692,34.7,97,-24,595,118,97,4.9,19966
15326,T001038,Total male and female,GM1728,Bladel,2016JJ00,2016,19966,265,177,8.8,167,8.3,10,908,45.4,142,766,818,40.9,105,-20,713,90,97,4.9,20063
15327,T001038,Total male and female,GM1728,Bladel,2017JJ00,2017,20063,266,184,9.2,188,9.4,-4,898,44.7,136,762,813,40.4,105,-24,708,85,81,4,20144
15328,T001038,Total male and female,GM1728,Bladel,2018JJ00,2018,20144,267,165,8.2,201,10,-36,829,41.1,142,687,766,38,104,-25,662,63,31,1.5,20175
15329,T001038,Total male and female,GM1728,Bladel,2019JJ00,2019,20175,268,169,8.3,171,8.4,-2,931,45.9,180,751,711,35.1,94,-11,617,220,215,10.7,20390
15330,T001038,Total male and female,GM1728,Bladel,2020JJ00,2020,20390,271,198,9.7,231,11.3,-33,932,45.6,141,791,758,37,102,-29,656,174,139,6.8,20529
15331,T001038,Total male and female,GM1728,Bladel,2021JJ00,2021,20529,273,175,8.5,188,9.1,-13,1003,48.6,154,849,800,38.8,114,-26,686,203,189,9.2,20718
15332,T001038,Total male and female,GM1728,Bladel,2022JJ00,2022,20718,275,189,9.1,209,10,-20,1042,49.9,250,792,732,35.1,115,-12,617,310,291,14,21009
15333,T001038,Total male and female,GM1728,Bladel,2023JJ00,2023,21009,279,179,8.5,222,10.6,-43,871,41.5,249,622,850,40.5,151,-32,699,21,-24,-1.1,20985
15568,T001038,Total male and female,GM0376,Blaricum,2012JJ00,2012,9038,814,55,6.1,79,8.7,-24,602,66.4,57,545,507,55.9,57,-12,450,95,69,7.6,9107
15569,T001038,Total male and female,GM0376,Blaricum,2013JJ00,2013,9107,817,64,7,80,8.8,-16,523,57.5,59,464,519,57,49,0,470,4,-13,-1.4,9094
15570,T001038,Total male and female,GM0376,Blaricum,2014JJ00,2014,9094,816,63,6.8,81,8.8,-18,751,81.6,67,684,518,56.3,61,-11,457,233,218,24,9312
15571,T001038,Total male and female,GM0376,Blaricum,2015JJ00,2015,9312,835,86,9.1,96,10.1,-10,903,95.4,77,826,583,61.6,63,1,520,320,310,33.3,9622
15572,T001038,Total male and female,GM0376,Blaricum,2016JJ00,2016,9622,863,95,9.6,91,9.2,4,1167,117.7,84,1083,590,59.5,75,0,515,577,579,60.2,10201
15573,T001038,Total male and female,GM0376,Blaricum,2017JJ00,2017,10201,915,120,11.4,95,9,25,1314,125.2,78,1236,744,70.9,65,-6,679,570,594,58.2,10795
15574,T001038,Total male and female,GM0376,Blaricum,2018JJ00,2018,10795,972,142,12.9,100,9.1,42,1058,96.2,121,937,689,62.6,83,-5,606,369,407,37.7,11202
15575,T001038,Total male and female,GM0376,Blaricum,2019JJ00,2019,11202,1008,132,11.6,85,7.5,47,1044,91.8,85,959,792,69.7,71,-5,721,252,338,30.2,11540
15576,T001038,Total male and female,GM0376,Blaricum,2020JJ00,2020,11540,1039,136,11.6,85,7.2,51,1152,98.1,102,1050,787,67,60,2,727,365,414,35.9,11954
15577,T001038,Total male and female,GM0376,Blaricum,2021JJ00,2021,11954,1076,143,11.8,117,9.6,26,1210,99.5,74,1136,827,68,95,0,732,383,405,33.9,12359
15578,T001038,Total male and female,GM0376,Blaricum,2022JJ00,2022,12359,1116,115,9.3,103,8.3,12,947,76.2,196,751,826,66.5,98,-1,728,121,131,10.6,12490
15579,T001038,Total male and female,GM0376,Blaricum,2023JJ00,2023,12490,1128,124,9.8,112,8.9,12,1086,86.1,178,908,863,68.5,110,-1,753,223,234,18.7,12724
15814,T001038,Total male and female,GM0377,Bloemendaal,2012JJ00,2012,22056,555,116,5.2,302,13.6,-186,1483,67,178,1305,1155,52.2,174,-22,981,328,139,6.3,22195
15815,T001038,Total male and female,GM0377,Bloemendaal,2013JJ00,2013,22195,558,103,4.7,303,13.7,-200,1328,60,176,1152,1265,57.2,156,-5,1109,63,-136,-6.1,22059
15816,T001038,Total male and female,GM0377,Bloemendaal,2014JJ00,2014,22059,555,126,5.7,284,12.8,-158,1766,79.7,238,1528,1410,63.6,155,-14,1255,356,197,8.9,22256
15817,T001038,Total male and female,GM0377,Bloemendaal,2015JJ00,2015,22256,560,114,5.1,290,13,-176,1833,82.3,192,1641,1624,72.9,182,-5,1442,209,40,1.8,22296
15818,T001038,Total male and female,GM0377,Bloemendaal,2016JJ00,2016,22296,561,121,5.4,284,12.6,-163,2210,98,316,1894,1516,67.2,195,-29,1321,694,530,23.8,22826
15819,T001038,Total male and female,GM0377,Bloemendaal,2017JJ00,2017,22826,575,140,6.1,300,13,-160,2128,92.5,282,1846,1580,68.6,212,-21,1368,548,382,16.7,23208
15820,T001038,Total male and female,GM0377,Bloemendaal,2018JJ00,2018,23208,583,143,6.1,290,12.4,-147,1945,83.4,248,1697,1596,68.5,216,-13,1380,349,202,8.7,23410
15821,T001038,Total male and female,GM0377,Bloemendaal,2019JJ00,2019,23410,588,130,5.5,299,12.7,-169,1908,81.2,276,1632,1577,67.1,200,-7,1377,331,161,6.9,23571
15822,T001038,Total male and female,GM0377,Bloemendaal,2020JJ00,2020,23571,592,108,4.6,315,13.4,-207,1812,77,218,1594,1694,72,164,0,1530,118,-93,-3.9,23478
15823,T001038,Total male and female,GM0377,Bloemendaal,2021JJ00,2021,23478,590,137,5.8,344,14.6,-207,2015,85.4,210,1805,1553,65.8,156,-7,1397,462,254,10.8,23732
15824,T001038,Total male and female,GM0377,Bloemendaal,2022JJ00,2022,23732,597,135,5.7,356,14.9,-221,2065,86.7,452,1613,1650,69.2,250,-17,1400,415,190,8,23922
15825,T001038,Total male and female,GM0377,Bloemendaal,2023JJ00,2023,23922,602,110,4.6,346,14.5,-236,1766,74,238,1528,1665,69.8,223,-10,1442,101,-136,-5.7,23786
16060,T001038,Total male and female,GM0055,Boarnsterhim,2012JJ00,2012,19380,128,194,10,135,6.9,59,916,47.1,59,857,855,44,79,-12,776,61,125,6.4,19505
16061,T001038,Total male and female,GM0055,Boarnsterhim,2013JJ00,2013,19505,129,181,9.3,148,7.6,33,822,42.2,61,761,878,45,58,-10,820,-56,-27,-1.4,19478
16306,T001038,Total male and female,GM1901,Bodegraven-Reeuwijk,2012JJ00,2012,32834,434,338,10.3,211,6.4,127,925,28.2,116,809,1070,32.6,149,-39,921,-145,-17,-0.5,32817
16307,T001038,Total male and female,GM1901,Bodegraven-Reeuwijk,2013JJ00,2013,32817,433,311,9.5,227,6.9,84,1042,31.7,149,893,1032,31.4,94,12,938,10,93,2.8,32910
16308,T001038,Total male and female,GM1901,Bodegraven-Reeuwijk,2014JJ00,2014,32910,435,377,11.4,222,6.7,155,1201,36.3,167,1034,1060,32.1,105,-12,955,141,298,9.1,33208
16309,T001038,Total male and female,GM1901,Bodegraven-Reeuwijk,2015JJ00,2015,33208,438,346,10.4,235,7.1,111,1305,39.2,142,1163,1172,35.2,84,-4,1088,133,243,7.3,33451
16310,T001038,Total male and female,GM1901,Bodegraven-Reeuwijk,2016JJ00,2016,33451,442,384,11.4,237,7.1,147,1489,44.3,165,1324,1352,40.2,104,-16,1248,137,282,8.4,33733
16311,T001038,Total male and female,GM1901,Bodegraven-Reeuwijk,2017JJ00,2017,33733,446,383,11.3,246,7.3,137,1519,44.9,183,1336,1441,42.6,97,-23,1344,78,215,6.4,33948
16312,T001038,Total male and female,GM1901,Bodegraven-Reeuwijk,2018JJ00,2018,33948,450,365,10.7,262,7.7,103,1764,51.6,178,1586,1348,39.4,107,-17,1241,416,514,15.1,34462
16313,T001038,Total male and female,GM1901,Bodegraven-Reeuwijk,2019JJ00,2019,34462,457,401,11.6,272,7.8,129,1668,48.1,215,1453,1387,40,125,-25,1262,281,410,11.9,34872
16314,T001038,Total male and female,GM1901,Bodegraven-Reeuwijk,2020JJ00,2020,34872,463,397,11.3,281,8,116,1711,48.8,211,1500,1421,40.5,95,-5,1326,290,406,11.6,35278
16315,T001038,Total male and female,GM1901,Bodegraven-Reeuwijk,2021JJ00,2021,35278,468,455,12.8,288,8.1,167,1648,46.4,190,1458,1338,37.7,149,-27,1189,310,474,13.4,35752
16316,T001038,Total male and female,GM1901,Bodegraven-Reeuwijk,2022JJ00,2022,35752,474,409,11.4,308,8.5,101,1879,52.2,390,1489,1425,39.6,163,-32,1262,454,556,15.6,36308
16317,T001038,Total male and female,GM1901,Bodegraven-Reeuwijk,2023JJ00,2023,36308,482,391,10.7,312,8.6,79,1807,49.6,335,1472,1625,44.6,183,-36,1442,182,261,7.2,36569
16388,T001038,Total male and female,GM0755,Boekel,2012JJ00,2012,9967,289,99,9.9,79,7.9,20,353,35.2,54,299,278,27.8,26,6,252,75,95,9.5,10062
16389,T001038,Total male and female,GM0755,Boekel,2013JJ00,2013,10062,292,90,8.9,68,6.7,22,349,34.6,50,299,345,34.2,10,4,335,4,27,2.7,10089
16390,T001038,Total male and female,GM0755,Boekel,2014JJ00,2014,10089,292,93,9.2,96,9.5,-3,349,34.5,49,300,316,31.3,18,0,298,33,30,3,10119
16391,T001038,Total male and female,GM0755,Boekel,2015JJ00,2015,10119,293,101,9.9,87,8.5,14,509,50,70,439,387,38,36,-12,351,122,135,13.3,10254
16392,T001038,Total male and female,GM0755,Boekel,2016JJ00,2016,10254,297,95,9.2,97,9.4,-2,534,51.7,52,482,372,36,42,-2,330,162,160,15.6,10414
16393,T001038,Total male and female,GM0755,Boekel,2017JJ00,2017,10414,302,95,9.1,88,8.4,7,505,48.3,62,443,424,40.5,29,-2,395,81,88,8.5,10502
16394,T001038,Total male and female,GM0755,Boekel,2018JJ00,2018,10502,304,101,9.6,86,8.2,15,536,50.8,54,482,464,44,48,-10,416,72,86,8.2,10588
16395,T001038,Total male and female,GM0755,Boekel,2019JJ00,2019,10588,307,99,9.3,90,8.4,9,555,51.9,67,488,367,34.3,31,2,336,188,197,18.6,10785
16396,T001038,Total male and female,GM0755,Boekel,2020JJ00,2020,10785,313,126,11.6,109,10,17,576,53,47,529,420,38.6,53,-12,367,156,174,16.1,10959
16397,T001038,Total male and female,GM0755,Boekel,2021JJ00,2021,10959,318,129,11.7,100,9.1,29,511,46.5,56,455,469,42.7,50,-16,419,42,71,6.5,11030
16398,T001038,Total male and female,GM0755,Boekel,2022JJ00,2022,11030,320,126,11.4,111,10,15,513,46.2,102,411,396,35.7,68,-18,328,117,133,12.1,11163
16399,T001038,Total male and female,GM0755,Boekel,2023JJ00,2023,11163,324,133,11.8,102,9.1,31,550,49,74,476,451,40.2,59,-16,392,99,130,11.6,11293
16470,T001038,Total male and female,GM0009,Ten Boer,2012JJ00,2012,7477,165,92,12.3,90,12,2,313,41.8,13,300,292,39,19,0,273,21,23,3.1,7500
16471,T001038,Total male and female,GM0009,Ten Boer,2013JJ00,2013,7500,166,74,9.9,76,10.1,-2,296,39.5,12,284,315,42.1,22,2,293,-19,-21,-2.8,7479
16472,T001038,Total male and female,GM0009,Ten Boer,2014JJ00,2014,7479,165,70,9.4,97,13,-27,325,43.5,21,304,326,43.7,7,3,319,-1,-27,-3.6,7452
16473,T001038,Total male and female,GM0009,Ten Boer,2015JJ00,2015,7452,164,68,9.2,108,14.6,-40,323,43.6,23,300,381,51.5,24,-5,357,-58,-100,-13.4,7352
16474,T001038,Total male and female,GM0009,Ten Boer,2016JJ00,2016,7352,162,60,8.2,107,14.6,-47,355,48.5,10,345,372,50.8,25,-11,347,-17,-64,-8.7,7288
16475,T001038,Total male and female,GM0009,Ten Boer,2017JJ00,2017,7288,161,46,6.3,84,11.5,-38,458,62.8,10,448,417,57.2,16,-3,401,41,4,0.5,7292
16476,T001038,Total male and female,GM0009,Ten Boer,2018JJ00,2018,7292,161,60,8.2,111,15.2,-51,433,59.4,24,409,383,52.5,10,0,373,50,-3,-0.4,7289
16962,T001038,Total male and female,GM1681,Borger-Odoorn,2012JJ00,2012,25859,94,180,7,262,10.2,-82,1086,42.2,64,1022,1200,46.6,67,-1,1133,-114,-197,-7.6,25662
16963,T001038,Total male and female,GM1681,Borger-Odoorn,2013JJ00,2013,25662,93,208,8.1,232,9,-24,1158,45.2,75,1083,1168,45.5,51,-5,1117,-10,-35,-1.4,25627
16964,T001038,Total male and female,GM1681,Borger-Odoorn,2014JJ00,2014,25627,93,182,7.1,231,9,-49,1106,43.3,51,1055,1182,46.2,68,-2,1114,-76,-125,-4.9,25502
16965,T001038,Total male and female,GM1681,Borger-Odoorn,2015JJ00,2015,25502,93,182,7.2,268,10.5,-86,1221,48,68,1153,1269,49.9,51,-7,1218,-48,-131,-5.1,25371
16966,T001038,Total male and female,GM1681,Borger-Odoorn,2016JJ00,2016,25371,92,187,7.4,269,10.6,-82,1433,56.5,79,1354,1367,53.9,71,-2,1296,66,-16,-0.6,25355
16967,T001038,Total male and female,GM1681,Borger-Odoorn,2017JJ00,2017,25355,92,171,6.7,291,11.5,-120,1541,60.8,52,1489,1426,56.2,49,3,1377,115,-4,-0.2,25351
16968,T001038,Total male and female,GM1681,Borger-Odoorn,2018JJ00,2018,25351,92,197,7.8,255,10.1,-58,1494,58.9,67,1427,1415,55.8,57,5,1358,79,21,0.8,25372
16969,T001038,Total male and female,GM1681,Borger-Odoorn,2019JJ00,2019,25372,92,209,8.2,262,10.3,-53,1660,65.2,85,1575,1421,55.8,61,-3,1360,239,187,7.4,25559
16970,T001038,Total male and female,GM1681,Borger-Odoorn,2020JJ00,2020,25559,93,178,7,278,10.9,-100,1638,64,69,1569,1498,58.6,66,-1,1432,140,39,1.5,25598
16971,T001038,Total male and female,GM1681,Borger-Odoorn,2021JJ00,2021,25598,93,212,8.3,285,11.1,-73,1452,56.6,53,1399,1298,50.6,41,-7,1257,154,83,3.2,25681
16972,T001038,Total male and female,GM1681,Borger-Odoorn,2022JJ00,2022,25681,93,180,7,323,12.5,-143,1620,62.8,228,1392,1239,48,93,-21,1146,381,238,9.3,25919
16973,T001038,Total male and female,GM1681,Borger-Odoorn,2023JJ00,2023,25919,94,202,7.8,294,11.3,-92,1542,59.4,187,1355,1356,52.2,90,-2,1266,186,95,3.7,26014
17208,T001038,Total male and female,GM0147,Borne,2012JJ00,2012,21586,830,232,10.7,174,8,58,980,45.2,68,912,856,39.5,111,-60,745,124,184,8.5,21770
17209,T001038,Total male and female,GM0147,Borne,2013JJ00,2013,21770,837,210,9.6,202,9.3,8,840,38.5,58,782,735,33.7,62,-2,673,105,114,5.2,21884
17210,T001038,Total male and female,GM0147,Borne,2014JJ00,2014,21884,842,212,9.7,175,8,37,855,39,42,813,785,35.8,67,-16,718,70,108,4.9,21992
17211,T001038,Total male and female,GM0147,Borne,2015JJ00,2015,21992,846,236,10.6,200,9,36,1505,67.9,558,947,1190,53.7,54,-3,1136,315,351,16,22343
17212,T001038,Total male and female,GM0147,Borne,2016JJ00,2016,22343,859,224,9.9,208,9.2,16,1774,78.6,364,1410,1341,59.4,73,-18,1268,433,452,20.2,22795
17213,T001038,Total male and female,GM0147,Borne,2017JJ00,2017,22795,877,249,10.8,206,9,43,1536,66.9,125,1411,1250,54.4,78,-27,1172,286,329,14.4,23124
17214,T001038,Total male and female,GM0147,Borne,2018JJ00,2018,23124,889,245,10.6,193,8.3,52,1029,44.4,71,958,994,42.9,79,-18,915,35,86,3.7,23210
17215,T001038,Total male and female,GM0147,Borne,2019JJ00,2019,23210,893,249,10.7,211,9.1,38,1182,50.8,162,1020,1123,48.3,75,-16,1048,59,102,4.4,23312
17216,T001038,Total male and female,GM0147,Borne,2020JJ00,2020,23312,897,242,10.3,244,10.4,-2,1308,55.7,66,1242,949,40.4,64,-23,885,359,356,15.3,23668
17217,T001038,Total male and female,GM0147,Borne,2021JJ00,2021,23668,910,267,11.2,237,9.9,30,1264,53,55,1209,954,40,44,-1,910,310,339,14.3,24007
17218,T001038,Total male and female,GM0147,Borne,2022JJ00,2022,24007,924,266,11,265,10.9,1,1502,61.9,435,1067,986,40.6,112,-33,874,516,517,21.5,24524
17219,T001038,Total male and female,GM0147,Borne,2023JJ00,2023,24524,944,220,8.9,209,8.5,11,1194,48.6,130,1064,1090,44.3,89,-9,1001,104,115,4.7,24639
17290,T001038,Total male and female,GM0654,Borsele,2012JJ00,2012,22676,160,239,10.5,158,7,81,814,35.9,83,731,878,38.7,77,-30,801,-64,7,0.3,22683
17291,T001038,Total male and female,GM0654,Borsele,2013JJ00,2013,22683,160,228,10.1,173,7.6,55,753,33.3,63,690,916,40.5,61,-1,855,-163,-104,-4.6,22579
17292,T001038,Total male and female,GM0654,Borsele,2014JJ00,2014,22579,159,233,10.3,163,7.2,70,878,38.9,81,797,959,42.5,82,-4,877,-81,-11,-0.5,22568
17293,T001038,Total male and female,GM0654,Borsele,2015JJ00,2015,22568,159,242,10.7,168,7.4,74,884,39.1,84,800,915,40.5,76,-4,839,-31,44,1.9,22612
17294,T001038,Total male and female,GM0654,Borsele,2016JJ00,2016,22612,160,232,10.2,159,7,73,970,42.8,70,900,966,42.6,76,-12,890,4,76,3.4,22688
17295,T001038,Total male and female,GM0654,Borsele,2017JJ00,2017,22688,160,222,9.8,182,8,40,1091,48.1,85,1006,1104,48.6,75,1,1029,-13,28,1.2,22716
17296,T001038,Total male and female,GM0654,Borsele,2018JJ00,2018,22716,160,227,10,182,8,45,1133,49.8,128,1005,1092,48,87,-16,1005,41,84,3.7,22800
17297,T001038,Total male and female,GM0654,Borsele,2019JJ00,2019,22800,161,232,10.2,177,7.8,55,969,42.6,97,872,1084,47.6,84,-8,1000,-115,-61,-2.7,22739
17298,T001038,Total male and female,GM0654,Borsele,2020JJ00,2020,22739,161,230,10.1,182,8,48,1004,44.1,95,909,974,42.8,60,6,914,30,79,3.5,22818
17299,T001038,Total male and female,GM0654,Borsele,2021JJ00,2021,22818,161,222,9.7,225,9.9,-3,998,43.7,87,911,966,42.3,71,-8,895,32,29,1.3,22847
17300,T001038,Total male and female,GM0654,Borsele,2022JJ00,2022,22847,161,232,10.1,204,8.9,28,1268,55.1,231,1037,983,42.7,111,-16,872,285,312,13.7,23159
17301,T001038,Total male and female,GM0654,Borsele,2023JJ00,2023,23159,164,228,9.9,214,9.2,14,1070,46.2,165,905,1122,48.5,116,-8,1006,-52,-38,-1.6,23121
17454,T001038,Total male and female,GM0499,Boskoop,2012JJ00,2012,15087,1014,147,9.7,117,7.7,30,589,38.9,95,494,511,33.7,68,1,443,78,108,7.2,15195
17455,T001038,Total male and female,GM0499,Boskoop,2013JJ00,2013,15195,1023,146,9.6,124,8.2,22,517,34,100,417,554,36.5,72,3,482,-37,-18,-1.2,15177
17618,T001038,Total male and female,GM0756,Boxmeer,2012JJ00,2012,28397,255,187,6.6,233,8.2,-46,995,35.1,121,874,1115,39.4,104,-9,1011,-120,-170,-6,28227
17619,T001038,Total male and female,GM0756,Boxmeer,2013JJ00,2013,28227,253,202,7.2,211,7.5,-9,956,33.9,109,847,1028,36.5,148,-6,880,-72,-80,-2.8,28147
17620,T001038,Total male and female,GM0756,Boxmeer,2014JJ00,2014,28147,252,198,7,236,8.4,-38,1348,47.7,466,882,1114,39.4,107,-2,1007,234,195,6.9,28342
17621,T001038,Total male and female,GM0756,Boxmeer,2015JJ00,2015,28342,254,219,7.7,247,8.7,-28,2073,73,1063,1010,1921,67.6,100,10,1821,152,123,4.3,28465
17622,T001038,Total male and female,GM0756,Boxmeer,2016JJ00,2016,28465,255,235,8.2,254,8.9,-19,2110,73.8,697,1413,1848,64.6,109,-2,1739,262,244,8.6,28709
17623,T001038,Total male and female,GM0756,Boxmeer,2017JJ00,2017,28709,258,228,7.9,284,9.9,-56,1732,60.2,234,1498,1525,53,156,-64,1369,207,144,5,28853
17624,T001038,Total male and female,GM0756,Boxmeer,2018JJ00,2018,28853,259,243,8.4,264,9.1,-21,1713,59.2,301,1412,1481,51.1,175,-51,1306,232,212,7.3,29065
17625,T001038,Total male and female,GM0756,Boxmeer,2019JJ00,2019,29065,261,239,8.2,265,9.1,-26,1664,57,331,1333,1334,45.7,196,-88,1138,330,300,10.3,29365
17626,T001038,Total male and female,GM0756,Boxmeer,2020JJ00,2020,29365,264,248,8.4,321,10.9,-73,1771,60.1,187,1584,1451,49.2,129,-16,1322,320,244,8.3,29609
17627,T001038,Total male and female,GM0756,Boxmeer,2021JJ00,2021,29609,266,293,9.9,298,10,-5,1721,58,161,1560,1624,54.7,118,-17,1506,97,112,3.8,29721
17700,T001038,Total male and female,GM0757,Boxtel,2012JJ00,2012,30284,475,270,8.9,260,8.6,10,1124,37,182,942,983,32.4,102,-16,881,141,152,5,30436
17701,T001038,Total male and female,GM0757,Boxtel,2013JJ00,2013,30436,478,241,7.9,259,8.5,-18,1085,35.7,168,917,1183,38.9,161,-14,1022,-98,-116,-3.8,30320
17702,T001038,Total male and female,GM0757,Boxtel,2014JJ00,2014,30320,476,275,9.1,271,8.9,4,1201,39.6,179,1022,1193,39.3,134,-37,1059,8,17,0.6,30337
17703,T001038,Total male and female,GM0757,Boxtel,2015JJ00,2015,30337,476,245,8.1,317,10.4,-72,1305,43,211,1094,1164,38.3,146,-17,1018,141,69,2.3,30406
17704,T001038,Total male and female,GM0757,Boxtel,2016JJ00,2016,30406,477,291,9.5,311,10.2,-20,1495,49,226,1269,1218,39.9,158,-25,1060,277,249,8.2,30655
17705,T001038,Total male and female,GM0757,Boxtel,2017JJ00,2017,30655,481,254,8.3,287,9.4,-33,1395,45.5,224,1171,1344,43.8,169,-31,1175,51,17,0.6,30672
17706,T001038,Total male and female,GM0757,Boxtel,2018JJ00,2018,30672,481,282,9.2,329,10.7,-47,1401,45.6,330,1071,1276,41.6,140,-59,1136,125,75,2.4,30747
17707,T001038,Total male and female,GM0757,Boxtel,2019JJ00,2019,30747,482,248,8.1,306,9.9,-58,1328,43.2,379,949,1215,39.5,171,-51,1044,113,54,1.8,30801
17708,T001038,Total male and female,GM0757,Boxtel,2020JJ00,2020,30801,483,264,8.6,373,12.1,-109,1457,47.3,349,1108,1324,43,164,-60,1160,133,23,0.7,30824
17709,T001038,Total male and female,GM0757,Boxtel,2021JJ00,2021,32973,477,301,9.1,379,11.5,-78,1649,49.9,333,1316,1411,42.7,238,-94,1173,238,156,4.7,33129
17710,T001038,Total male and female,GM0757,Boxtel,2022JJ00,2022,33129,480,281,8.4,392,11.7,-111,2115,63.3,571,1544,1391,41.6,301,-100,1090,724,619,18.7,33748
17711,T001038,Total male and female,GM0757,Boxtel,2023JJ00,2023,33748,489,260,7.7,407,12,-147,1872,55.3,354,1518,1498,44.2,274,-113,1224,374,231,6.8,33979
17946,T001038,Total male and female,GM0758,Breda,2012JJ00,2012,176401,1400,1892,10.7,1497,8.4,395,9500,53.6,2013,7487,8207,46.3,1662,-300,6545,1293,1739,9.9,178140
17947,T001038,Total male and female,GM0758,Breda,2013JJ00,2013,178140,1413,1883,10.5,1606,9,277,9614,53.7,1925,7689,8413,47,1571,-118,6842,1201,1483,8.3,179623
17948,T001038,Total male and female,GM0758,Breda,2014JJ00,2014,179623,1425,1918,10.6,1564,8.7,354,10112,56.1,2008,8104,9153,50.8,1806,-325,7347,959,1314,7.3,180937
17949,T001038,Total male and female,GM0758,Breda,2015JJ00,2015,180937,1435,1930,10.6,1656,9.1,274,10627,58.6,2509,8118,10219,56.4,1727,-239,8492,408,674,3.7,181611
17950,T001038,Total male and female,GM0758,Breda,2016JJ00,2016,181611,1442,1842,10.1,1637,9,205,11016,60.5,2354,8662,10526,57.8,1783,-302,8743,490,693,3.8,182304
17951,T001038,Total male and female,GM0758,Breda,2017JJ00,2017,182304,1447,1847,10.1,1658,9.1,189,11280,61.7,2339,8941,10305,56.3,1772,-243,8533,975,1144,6.3,183448
17952,T001038,Total male and female,GM0758,Breda,2018JJ00,2018,183448,1459,1801,9.8,1672,9.1,129,10354,56.4,2570,7784,10045,54.7,1854,-217,8191,309,425,2.3,183873
17953,T001038,Total male and female,GM0758,Breda,2019JJ00,2019,183873,1462,1732,9.4,1691,9.2,41,10214,55.5,2563,7651,10039,54.6,1993,-386,8046,175,196,1.1,184069
17954,T001038,Total male and female,GM0758,Breda,2020JJ00,2020,184069,1464,1670,9.1,1835,10,-165,9911,53.8,2168,7743,9684,52.6,1690,-267,7994,227,57,0.3,184126
17955,T001038,Total male and female,GM0758,Breda,2021JJ00,2021,184126,1464,1882,10.2,1799,9.8,83,9857,53.5,2289,7568,9366,50.8,1491,-73,7875,491,576,3.1,184702
17956,T001038,Total male and female,GM0758,Breda,2022JJ00,2022,184702,1470,1743,9.4,1760,9.5,-17,11296,60.9,3488,7808,9534,51.4,1967,-255,7567,1762,1736,9.4,186438
17957,T001038,Total male and female,GM0758,Breda,2023JJ00,2023,186438,1483,1660,8.9,1827,9.8,-167,11985,64,3295,8690,10175,54.3,2212,-309,7963,1810,1640,8.8,188078
18438,T001038,Total male and female,GM0501,Brielle,2012JJ00,2012,16072,583,138,8.5,151,9.3,-13,920,56.8,130,790,659,40.7,118,-19,541,261,248,15.4,16320
18439,T001038,Total male and female,GM0501,Brielle,2013JJ00,2013,16320,591,120,7.4,139,8.5,-19,668,40.9,115,553,657,40.3,94,0,563,11,-8,-0.5,16312
18440,T001038,Total male and female,GM0501,Brielle,2014JJ00,2014,16312,591,133,8.1,153,9.3,-20,856,52.2,127,729,680,41.5,91,6,589,176,155,9.5,16467
18441,T001038,Total male and female,GM0501,Brielle,2015JJ00,2015,16467,597,133,8,155,9.4,-22,885,53.5,117,768,694,41.9,105,-7,589,191,173,10.5,16640
18442,T001038,Total male and female,GM0501,Brielle,2016JJ00,2016,16640,604,141,8.4,181,10.8,-40,1037,62,149,888,805,48.1,126,-20,679,232,193,11.6,16833
18443,T001038,Total male and female,GM0501,Brielle,2017JJ00,2017,16833,611,123,7.3,159,9.4,-36,1049,61.9,112,937,806,47.6,80,-6,726,243,207,12.3,17040
18444,T001038,Total male and female,GM0501,Brielle,2018JJ00,2018,17040,619,132,7.7,144,8.4,-12,1005,58.7,110,895,853,49.9,99,-16,754,152,142,8.3,17182
18445,T001038,Total male and female,GM0501,Brielle,2019JJ00,2019,17182,624,146,8.5,159,9.2,-13,938,54.5,136,802,833,48.4,71,1,762,105,89,5.2,17271
18446,T001038,Total male and female,GM0501,Brielle,2020JJ00,2020,17271,627,176,10.1,158,9.1,18,1049,60.4,128,921,898,51.7,72,-11,826,151,168,9.7,17439
18447,T001038,Total male and female,GM0501,Brielle,2021JJ00,2021,17439,633,157,8.9,181,10.3,-24,1157,65.8,140,1017,868,49.4,67,-15,801,289,265,15.2,17704
18448,T001038,Total male and female,GM0501,Brielle,2022JJ00,2022,17704,643,155,8.7,197,11,-42,1094,61.2,238,856,816,45.7,120,-35,696,278,320,18.1,18024
18766,T001038,Total male and female,GM1876,Bronckhorst,2012JJ00,2012,37441,132,263,7,361,9.7,-98,1121,30,68,1053,1247,33.4,52,-1,1195,-126,-225,-6,37216
18767,T001038,Total male and female,GM1876,Bronckhorst,2013JJ00,2013,37216,131,249,6.7,351,9.5,-102,1089,29.4,65,1024,1273,34.3,76,3,1197,-184,-284,-7.6,36932
18768,T001038,Total male and female,GM1876,Bronckhorst,2014JJ00,2014,36932,130,243,6.6,357,9.7,-114,1169,31.7,77,1092,1262,34.3,56,3,1206,-93,-206,-5.6,36726
18769,T001038,Total male and female,GM1876,Bronckhorst,2015JJ00,2015,36726,130,230,6.3,336,9.2,-106,1283,35,105,1178,1393,38,60,6,1333,-110,-216,-5.9,36510
18770,T001038,Total male and female,GM1876,Bronckhorst,2016JJ00,2016,36510,129,226,6.2,364,10,-138,1506,41.3,97,1409,1467,40.2,97,-4,1370,39,-100,-2.7,36410
18771,T001038,Total male and female,GM1876,Bronckhorst,2017JJ00,2017,36410,128,224,6.2,344,9.5,-120,1611,44.3,103,1508,1546,42.5,67,-6,1479,65,-58,-1.6,36352
18772,T001038,Total male and female,GM1876,Bronckhorst,2018JJ00,2018,36352,128,249,6.9,371,10.2,-122,1444,39.8,96,1348,1463,40.3,75,-4,1388,-19,-140,-3.9,36212
18773,T001038,Total male and female,GM1876,Bronckhorst,2019JJ00,2019,36212,128,246,6.8,351,9.7,-105,1368,37.9,75,1293,1420,39.3,73,-3,1347,-52,-157,-4.3,36055
18774,T001038,Total male and female,GM1876,Bronckhorst,2020JJ00,2020,36055,127,254,7,425,11.8,-171,1645,45.6,107,1538,1444,40,88,-15,1356,201,32,0.9,36087
18775,T001038,Total male and female,GM1876,Bronckhorst,2021JJ00,2021,36087,127,242,6.7,438,12.1,-196,1500,41.6,87,1413,1313,36.4,78,-6,1235,187,-10,-0.3,36077
18776,T001038,Total male and female,GM1876,Bronckhorst,2022JJ00,2022,36077,127,229,6.3,410,11.3,-181,1750,48.4,352,1398,1368,37.8,133,-5,1235,382,200,5.5,36277
18777,T001038,Total male and female,GM1876,Bronckhorst,2023JJ00,2023,36277,128,230,6.4,406,11.2,-176,1419,39.2,221,1198,1401,38.7,126,-5,1275,18,-158,-4.4,36119
19012,T001038,Total male and female,GM0213,Brummen,2012JJ00,2012,21327,254,165,7.8,194,9.1,-29,755,35.5,35,720,808,38,43,4,765,-53,-82,-3.8,21245
19013,T001038,Total male and female,GM0213,Brummen,2013JJ00,2013,21245,253,164,7.7,198,9.3,-34,816,38.5,58,758,850,40.1,52,2,798,-34,-68,-3.2,21177
19014,T001038,Total male and female,GM0213,Brummen,2014JJ00,2014,21177,252,154,7.3,192,9.1,-38,735,34.9,69,666,891,42.3,64,-5,827,-156,-194,-9.2,20983
19015,T001038,Total male and female,GM0213,Brummen,2015JJ00,2015,20983,250,149,7.1,206,9.8,-57,829,39.6,60,769,815,38.9,47,8,768,14,-45,-2.1,20938
19016,T001038,Total male and female,GM0213,Brummen,2016JJ00,2016,20938,249,153,7.3,214,10.2,-61,946,45.3,80,866,980,46.9,39,-6,941,-34,-95,-4.5,20843
19017,T001038,Total male and female,GM0213,Brummen,2017JJ00,2017,20843,248,170,8.2,205,9.9,-35,980,47.1,75,905,1018,48.9,71,-10,947,-38,-72,-3.5,20771
19018,T001038,Total male and female,GM0213,Brummen,2018JJ00,2018,20771,248,142,6.8,221,10.7,-79,975,47,57,918,970,46.8,40,-9,930,5,-73,-3.5,20698
19019,T001038,Total male and female,GM0213,Brummen,2019JJ00,2019,20698,247,161,7.8,222,10.7,-61,1000,48.3,56,944,911,44,54,-15,857,89,28,1.4,20726
19020,T001038,Total male and female,GM0213,Brummen,2020JJ00,2020,20726,248,167,8,225,10.8,-58,1115,53.6,66,1049,899,43.2,47,-7,852,216,158,7.6,20884
19021,T001038,Total male and female,GM0213,Brummen,2021JJ00,2021,20884,250,145,6.9,237,11.3,-92,1034,49.5,52,982,937,44.9,52,-2,885,97,6,0.3,20890
19022,T001038,Total male and female,GM0213,Brummen,2022JJ00,2022,20890,250,162,7.7,279,13.3,-117,1070,51,156,914,737,35.1,54,-4,683,333,215,10.3,21105
19023,T001038,Total male and female,GM0213,Brummen,2023JJ00,2023,21105,252,163,7.7,259,12.2,-96,1141,53.8,86,1055,865,40.8,85,-3,780,276,181,8.6,21286
19094,T001038,Total male and female,GM0899,Brunssum,2012JJ00,2012,29199,1697,233,8,331,11.4,-98,1272,43.7,141,1131,1290,44.3,82,22,1208,-18,-118,-4,29081
19095,T001038,Total male and female,GM0899,Brunssum,2013JJ00,2013,29081,1690,213,7.3,368,12.7,-155,1281,44.1,148,1133,1250,43.1,125,14,1125,31,-123,-4.2,28958
19096,T001038,Total male and female,GM0899,Brunssum,2014JJ00,2014,28958,1683,225,7.8,373,12.9,-148,1202,41.7,130,1072,1358,47.1,159,-31,1199,-156,-302,-10.4,28656
19097,T001038,Total male and female,GM0899,Brunssum,2015JJ00,2015,28656,1665,207,7.2,385,13.5,-178,1367,47.9,132,1235,1398,49,130,-9,1268,-31,-208,-7.3,28448
19098,T001038,Total male and female,GM0899,Brunssum,2016JJ00,2016,28448,1653,192,6.8,375,13.2,-183,1351,47.6,114,1237,1258,44.3,101,-2,1157,93,-90,-3.2,28358
19099,T001038,Total male and female,GM0899,Brunssum,2017JJ00,2017,28358,1648,237,8.4,391,13.8,-154,1460,51.6,135,1325,1421,50.2,114,-2,1307,39,-117,-4.1,28241
19100,T001038,Total male and female,GM0899,Brunssum,2018JJ00,2018,28241,1637,214,7.6,397,14.1,-183,1480,52.5,164,1316,1434,50.9,136,-2,1298,46,-138,-4.9,28103
19101,T001038,Total male and female,GM0899,Brunssum,2019JJ00,2019,28103,1629,203,7.3,331,11.8,-128,1421,50.8,176,1245,1574,56.3,142,-26,1432,-153,-282,-10,27821
19102,T001038,Total male and female,GM0899,Brunssum,2020JJ00,2020,27821,1613,192,6.9,392,14.1,-200,1509,54.4,151,1358,1457,52.5,130,-17,1327,52,-151,-5.4,27670
19103,T001038,Total male and female,GM0899,Brunssum,2021JJ00,2021,27670,1604,204,7.4,412,14.9,-208,1621,58.6,143,1478,1407,50.8,112,-1,1295,214,4,0.1,27674
19104,T001038,Total male and female,GM0899,Brunssum,2022JJ00,2022,27674,1605,210,7.6,397,14.3,-187,1673,60.4,278,1395,1481,53.5,175,-42,1306,192,8,0.3,27682
19105,T001038,Total male and female,GM0899,Brunssum,2023JJ00,2023,27682,1606,214,7.7,396,14.3,-182,1545,55.7,237,1308,1271,45.8,185,-19,1086,274,88,3.2,27770
19422,T001038,Total male and female,GM0312,Bunnik,2012JJ00,2012,14451,391,115,7.9,107,7.4,8,778,53.6,45,733,675,46.5,55,-10,620,103,112,7.8,14563
19423,T001038,Total male and female,GM0312,Bunnik,2013JJ00,2013,14563,394,129,8.8,87,6,42,719,49.3,51,668,701,48,71,-2,630,18,63,4.3,14626
19424,T001038,Total male and female,GM0312,Bunnik,2014JJ00,2014,14626,396,116,7.9,111,7.6,5,872,59.5,74,798,842,57.5,64,-3,778,30,36,2.5,14662
19425,T001038,Total male and female,GM0312,Bunnik,2015JJ00,2015,14662,396,141,9.6,103,7,38,866,58.8,79,787,795,54,42,-3,753,71,111,7.6,14773
19426,T001038,Total male and female,GM0312,Bunnik,2016JJ00,2016,14773,400,147,9.8,105,7,42,1073,71.7,62,1011,732,48.9,51,-1,681,341,383,25.9,15156
19427,T001038,Total male and female,GM0312,Bunnik,2017JJ00,2017,15156,410,135,8.9,114,7.5,21,850,56,61,789,812,53.5,60,-7,752,38,58,3.8,15214
19428,T001038,Total male and female,GM0312,Bunnik,2018JJ00,2018,15214,412,131,8.6,113,7.4,18,830,54.6,68,762,872,57.4,56,-13,816,-42,-22,-1.4,15192
19429,T001038,Total male and female,GM0312,Bunnik,2019JJ00,2019,15192,411,139,9.1,98,6.5,41,774,50.9,87,687,816,53.7,45,-5,771,-42,-1,-0.1,15191
19430,T001038,Total male and female,GM0312,Bunnik,2020JJ00,2020,15191,411,132,8.6,130,8.5,2,993,65,60,933,845,55.4,67,-12,778,148,150,9.9,15341
19431,T001038,Total male and female,GM0312,Bunnik,2021JJ00,2021,15341,415,147,9.5,140,9.1,7,1026,66.3,79,947,784,50.7,44,-6,740,242,249,16.2,15590
19432,T001038,Total male and female,GM0312,Bunnik,2022JJ00,2022,15590,422,135,8.5,115,7.3,20,1173,74.2,208,965,756,47.8,53,5,703,417,436,28,16026
19433,T001038,Total male and female,GM0312,Bunnik,2023JJ00,2023,16026,434,140,8.7,145,9,-5,930,57.9,107,823,845,52.6,87,-15,758,85,82,5.1,16108
19504,T001038,Total male and female,GM0313,Bunschoten,2012JJ00,2012,20200,664,294,14.5,121,6,173,362,17.9,79,283,418,20.6,76,-19,342,-56,116,5.7,20316
19505,T001038,Total male and female,GM0313,Bunschoten,2013JJ00,2013,20316,667,240,11.8,140,6.9,100,445,21.8,197,248,370,18.1,48,-5,322,75,176,8.7,20492
19506,T001038,Total male and female,GM0313,Bunschoten,2014JJ00,2014,20492,673,267,13,130,6.3,137,533,25.9,208,325,516,25.1,144,-19,372,17,155,7.6,20647
19507,T001038,Total male and female,GM0313,Bunschoten,2015JJ00,2015,20647,678,270,13,124,6,146,547,26.4,146,401,517,24.9,153,-23,364,30,176,8.5,20823
19508,T001038,Total male and female,GM0313,Bunschoten,2016JJ00,2016,20823,684,238,11.4,131,6.3,107,684,32.7,266,418,594,28.4,139,-17,455,90,197,9.5,21020
19509,T001038,Total male and female,GM0313,Bunschoten,2017JJ00,2017,21020,691,286,13.5,131,6.2,155,618,29.2,165,453,527,24.9,102,-21,425,91,246,11.7,21266
19510,T001038,Total male and female,GM0313,Bunschoten,2018JJ00,2018,21266,700,268,12.5,129,6,139,763,35.6,234,529,590,27.5,180,-30,410,173,310,14.6,21576
19511,T001038,Total male and female,GM0313,Bunschoten,2019JJ00,2019,21576,710,295,13.6,136,6.3,159,743,34.2,246,497,609,28,115,-9,494,134,290,13.4,21866
19512,T001038,Total male and female,GM0313,Bunschoten,2020JJ00,2020,21866,720,271,12.4,197,9,74,650,29.6,183,467,569,25.9,131,-41,438,81,153,7,22019
19513,T001038,Total male and female,GM0313,Bunschoten,2021JJ00,2021,22019,725,286,12.9,156,7,130,753,34,164,589,577,26,96,-19,481,176,306,13.9,22325
19514,T001038,Total male and female,GM0313,Bunschoten,2022JJ00,2022,22325,735,261,11.6,187,8.3,74,772,34.4,294,478,672,30,196,-20,476,100,175,7.8,22500
19515,T001038,Total male and female,GM0313,Bunschoten,2023JJ00,2023,22500,740,235,10.4,164,7.3,71,709,31.4,188,521,660,29.3,157,-33,503,49,119,5.3,22619
19586,T001038,Total male and female,GM0214,Buren,2012JJ00,2012,25949,193,238,9.2,209,8.1,29,1002,38.6,97,905,1041,40.1,61,-16,980,-39,-10,-0.4,25939
19587,T001038,Total male and female,GM0214,Buren,2013JJ00,2013,25939,193,233,9,207,8,26,1096,42.2,106,990,1043,40.1,79,6,964,53,80,3.1,26019
19588,T001038,Total male and female,GM0214,Buren,2014JJ00,2014,26019,194,232,8.9,190,7.3,42,1188,45.6,121,1067,1129,43.3,96,-16,1033,59,98,3.8,26117
19589,T001038,Total male and female,GM0214,Buren,2015JJ00,2015,26117,195,221,8.4,225,8.6,-4,1241,47.4,118,1123,1154,44.1,75,-6,1079,87,85,3.3,26202
19590,T001038,Total male and female,GM0214,Buren,2016JJ00,2016,26202,195,247,9.4,195,7.4,52,1450,55.2,109,1341,1356,51.6,79,-6,1277,94,146,5.6,26348
19591,T001038,Total male and female,GM0214,Buren,2017JJ00,2017,26348,197,204,7.7,196,7.4,8,1502,57,109,1393,1492,56.6,81,-7,1411,10,17,0.6,26365
19592,T001038,Total male and female,GM0214,Buren,2018JJ00,2018,26365,197,235,8.9,186,7,49,1452,54.9,109,1343,1298,49,66,-3,1232,154,203,7.7,26568
19593,T001038,Total male and female,GM0214,Buren,2019JJ00,2019,26568,198,221,8.3,213,8,8,1539,57.7,132,1407,1365,51.2,103,-19,1262,174,181,6.8,26749
19594,T001038,Total male and female,GM0214,Buren,2020JJ00,2020,26749,200,253,9.4,251,9.3,2,1687,62.8,146,1541,1430,53.2,91,-14,1339,257,260,9.7,27009
19595,T001038,Total male and female,GM0214,Buren,2021JJ00,2021,27009,202,265,9.8,278,10.3,-13,1508,55.7,133,1375,1349,49.8,103,-26,1246,159,146,5.4,27155
19596,T001038,Total male and female,GM0214,Buren,2022JJ00,2022,27155,203,235,8.6,240,8.7,-5,2008,73.2,477,1531,1433,52.2,172,-39,1261,575,570,21,27725
19597,T001038,Total male and female,GM0214,Buren,2023JJ00,2023,27725,208,261,9.4,229,8.3,32,1585,57.1,368,1217,1568,56.5,257,-87,1311,17,48,1.7,27773
19750,T001038,Total male and female,GM0381,Bussum,2012JJ00,2012,32585,4028,296,9.1,334,10.2,-38,2003,61.4,270,1733,1917,58.8,196,-26,1721,86,46,1.4,32631
19751,T001038,Total male and female,GM0381,Bussum,2013JJ00,2013,32631,4038,302,9.3,347,10.6,-45,2091,64.1,273,1818,2048,62.8,273,-42,1775,43,0,0,32631
19752,T001038,Total male and female,GM0381,Bussum,2014JJ00,2014,32631,4038,315,9.6,347,10.6,-32,2553,78,282,2271,2280,69.6,303,-33,1977,273,239,7.3,32870
19753,T001038,Total male and female,GM0381,Bussum,2015JJ00,2015,32870,4068,300,9.1,364,11,-64,2661,80.7,300,2361,2381,72.2,277,-40,2104,280,227,6.9,33097
20160,T001038,Total male and female,GM0502,Capelle aan den IJssel,2012JJ00,2012,66122,4640,726,11,587,8.9,139,3597,54.4,499,3098,3842,58.1,547,-89,3295,-245,-98,-1.5,66024
20161,T001038,Total male and female,GM0502,Capelle aan den IJssel,2013JJ00,2013,66024,4643,695,10.5,596,9,99,3815,57.7,472,3343,3756,56.8,660,-159,3096,59,154,2.3,66178
20162,T001038,Total male and female,GM0502,Capelle aan den IJssel,2014JJ00,2014,66178,4654,764,11.5,525,7.9,239,3902,58.8,527,3375,3843,57.9,567,-121,3276,59,300,4.5,66478
20163,T001038,Total male and female,GM0502,Capelle aan den IJssel,2015JJ00,2015,66478,4675,701,10.5,618,9.3,83,4108,61.8,557,3551,4184,62.9,667,-192,3517,-76,8,0.1,66486
20164,T001038,Total male and female,GM0502,Capelle aan den IJssel,2016JJ00,2016,66486,4676,712,10.7,577,8.7,135,4199,63.2,540,3659,4398,66.2,751,-246,3647,-199,-65,-1,66421
20165,T001038,Total male and female,GM0502,Capelle aan den IJssel,2017JJ00,2017,66421,4671,691,10.4,610,9.2,81,4559,68.4,537,4022,4210,63.2,529,-76,3681,349,433,6.5,66854
20166,T001038,Total male and female,GM0502,Capelle aan den IJssel,2018JJ00,2018,66854,4728,657,9.8,617,9.2,40,4293,64.2,612,3681,4365,65.3,537,-130,3828,-72,-36,-0.5,66818
20167,T001038,Total male and female,GM0502,Capelle aan den IJssel,2019JJ00,2019,66818,4725,652,9.7,609,9.1,43,4407,65.8,713,3694,4140,61.8,491,-99,3649,267,304,4.5,67122
20168,T001038,Total male and female,GM0502,Capelle aan den IJssel,2020JJ00,2020,67122,4747,658,9.8,715,10.6,-57,4549,67.7,553,3996,4290,63.8,421,-21,3869,259,197,2.9,67319
20169,T001038,Total male and female,GM0502,Capelle aan den IJssel,2021JJ00,2021,67319,4761,702,10.4,689,10.2,13,4413,65.6,673,3740,4557,67.8,486,-81,4071,-144,-131,-1.9,67188
20170,T001038,Total male and female,GM0502,Capelle aan den IJssel,2022JJ00,2022,67188,4752,645,9.6,673,10,-28,4946,73.4,1122,3824,4549,67.5,559,-84,3990,397,364,5.4,67552
20171,T001038,Total male and female,GM0502,Capelle aan den IJssel,2023JJ00,2023,67552,4777,653,9.6,723,10.7,-70,5065,74.8,1085,3980,4618,68.2,556,-45,4062,447,373,5.5,67925
20242,T001038,Total male and female,GM0383,Castricum,2012JJ00,2012,34474,694,228,6.6,300,8.7,-72,1118,32.5,126,992,1116,32.4,128,-35,988,2,-72,-2.1,34402
20243,T001038,Total male and female,GM0383,Castricum,2013JJ00,2013,34402,695,259,7.5,315,9.2,-56,1066,31,96,970,1122,32.7,84,0,1038,-56,-114,-3.3,34288
20244,T001038,Total male and female,GM0383,Castricum,2014JJ00,2014,34288,693,251,7.3,325,9.5,-74,1349,39.3,115,1234,1201,35,78,3,1123,148,73,2.1,34361
20245,T001038,Total male and female,GM0383,Castricum,2015JJ00,2015,34361,694,256,7.4,348,10.1,-92,1506,43.7,100,1406,1174,34,87,0,1087,332,243,7.1,34604
20246,T001038,Total male and female,GM0383,Castricum,2016JJ00,2016,34604,699,275,7.9,342,9.8,-67,1994,57.1,138,1856,1315,37.7,123,2,1192,679,612,17.7,35216
20247,T001038,Total male and female,GM0383,Castricum,2017JJ00,2017,35216,711,285,8,377,10.6,-92,1883,53.2,122,1761,1397,39.4,121,-5,1276,486,392,11.1,35608
20248,T001038,Total male and female,GM0383,Castricum,2018JJ00,2018,35608,717,266,7.5,352,9.9,-86,1464,41,153,1311,1213,34,131,-17,1082,251,164,4.6,35772
20249,T001038,Total male and female,GM0383,Castricum,2019JJ00,2019,35772,720,298,8.3,339,9.4,-41,1535,42.8,135,1400,1280,35.7,100,-2,1180,255,214,6,35986
20250,T001038,Total male and female,GM0383,Castricum,2020JJ00,2020,35986,724,307,8.5,384,10.7,-77,1726,47.9,141,1585,1553,43.1,95,-3,1458,173,100,2.8,36086
20251,T001038,Total male and female,GM0383,Castricum,2021JJ00,2021,36086,726,321,8.9,360,10,-39,1640,45.3,113,1527,1423,39.3,112,-2,1311,217,177,4.9,36263
20252,T001038,Total male and female,GM0383,Castricum,2022JJ00,2022,36263,731,276,7.6,409,11.3,-133,1647,45.4,245,1402,1431,39.4,154,-11,1277,216,82,2.3,36345
20253,T001038,Total male and female,GM0383,Castricum,2023JJ00,2023,36345,732,293,8.1,411,11.3,-118,1592,43.8,151,1441,1452,39.9,162,-12,1290,140,21,0.6,36366
20488,T001038,Total male and female,GM0109,Coevorden,2012JJ00,2012,35881,121,312,8.7,369,10.3,-57,1661,46.4,371,1290,1723,48.1,172,-69,1551,-62,-116,-3.2,35765
20489,T001038,Total male and female,GM0109,Coevorden,2013JJ00,2013,35765,121,296,8.3,360,10.1,-64,1771,49.5,430,1341,1706,47.7,200,-106,1506,65,4,0.1,35769
20490,T001038,Total male and female,GM0109,Coevorden,2014JJ00,2014,35769,121,289,8.1,396,11.1,-107,1682,47.2,496,1186,1820,51,150,-45,1670,-138,-234,-6.5,35535
20491,T001038,Total male and female,GM0109,Coevorden,2015JJ00,2015,35535,120,283,8,401,11.3,-118,1905,53.7,468,1437,1949,55,159,-41,1790,-44,-154,-4.3,35381
20492,T001038,Total male and female,GM0109,Coevorden,2016JJ00,2016,35381,120,306,8.7,427,12.1,-121,1821,51.5,386,1435,1801,51,125,-21,1676,20,-95,-2.7,35286
20493,T001038,Total male and female,GM0109,Coevorden,2017JJ00,2017,35286,119,280,7.9,373,10.6,-93,2114,59.9,206,1908,2012,57,114,-5,1898,102,13,0.4,35299
20494,T001038,Total male and female,GM0109,Coevorden,2018JJ00,2018,35299,119,277,7.8,415,11.7,-138,2108,59.6,214,1894,1788,50.5,106,3,1682,320,184,5.2,35483
20495,T001038,Total male and female,GM0109,Coevorden,2019JJ00,2019,35483,120,296,8.4,408,11.5,-112,1944,54.9,140,1804,2017,57,258,-119,1759,-73,-186,-5.2,35297
20496,T001038,Total male and female,GM0109,Coevorden,2020JJ00,2020,35297,119,284,8,448,12.7,-164,1933,54.7,132,1801,1749,49.5,121,-26,1628,184,20,0.6,35317
20497,T001038,Total male and female,GM0109,Coevorden,2021JJ00,2021,35317,119,291,8.2,460,13,-169,2045,57.7,97,1948,1678,47.4,100,-35,1578,367,200,5.7,35517
20498,T001038,Total male and female,GM0109,Coevorden,2022JJ00,2022,35517,120,262,7.4,434,12.2,-172,2000,56.2,376,1624,1645,46.2,154,-6,1491,355,183,5.2,35700
20499,T001038,Total male and female,GM0109,Coevorden,2023JJ00,2023,35700,121,247,6.9,425,11.9,-178,2043,57.2,207,1836,1841,51.6,199,-18,1642,202,25,0.7,35725
20652,T001038,Total male and female,GM1706,Cranendonck,2012JJ00,2012,20432,267,198,9.7,159,7.8,39,565,27.7,115,450,706,34.6,115,-16,591,-141,-102,-5,20330
20653,T001038,Total male and female,GM1706,Cranendonck,2013JJ00,2013,20330,266,175,8.6,186,9.1,-11,662,32.6,118,544,638,31.4,123,-8,515,24,14,0.7,20344
20654,T001038,Total male and female,GM1706,Cranendonck,2014JJ00,2014,20344,266,166,8.1,170,8.3,-4,911,44.6,334,577,711,34.8,131,-31,580,200,198,9.7,20542
20655,T001038,Total male and female,GM1706,Cranendonck,2015JJ00,2015,20542,269,178,8.6,172,8.3,6,1157,56.2,605,552,1046,50.8,78,1,968,111,118,5.7,20660
20656,T001038,Total male and female,GM1706,Cranendonck,2016JJ00,2016,20660,271,186,9,197,9.5,-11,4561,220.7,3370,1191,4542,219.8,115,-4,4427,19,16,0.8,20676
20657,T001038,Total male and female,GM1706,Cranendonck,2017JJ00,2017,20676,271,174,8.5,213,10.4,-39,3519,171.6,2846,673,3819,186.2,155,-48,3664,-300,-340,-16.4,20336
20658,T001038,Total male and female,GM1706,Cranendonck,2018JJ00,2018,20336,266,163,8,204,10,-41,1363,66.9,777,586,1215,59.6,97,8,1118,148,104,5.1,20440
20659,T001038,Total male and female,GM1706,Cranendonck,2019JJ00,2019,20440,268,152,7.3,187,9,-35,2983,143.5,2138,845,2260,108.7,108,10,2152,723,698,34.1,21138
20660,T001038,Total male and female,GM1706,Cranendonck,2020JJ00,2020,21138,277,186,8.8,249,11.8,-63,3870,183.7,3073,797,3959,187.9,107,12,3852,-89,-137,-6.5,21001
20661,T001038,Total male and female,GM1706,Cranendonck,2021JJ00,2021,21001,275,144,6.9,248,11.9,-104,4941,237.1,4260,681,5194,249.3,91,21,5103,-253,-332,-15.8,20669
20662,T001038,Total male and female,GM1706,Cranendonck,2022JJ00,2022,20669,270,170,8.2,199,9.6,-29,7439,358.3,6588,851,7254,349.4,192,-9,7062,185,182,8.8,20851
20663,T001038,Total male and female,GM1706,Cranendonck,2023JJ00,2023,20851,273,176,8.4,223,10.7,-47,10084,483.7,9125,959,10075,483.3,155,-31,9920,9,-10,-0.5,20841
20734,T001038,Total male and female,GM0611,Cromstrijen,2012JJ00,2012,12780,235,103,8.1,91,7.1,12,398,31.2,29,369,428,33.5,52,-12,376,-30,-18,-1.4,12762
20735,T001038,Total male and female,GM0611,Cromstrijen,2013JJ00,2013,12762,235,101,7.9,109,8.5,-8,434,34,22,412,449,35.2,43,-8,406,-15,-24,-1.9,12738
20736,T001038,Total male and female,GM0611,Cromstrijen,2014JJ00,2014,12738,234,106,8.3,107,8.4,-1,484,37.9,39,445,435,34.1,29,-6,406,49,46,3.6,12784
20737,T001038,Total male and female,GM0611,Cromstrijen,2015JJ00,2015,12784,235,102,8,99,7.8,3,448,35.1,39,409,482,37.7,46,-9,436,-34,-29,-2.3,12755
20738,T001038,Total male and female,GM0611,Cromstrijen,2016JJ00,2016,12755,234,109,8.5,114,8.9,-5,530,41.5,25,505,484,37.9,13,9,471,46,42,3.3,12797
20739,T001038,Total male and female,GM0611,Cromstrijen,2017JJ00,2017,12797,235,92,7.2,133,10.4,-41,571,44.6,32,539,500,39,22,-2,478,71,29,2.3,12826
20740,T001038,Total male and female,GM0611,Cromstrijen,2018JJ00,2018,12826,236,92,7.1,111,8.6,-19,614,47.7,30,584,499,38.8,27,-3,472,115,90,7,12916
20816,T001038,Total male and female,GM1684,Cuijk,2012JJ00,2012,24648,481,226,9.2,193,7.8,33,883,35.8,120,763,821,33.2,126,-19,695,62,95,3.9,24743
20817,T001038,Total male and female,GM1684,Cuijk,2013JJ00,2013,24743,483,242,9.8,192,7.8,50,768,31,100,668,780,31.5,91,7,689,-12,40,1.6,24783
20818,T001038,Total male and female,GM1684,Cuijk,2014JJ00,2014,24783,484,233,9.4,190,7.7,43,818,33.1,91,727,994,40.2,129,11,865,-176,-134,-5.4,24649
20819,T001038,Total male and female,GM1684,Cuijk,2015JJ00,2015,24649,481,218,8.9,211,8.6,7,933,37.9,112,821,982,39.9,181,-52,801,-49,-41,-1.7,24608
20820,T001038,Total male and female,GM1684,Cuijk,2016JJ00,2016,24608,481,232,9.4,238,9.7,-6,1018,41.3,140,878,925,37.5,104,-21,821,93,88,3.6,24696
20821,T001038,Total male and female,GM1684,Cuijk,2017JJ00,2017,24696,483,213,8.6,200,8.1,13,1221,49.2,136,1085,1017,41,94,-20,923,204,215,8.7,24911
20822,T001038,Total male and female,GM1684,Cuijk,2018JJ00,2018,24911,487,231,9.3,219,8.8,12,1109,44.5,122,987,1102,44.2,144,-19,958,7,20,0.8,24931
20823,T001038,Total male and female,GM1684,Cuijk,2019JJ00,2019,24931,487,202,8.1,216,8.6,-14,1205,48.1,148,1057,991,39.6,129,-23,862,214,199,8,25130
20824,T001038,Total male and female,GM1684,Cuijk,2020JJ00,2020,25130,491,218,8.6,279,11,-61,1309,51.8,160,1149,974,38.5,93,-12,881,335,274,10.9,25404
20825,T001038,Total male and female,GM1684,Cuijk,2021JJ00,2021,25404,497,242,9.5,239,9.4,3,1186,46.4,158,1028,911,35.7,103,-12,808,275,273,10.7,25677
20980,T001038,Total male and female,GM0216,Culemborg,2012JJ00,2012,27632,939,290,10.5,198,7.2,92,990,35.8,126,864,1033,37.4,104,8,929,-43,49,1.8,27681
20981,T001038,Total male and female,GM0216,Culemborg,2013JJ00,2013,27681,941,258,9.3,204,7.4,54,929,33.6,116,813,1074,38.9,140,-20,934,-145,-91,-3.3,27590
20982,T001038,Total male and female,GM0216,Culemborg,2014JJ00,2014,27590,938,258,9.4,206,7.5,52,1072,38.9,126,946,1156,41.9,102,2,1054,-84,-30,-1.1,27560
20983,T001038,Total male and female,GM0216,Culemborg,2015JJ00,2015,27560,937,258,9.3,243,8.8,15,1211,43.9,141,1070,1144,41.4,148,-27,996,67,84,3,27644
20984,T001038,Total male and female,GM0216,Culemborg,2016JJ00,2016,27644,944,239,8.6,220,7.9,19,1439,51.8,106,1333,1237,44.6,140,-25,1097,202,220,8,27864
20985,T001038,Total male and female,GM0216,Culemborg,2017JJ00,2017,27864,951,264,9.4,208,7.4,56,1531,54.6,129,1402,1260,45,97,-13,1163,271,331,11.9,28195
20986,T001038,Total male and female,GM0216,Culemborg,2018JJ00,2018,28195,963,283,10,248,8.7,35,1512,53.3,165,1347,1189,41.9,72,1,1117,323,360,12.8,28555
20987,T001038,Total male and female,GM0216,Culemborg,2019JJ00,2019,28555,975,279,9.7,249,8.7,30,1647,57.3,229,1418,1278,44.4,73,4,1205,369,400,14,28955
20988,T001038,Total male and female,GM0216,Culemborg,2020JJ00,2020,28955,989,287,9.9,238,8.2,49,1456,50.1,136,1320,1334,45.9,124,-33,1210,122,166,5.7,29121
20989,T001038,Total male and female,GM0216,Culemborg,2021JJ00,2021,29121,994,370,12.6,258,8.8,112,1464,50,159,1305,1299,44.4,101,-13,1198,165,276,9.5,29397
20990,T001038,Total male and female,GM0216,Culemborg,2022JJ00,2022,29397,1004,296,10,275,9.3,21,1632,55.2,194,1438,1321,44.7,123,-3,1198,311,332,11.3,29729
20991,T001038,Total male and female,GM0216,Culemborg,2023JJ00,2023,29729,1016,290,9.7,217,7.3,73,1511,50.6,191,1320,1368,45.8,111,-21,1257,143,215,7.2,29944
21144,T001038,Total male and female,GM0148,Dalfsen,2012JJ00,2012,27432,166,282,10.3,182,6.6,100,876,31.9,92,784,838,30.5,70,-5,768,38,138,5,27570
21145,T001038,Total male and female,GM0148,Dalfsen,2013JJ00,2013,27570,167,291,10.5,226,8.2,65,903,32.7,76,827,863,31.2,67,-9,796,40,104,3.8,27674
21146,T001038,Total male and female,GM0148,Dalfsen,2014JJ00,2014,27674,168,260,9.4,222,8,38,943,34.1,70,873,980,35.4,82,-20,898,-37,3,0.1,27677
21147,T001038,Total male and female,GM0148,Dalfsen,2015JJ00,2015,27677,168,311,11.2,220,7.9,91,1095,39.4,80,1015,947,34.1,84,-7,863,148,239,8.6,27916
21148,T001038,Total male and female,GM0148,Dalfsen,2016JJ00,2016,27916,169,260,9.3,205,7.3,55,1090,38.9,67,1023,990,35.4,85,-9,905,100,154,5.5,28070
21149,T001038,Total male and female,GM0148,Dalfsen,2017JJ00,2017,28070,170,298,10.6,252,9,46,1259,44.7,75,1184,1134,40.3,74,-5,1060,125,172,6.1,28242
21150,T001038,Total male and female,GM0148,Dalfsen,2018JJ00,2018,28242,171,271,9.6,222,7.8,49,1259,44.4,102,1157,1054,37.2,55,0,999,205,257,9.1,28499
21151,T001038,Total male and female,GM0148,Dalfsen,2019JJ00,2019,28499,173,266,9.3,223,7.8,43,1073,37.6,60,1013,1028,36,61,-2,967,45,88,3.1,28587
21152,T001038,Total male and female,GM0148,Dalfsen,2020JJ00,2020,28587,173,263,9.1,267,9.3,-4,1344,46.8,98,1246,1028,35.8,74,-5,954,316,314,11,28901
21153,T001038,Total male and female,GM0148,Dalfsen,2021JJ00,2021,28901,175,278,9.6,264,9.1,14,1200,41.3,69,1131,956,32.9,78,0,878,244,261,9,29162
21154,T001038,Total male and female,GM0148,Dalfsen,2022JJ00,2022,29162,177,270,9.2,275,9.4,-5,1489,50.7,463,1026,1034,35.2,184,-5,850,455,450,15.4,29612
21155,T001038,Total male and female,GM0148,Dalfsen,2023JJ00,2023,29612,179,234,7.9,290,9.8,-56,1335,45,241,1094,1207,40.7,136,-2,1071,128,71,2.4,29683
21308,T001038,Total male and female,GM1891,Dantumadiel,2012JJ00,2012,19264,226,182,9.5,180,9.4,2,532,27.7,20,512,667,34.7,32,0,635,-135,-134,-7,19130
21309,T001038,Total male and female,GM1891,Dantumadiel,2013JJ00,2013,19130,224,179,9.4,194,10.2,-15,603,31.6,18,585,687,36,15,2,672,-84,-100,-5.2,19030
21310,T001038,Total male and female,GM1891,Dantumadiel,2014JJ00,2014,19030,223,194,10.2,218,11.4,-24,652,34.2,26,626,600,31.5,24,0,576,52,29,1.5,19059
21311,T001038,Total male and female,GM1891,Dantumadiel,2015JJ00,2015,19059,223,179,9.4,185,9.7,-6,663,34.8,16,647,701,36.8,21,2,680,-38,-44,-2.3,19015
21312,T001038,Total male and female,GM1891,Dantumadiel,2016JJ00,2016,19015,224,178,9.4,179,9.4,-1,700,36.9,35,665,772,40.7,25,1,747,-72,-73,-3.8,18942
21313,T001038,Total male and female,GM1891,Dantumadiel,2017JJ00,2017,18942,223,187,9.9,231,12.2,-44,734,38.8,35,699,728,38.5,20,1,708,6,-38,-2,18904
21314,T001038,Total male and female,GM1891,Dantumadiel,2018JJ00,2018,18904,223,192,10.2,234,12.4,-42,816,43.1,25,791,755,39.9,37,-7,718,61,19,1,18923
21315,T001038,Total male and female,GM1891,Dantumadiel,2019JJ00,2019,18923,224,184,9.7,201,10.6,-17,804,42.5,33,771,788,41.6,16,3,772,16,-1,-0.1,18922
21316,T001038,Total male and female,GM1891,Dantumadiel,2020JJ00,2020,18922,224,183,9.7,202,10.7,-19,759,40.1,27,732,719,38,14,0,705,40,21,1.1,18943
21317,T001038,Total male and female,GM1891,Dantumadiel,2021JJ00,2021,18943,224,162,8.5,271,14.3,-109,796,42,35,761,673,35.5,21,-2,652,123,14,0.7,18957
21318,T001038,Total male and female,GM1891,Dantumadiel,2022JJ00,2022,18957,224,189,9.9,210,11,-21,991,52,200,791,733,38.4,67,-10,666,258,237,12.5,19194
21319,T001038,Total male and female,GM1891,Dantumadiel,2023JJ00,2023,19194,227,188,9.8,229,11.9,-41,862,45,184,678,880,45.9,81,0,799,-18,-59,-3.1,19135
21472,T001038,Total male and female,GM0503,Delft,2012JJ00,2012,98675,4324,922,9.3,742,7.5,180,8280,83.7,2952,5328,8028,81.2,2586,-857,5442,252,422,4.3,99097
21473,T001038,Total male and female,GM0503,Delft,2013JJ00,2013,99097,4341,970,9.7,751,7.5,219,8722,87.6,3107,5615,7980,80.1,2449,-575,5531,742,949,9.6,100046
21474,T001038,Total male and female,GM0503,Delft,2014JJ00,2014,100046,4382,911,9.1,723,7.2,188,9453,94,3371,6082,8640,85.9,2669,-616,5971,813,984,9.8,101030
21475,T001038,Total male and female,GM0503,Delft,2015JJ00,2015,101030,4425,913,9,739,7.3,174,9397,93,3710,5687,9555,94.6,3287,-1089,6268,-158,4,0,101034
21476,T001038,Total male and female,GM0503,Delft,2016JJ00,2016,101034,4422,993,9.8,737,7.3,256,9824,97.1,3846,5978,9708,95.9,2979,-797,6729,116,347,3.4,101381
21477,T001038,Total male and female,GM0503,Delft,2017JJ00,2017,101381,4437,864,8.5,743,7.3,121,10834,106.4,4220,6614,10064,98.8,3132,-758,6932,770,872,8.6,102253
21478,T001038,Total male and female,GM0503,Delft,2018JJ00,2018,102253,4514,913,8.9,780,7.6,133,10737,104.5,4439,6298,9955,96.9,2984,-467,6971,782,910,8.9,103163
21479,T001038,Total male and female,GM0503,Delft,2019JJ00,2019,103163,4555,922,8.9,728,7,194,10742,103.9,4430,6312,10495,101.5,3119,-543,7376,247,432,4.2,103595
21480,T001038,Total male and female,GM0503,Delft,2020JJ00,2020,103595,4574,879,8.5,812,7.8,67,10684,103.1,3640,7044,10746,103.7,3197,-646,7549,-62,-14,-0.1,103581
21481,T001038,Total male and female,GM0503,Delft,2021JJ00,2021,103581,4573,925,8.9,792,7.6,133,11706,112.5,4351,7355,10838,104.1,2574,-423,8264,868,991,9.6,104572
21482,T001038,Total male and female,GM0503,Delft,2022JJ00,2022,104572,4615,808,7.7,825,7.8,-17,11951,113.5,4988,6963,10410,98.8,2628,-286,7782,1541,1514,14.5,106086
21483,T001038,Total male and female,GM0503,Delft,2023JJ00,2023,106086,4682,840,7.8,787,7.3,53,14259,132.2,4690,9569,10818,100.3,2872,-329,7946,3441,3491,32.9,109577
21554,T001038,Total male and female,GM0010,Delfzijl,2012JJ00,2012,26305,198,226,8.6,330,12.6,-104,1168,44.6,331,837,1350,51.6,213,-120,1137,-182,-280,-10.6,26025
21555,T001038,Total male and female,GM0010,Delfzijl,2013JJ00,2013,26025,195,195,7.5,322,12.5,-127,1145,44.3,324,821,1347,52.1,196,-80,1151,-202,-327,-12.6,25698
21556,T001038,Total male and female,GM0010,Delfzijl,2014JJ00,2014,25698,193,209,8.2,319,12.5,-110,1407,55.1,560,847,1586,62.1,133,-42,1453,-179,-289,-11.2,25409
21557,T001038,Total male and female,GM0010,Delfzijl,2015JJ00,2015,25409,191,191,7.6,335,13.3,-144,1487,58.9,509,978,1690,67,173,-61,1517,-203,-341,-13.4,25068
21558,T001038,Total male and female,GM0010,Delfzijl,2016JJ00,2016,25068,188,234,9.4,329,13.2,-95,1704,68.1,366,1338,1710,68.4,118,-42,1592,-6,-103,-4.1,24965
21559,T001038,Total male and female,GM0010,Delfzijl,2017JJ00,2017,24965,188,222,8.9,309,12.4,-87,1534,61.6,183,1351,1547,62.1,140,-65,1407,-13,-102,-4.1,24863
21560,T001038,Total male and female,GM0010,Delfzijl,2018JJ00,2018,24863,187,184,7.4,344,13.9,-160,1431,57.7,301,1130,1418,57.2,122,-26,1296,13,-147,-5.9,24716
21561,T001038,Total male and female,GM0010,Delfzijl,2019JJ00,2019,24716,186,222,9,305,12.3,-83,1504,60.9,314,1190,1464,59.3,135,-39,1329,40,-38,-1.5,24678
21562,T001038,Total male and female,GM0010,Delfzijl,2020JJ00,2020,24678,185,187,7.6,331,13.4,-144,1421,57.7,269,1152,1350,54.8,111,-10,1239,71,-82,-3.3,24596
21718,T001038,Total male and female,GM0762,Deurne,2012JJ00,2012,31762,271,296,9.3,253,8,43,1008,31.8,108,900,1079,34,91,-6,988,-71,-29,-0.9,31733
21719,T001038,Total male and female,GM0762,Deurne,2013JJ00,2013,31733,271,276,8.7,255,8,21,1056,33.3,111,945,1150,36.3,83,-8,1067,-94,-74,-2.3,31659
21720,T001038,Total male and female,GM0762,Deurne,2014JJ00,2014,31659,271,324,10.2,279,8.8,45,1210,38.2,165,1045,1149,36.2,131,-15,1018,61,106,3.3,31765
21721,T001038,Total male and female,GM0762,Deurne,2015JJ00,2015,31765,272,291,9.1,280,8.8,11,1205,37.9,175,1030,1102,34.6,131,-13,971,103,113,3.6,31878
21722,T001038,Total male and female,GM0762,Deurne,2016JJ00,2016,31878,273,320,10,300,9.4,20,1241,38.9,182,1059,1209,37.9,107,-23,1102,32,55,1.7,31933
21723,T001038,Total male and female,GM0762,Deurne,2017JJ00,2017,31933,273,288,9,305,9.5,-17,1353,42.2,158,1195,1138,35.5,117,-30,1021,215,204,6.4,32137
21724,T001038,Total male and female,GM0762,Deurne,2018JJ00,2018,32137,275,298,9.2,305,9.5,-7,1302,40.4,161,1141,1069,33.1,146,-22,923,233,225,7,32362
21725,T001038,Total male and female,GM0762,Deurne,2019JJ00,2019,32362,277,314,9.7,301,9.3,13,1165,35.9,167,998,1069,33,126,-22,943,96,109,3.4,32471
21726,T001038,Total male and female,GM0762,Deurne,2020JJ00,2020,32471,278,293,9,357,11,-64,1099,33.9,159,940,1070,33,108,-5,962,29,-34,-1,32437
21727,T001038,Total male and female,GM0762,Deurne,2021JJ00,2021,32437,277,318,9.8,375,11.5,-57,1260,38.7,163,1097,1034,31.8,90,2,944,226,169,5.2,32606
21728,T001038,Total male and female,GM0762,Deurne,2022JJ00,2022,32606,279,261,8,331,10.1,-70,1407,42.9,353,1054,966,29.5,132,-24,834,441,371,11.4,32977
21729,T001038,Total male and female,GM0762,Deurne,2023JJ00,2023,32977,282,283,8.6,362,10.9,-79,1380,41.7,309,1071,1098,33.2,203,-81,895,282,203,6.2,33180
21800,T001038,Total male and female,GM0150,Deventer,2012JJ00,2012,98672,752,1166,11.8,818,8.3,348,3957,40.1,1061,2896,4400,44.6,777,-181,3623,-443,-91,-0.9,98581
21801,T001038,Total male and female,GM0150,Deventer,2013JJ00,2013,98581,751,1088,11.1,837,8.5,251,4149,42.1,1143,3006,4662,47.4,981,-361,3681,-513,-259,-2.6,98322
21802,T001038,Total male and female,GM0150,Deventer,2014JJ00,2014,98322,749,1071,10.9,834,8.5,237,4629,47,1303,3326,4647,47.2,816,-198,3831,-18,218,2.2,98540
21803,T001038,Total male and female,GM0150,Deventer,2015JJ00,2015,98540,751,1003,10.2,866,8.8,137,4981,50.5,1264,3717,4785,48.5,738,-101,4047,196,329,3.3,98869
21804,T001038,Total male and female,GM0150,Deventer,2016JJ00,2016,98869,753,1051,10.6,807,8.1,244,5321,53.7,1208,4113,5135,51.8,986,-432,4149,186,426,4.3,99295
21805,T001038,Total male and female,GM0150,Deventer,2017JJ00,2017,99295,757,981,9.9,898,9,83,5347,53.8,969,4378,5074,51,697,-175,4377,273,358,3.6,99653
21806,T001038,Total male and female,GM0150,Deventer,2018JJ00,2018,99653,763,977,9.8,901,9,76,5002,50.1,1094,3908,4778,47.9,613,-110,4165,224,304,3.1,99957
21807,T001038,Total male and female,GM0150,Deventer,2019JJ00,2019,99957,765,946,9.4,940,9.4,6,5326,53.1,1200,4126,4562,45.5,775,-129,3787,764,762,7.6,100719
21808,T001038,Total male and female,GM0150,Deventer,2020JJ00,2020,100719,771,965,9.6,1034,10.2,-69,5083,50.3,824,4259,4498,44.5,505,-23,3993,585,517,5.1,101236
21809,T001038,Total male and female,GM0150,Deventer,2021JJ00,2021,101236,775,992,9.8,958,9.5,34,4925,48.6,842,4083,4753,46.9,619,-107,4134,172,210,2.1,101446
21810,T001038,Total male and female,GM0150,Deventer,2022JJ00,2022,101446,777,1025,10,1024,10,1,5729,56.1,1501,4228,4392,43,567,-83,3825,1337,1335,13.2,102781
21811,T001038,Total male and female,GM0150,Deventer,2023JJ00,2023,102781,787,979,9.5,1001,9.7,-22,5560,53.9,1168,4392,4905,47.6,911,-300,3994,655,624,6.1,103405
21964,T001038,Total male and female,GM0384,Diemen,2012JJ00,2012,24935,2080,268,10.7,178,7.1,90,2371,94.6,574,1797,2182,87,455,-68,1727,189,283,11.3,25218
21965,T001038,Total male and female,GM0384,Diemen,2013JJ00,2013,25218,2103,233,9.1,186,7.3,47,3079,120.4,647,2432,2418,94.5,576,-143,1842,661,712,28.2,25930
21966,T001038,Total male and female,GM0384,Diemen,2014JJ00,2014,25930,2163,217,8.3,184,7,33,3330,126.6,684,2646,2628,99.9,616,-37,2012,702,736,28.4,26666
21967,T001038,Total male and female,GM0384,Diemen,2015JJ00,2015,26666,2224,264,9.9,188,7,76,3086,115.4,678,2408,2982,111.5,696,-161,2286,104,174,6.5,26840
21968,T001038,Total male and female,GM0384,Diemen,2016JJ00,2016,26840,2239,295,10.9,201,7.4,94,3440,127.1,802,2638,3104,114.7,677,-120,2427,336,432,16.1,27272
21969,T001038,Total male and female,GM0384,Diemen,2017JJ00,2017,27272,2275,274,9.9,215,7.8,59,3804,137.3,896,2908,3008,108.6,526,-51,2482,796,849,31.1,28121
21970,T001038,Total male and female,GM0384,Diemen,2018JJ00,2018,28121,2345,301,10.5,179,6.2,122,4129,144.1,1028,3101,3167,110.5,670,-68,2497,962,1075,38.2,29196
21971,T001038,Total male and female,GM0384,Diemen,2019JJ00,2019,29196,2435,322,10.7,220,7.3,102,4772,159.1,1466,3306,3286,109.6,665,-84,2621,1486,1584,54.3,30780
21972,T001038,Total male and female,GM0384,Diemen,2020JJ00,2020,30780,2567,332,10.7,249,8,83,4684,150.8,1159,3525,4208,135.5,908,-90,3300,476,554,18,31334
21973,T001038,Total male and female,GM0384,Diemen,2021JJ00,2021,31334,2613,354,11.2,236,7.5,118,4792,151.8,1515,3277,4422,140,785,-128,3637,370,488,15.6,31822
21974,T001038,Total male and female,GM0384,Diemen,2022JJ00,2022,31822,2663,334,10.3,247,7.6,87,5529,171.2,2126,3403,4639,143.6,1102,-200,3537,890,963,30.3,32785
21975,T001038,Total male and female,GM0384,Diemen,2023JJ00,2023,32785,2744,325,9.9,250,7.6,75,4315,131.2,1383,2932,4193,127.5,927,-178,3266,122,192,5.9,32977
22384,T001038,Total male and female,GM1980,Dijk en Waard,2022JJ00,2022,87695,1417,803,9.1,722,8.2,81,5227,59.2,977,4250,4009,45.4,492,-123,3517,1218,1290,14.7,88985
22385,T001038,Total male and female,GM1980,Dijk en Waard,2023JJ00,2023,88985,1438,873,9.8,716,8,157,5077,56.7,725,4352,4142,46.3,598,-250,3544,935,1091,12.3,90076
22456,T001038,Total male and female,GM1774,Dinkelland,2012JJ00,2012,26073,148,203,7.8,221,8.5,-18,698,26.8,91,607,697,26.7,54,12,643,1,-17,-0.7,26056
22457,T001038,Total male and female,GM1774,Dinkelland,2013JJ00,2013,26056,148,204,7.8,245,9.4,-41,614,23.6,66,548,682,26.2,73,-4,609,-68,-109,-4.2,25947
22458,T001038,Total male and female,GM1774,Dinkelland,2014JJ00,2014,25947,148,225,8.7,233,9,-8,747,28.8,96,651,758,29.2,73,-3,685,-11,-19,-0.7,25928
22459,T001038,Total male and female,GM1774,Dinkelland,2015JJ00,2015,25928,148,218,8.4,238,9.1,-20,1070,41.1,307,763,860,33,79,-3,781,210,192,7.4,26120
22460,T001038,Total male and female,GM1774,Dinkelland,2016JJ00,2016,26120,149,202,7.7,239,9.1,-37,1208,46.1,237,971,1047,40,56,-3,991,161,124,4.7,26244
22461,T001038,Total male and female,GM1774,Dinkelland,2017JJ00,2017,26244,149,235,8.9,254,9.7,-19,977,37.2,68,909,911,34.7,93,-10,818,66,47,1.8,26291
22462,T001038,Total male and female,GM1774,Dinkelland,2018JJ00,2018,26291,150,211,8,243,9.2,-32,911,34.6,87,824,821,31.2,63,-5,758,90,59,2.2,26350
22463,T001038,Total male and female,GM1774,Dinkelland,2019JJ00,2019,26350,150,224,8.5,245,9.3,-21,837,31.7,92,745,704,26.7,61,-8,643,133,111,4.2,26461
22464,T001038,Total male and female,GM1774,Dinkelland,2020JJ00,2020,26461,151,275,10.4,302,11.4,-27,900,33.9,93,807,728,27.4,53,-4,675,172,145,5.5,26606
22465,T001038,Total male and female,GM1774,Dinkelland,2021JJ00,2021,26606,151,253,9.5,284,10.7,-31,810,30.5,81,729,791,29.7,59,-7,732,19,-12,-0.5,26594
22466,T001038,Total male and female,GM1774,Dinkelland,2022JJ00,2022,26594,151,252,9.4,297,11.1,-45,967,36.3,289,678,772,28.9,112,-4,660,195,149,5.6,26743
22467,T001038,Total male and female,GM1774,Dinkelland,2023JJ00,2023,26743,152,292,10.9,318,11.9,-26,927,34.7,153,774,905,33.8,94,-20,811,22,-4,-0.1,26739
22784,T001038,Total male and female,GM0504,Dirksland,2012JJ00,2012,8476,153,80,9.4,74,8.7,6,280,32.9,22,258,270,31.8,12,1,258,10,50,5.9,8526
22948,T001038,Total male and female,GM0221,Doesburg,2012JJ00,2012,11598,1002,89,7.7,112,9.7,-23,541,46.8,42,499,577,49.9,36,-1,541,-36,-59,-5.1,11539
22949,T001038,Total male and female,GM0221,Doesburg,2013JJ00,2013,11539,998,79,6.9,103,9,-24,442,38.5,45,397,520,45.3,40,-8,480,-78,-102,-8.8,11437
22950,T001038,Total male and female,GM0221,Doesburg,2014JJ00,2014,11437,989,86,7.5,106,9.3,-20,483,42.4,38,445,546,47.9,62,-2,484,-63,-82,-7.2,11355
22951,T001038,Total male and female,GM0221,Doesburg,2015JJ00,2015,11355,982,89,7.8,103,9.1,-14,578,50.9,29,549,583,51.4,66,-5,517,-5,-19,-1.7,11336
22952,T001038,Total male and female,GM0221,Doesburg,2016JJ00,2016,11336,981,58,5.1,112,9.9,-54,625,55.1,54,571,565,49.8,35,0,530,60,5,0.4,11341
22953,T001038,Total male and female,GM0221,Doesburg,2017JJ00,2017,11341,982,86,7.6,118,10.4,-32,665,58.7,47,618,644,56.8,40,2,604,21,-13,-1.1,11328
22954,T001038,Total male and female,GM0221,Doesburg,2018JJ00,2018,11328,982,74,6.6,106,9.4,-32,490,43.6,46,444,638,56.8,31,-3,607,-148,-180,-15.9,11148
22955,T001038,Total male and female,GM0221,Doesburg,2019JJ00,2019,11148,967,65,5.8,94,8.5,-29,524,47.2,58,466,566,50.9,38,-9,528,-42,-71,-6.4,11077
22956,T001038,Total male and female,GM0221,Doesburg,2020JJ00,2020,11077,961,73,6.6,149,13.5,-76,678,61.2,64,614,614,55.5,14,4,600,64,-13,-1.2,11064
22957,T001038,Total male and female,GM0221,Doesburg,2021JJ00,2021,11064,960,66,6,140,12.7,-74,582,52.7,54,528,537,48.6,26,-1,511,45,-28,-2.5,11036
22958,T001038,Total male and female,GM0221,Doesburg,2022JJ00,2022,11036,955,63,5.7,122,11,-59,653,59,69,584,549,49.6,59,-10,490,104,45,4.1,11081
22959,T001038,Total male and female,GM0221,Doesburg,2023JJ00,2023,11081,959,85,7.7,122,11,-37,656,59.2,100,556,621,56,53,-5,568,35,-2,-0.2,11079
23030,T001038,Total male and female,GM0222,Doetinchem,2012JJ00,2012,56252,712,548,9.7,489,8.7,59,2252,40,198,2054,2147,38.1,231,-58,1916,105,162,2.9,56414
23031,T001038,Total male and female,GM0222,Doetinchem,2013JJ00,2013,56414,713,482,8.5,502,8.9,-20,2193,38.9,136,2057,2243,39.8,210,-29,2033,-50,-70,-1.2,56344
23032,T001038,Total male and female,GM0222,Doetinchem,2014JJ00,2014,56344,713,612,10.8,465,8.2,147,2259,40,187,2072,2259,40,202,-27,2057,0,140,2.5,56484
23033,T001038,Total male and female,GM0222,Doetinchem,2015JJ00,2015,56484,714,531,9.4,556,9.8,-25,2606,46,417,2189,2238,39.5,180,-12,2058,368,343,6.1,56827
23034,T001038,Total male and female,GM0222,Doetinchem,2016JJ00,2016,56827,719,534,9.4,557,9.8,-23,5264,92.4,2753,2511,5001,87.8,243,-41,4758,263,241,4.2,57068
23035,T001038,Total male and female,GM0222,Doetinchem,2017JJ00,2017,57068,722,544,9.5,578,10.1,-34,2890,50.5,225,2665,2544,44.5,201,-19,2343,346,314,5.5,57382
23036,T001038,Total male and female,GM0222,Doetinchem,2018JJ00,2018,57382,726,502,8.7,593,10.3,-91,2622,45.6,209,2413,2356,41,144,7,2212,266,173,3,57555
23037,T001038,Total male and female,GM0222,Doetinchem,2019JJ00,2019,57555,728,535,9.3,556,9.6,-21,2842,49.2,268,2574,2371,41,168,-18,2203,471,446,7.7,58001
23038,T001038,Total male and female,GM0222,Doetinchem,2020JJ00,2020,58001,734,470,8.1,598,10.3,-128,2719,46.8,241,2478,2322,39.9,140,-8,2182,397,269,4.6,58270
23039,T001038,Total male and female,GM0222,Doetinchem,2021JJ00,2021,58270,737,552,9.5,652,11.2,-100,2632,45.1,211,2421,2263,38.7,176,-14,2087,369,276,4.7,58546
23040,T001038,Total male and female,GM0222,Doetinchem,2022JJ00,2022,58546,741,505,8.6,599,10.2,-94,2978,50.6,474,2504,2231,37.9,246,-24,1985,747,649,11.1,59195
23041,T001038,Total male and female,GM0222,Doetinchem,2023JJ00,2023,59195,749,524,8.8,624,10.5,-100,2823,47.5,353,2470,2294,38.6,194,-5,2100,529,428,7.2,59623
23276,T001038,Total male and female,GM0766,Dongen,2012JJ00,2012,25205,861,221,8.7,202,8,19,839,33.2,91,748,682,27,63,2,619,157,177,7,25382
23277,T001038,Total male and female,GM0766,Dongen,2013JJ00,2013,25382,867,233,9.2,210,8.3,23,775,30.5,122,653,822,32.4,106,-10,716,-47,-24,-0.9,25358
23278,T001038,Total male and female,GM0766,Dongen,2014JJ00,2014,25358,866,228,9,207,8.2,21,826,32.5,89,737,813,32,72,-4,741,13,37,1.5,25395
23279,T001038,Total male and female,GM0766,Dongen,2015JJ00,2015,25395,867,222,8.7,244,9.6,-22,963,37.9,101,862,924,36.4,112,-6,812,39,18,0.7,25413
23280,T001038,Total male and female,GM0766,Dongen,2016JJ00,2016,25413,868,206,8.1,233,9.2,-27,1020,40.1,131,889,897,35.2,88,5,809,123,96,3.8,25509
23281,T001038,Total male and female,GM0766,Dongen,2017JJ00,2017,25509,871,252,9.8,224,8.7,28,1246,48.6,103,1143,1005,39.2,102,-16,903,241,268,10.5,25777
23282,T001038,Total male and female,GM0766,Dongen,2018JJ00,2018,25777,882,267,10.3,241,9.3,26,1173,45.3,137,1036,925,35.7,74,-2,851,248,274,10.6,26051
23283,T001038,Total male and female,GM0766,Dongen,2019JJ00,2019,26051,891,255,9.8,257,9.8,-2,1110,42.5,140,970,936,35.8,110,-24,826,174,171,6.6,26222
23284,T001038,Total male and female,GM0766,Dongen,2020JJ00,2020,26222,897,257,9.8,296,11.3,-39,1234,46.9,133,1101,1049,39.9,88,-5,961,185,146,5.6,26368
23285,T001038,Total male and female,GM0766,Dongen,2021JJ00,2021,26368,902,270,10.2,314,11.9,-44,1075,40.7,131,944,916,34.7,94,-13,822,159,115,4.4,26483
23286,T001038,Total male and female,GM0766,Dongen,2022JJ00,2022,26483,906,264,9.8,323,12,-59,1778,66.2,728,1050,1000,37.3,227,-50,773,778,717,27.1,27200
23287,T001038,Total male and female,GM0766,Dongen,2023JJ00,2023,27200,931,268,9.9,264,9.7,4,1059,39,144,915,1167,43,296,-22,871,-108,-105,-3.9,27095
23358,T001038,Total male and female,GM0058,Dongeradeel,2012JJ00,2012,24284,145,285,11.8,224,9.2,61,662,27.3,45,617,786,32.4,47,-4,739,-124,-63,-2.6,24221
23359,T001038,Total male and female,GM0058,Dongeradeel,2013JJ00,2013,24221,145,236,9.8,231,9.5,5,717,29.6,54,663,783,32.4,47,4,736,-66,-61,-2.5,24160
23360,T001038,Total male and female,GM0058,Dongeradeel,2014JJ00,2014,24160,145,235,9.8,230,9.6,5,654,27.2,55,599,835,34.7,54,-5,781,-181,-177,-7.3,23983
23361,T001038,Total male and female,GM0058,Dongeradeel,2015JJ00,2015,23983,144,242,10.1,229,9.6,13,765,31.9,80,685,828,34.6,37,1,791,-63,-51,-2.1,23932
23362,T001038,Total male and female,GM0058,Dongeradeel,2016JJ00,2016,23932,144,217,9.1,227,9.5,-10,875,36.6,79,796,895,37.4,89,-11,806,-20,-31,-1.3,23901
23363,T001038,Total male and female,GM0058,Dongeradeel,2017JJ00,2017,23901,144,237,9.9,236,9.9,1,802,33.6,49,753,915,38.4,68,-6,847,-113,-112,-4.7,23789
23364,T001038,Total male and female,GM0058,Dongeradeel,2018JJ00,2018,23789,142,230,9.7,241,10.1,-11,867,36.4,89,778,811,34.1,55,-11,756,56,56,2.4,23845
23686,T001038,Total male and female,GM0505,Dordrecht,2012JJ00,2012,118862,1504,1397,11.8,1089,9.2,308,4708,39.7,1143,3565,5406,45.6,1297,-371,4109,-698,-396,-3.3,118466
23687,T001038,Total male and female,GM0505,Dordrecht,2013JJ00,2013,118466,1503,1324,11.2,1077,9.1,247,4719,39.8,1106,3613,4751,40.1,898,-15,3853,-32,225,1.9,118691
23688,T001038,Total male and female,GM0505,Dordrecht,2014JJ00,2014,118691,1506,1365,11.5,1002,8.4,363,4889,41.2,1019,3870,5048,42.5,1123,-242,3925,-159,208,1.8,118899
23689,T001038,Total male and female,GM0505,Dordrecht,2015JJ00,2015,118899,1508,1259,10.6,1078,9.1,181,4751,40,941,3810,5030,42.3,863,-89,4167,-279,-98,-0.8,118801
23690,T001038,Total male and female,GM0505,Dordrecht,2016JJ00,2016,118801,1511,1154,9.7,1103,9.3,51,4910,41.3,877,4033,5031,42.4,733,-72,4298,-121,-70,-0.6,118731
23691,T001038,Total male and female,GM0505,Dordrecht,2017JJ00,2017,118731,1510,1209,10.2,1135,9.6,74,5222,44,968,4254,5593,47.2,927,-203,4666,-371,-305,-2.6,118426
23692,T001038,Total male and female,GM0505,Dordrecht,2018JJ00,2018,118426,1508,1202,10.1,1131,9.5,71,5454,46,1145,4309,5298,44.7,911,-264,4387,156,228,1.9,118654
23693,T001038,Total male and female,GM0505,Dordrecht,2019JJ00,2019,118654,1511,1190,10,1093,9.2,97,5480,46.1,1225,4255,4945,41.6,798,-128,4147,535,630,5.3,119284
23694,T001038,Total male and female,GM0505,Dordrecht,2020JJ00,2020,119284,1519,1169,9.8,1269,10.6,-100,5323,44.7,1070,4253,5390,45.2,604,-82,4786,-67,-169,-1.4,119115
23695,T001038,Total male and female,GM0505,Dordrecht,2021JJ00,2021,119115,1517,1325,11.1,1308,11,17,5843,49,1069,4774,5437,45.6,730,-66,4707,406,422,3.5,119537
23696,T001038,Total male and female,GM0505,Dordrecht,2022JJ00,2022,119537,1541,1212,10.1,1236,10.3,-24,7185,59.6,2521,4664,5265,43.7,940,-160,4325,1920,1897,15.9,121434
23697,T001038,Total male and female,GM0505,Dordrecht,2023JJ00,2023,121434,1566,1173,9.6,1183,9.7,-10,6510,53.5,1522,4988,5852,48.1,1219,-420,4633,658,636,5.2,122070
23768,T001038,Total male and female,GM0498,Drechterland,2012JJ00,2012,19300,327,186,9.6,170,8.8,16,833,43.2,107,726,849,44,75,-21,774,-16,-2,-0.1,19298
23769,T001038,Total male and female,GM0498,Drechterland,2013JJ00,2013,19298,326,161,8.4,141,7.3,20,722,37.5,101,621,793,41.1,72,-8,721,-71,-48,-2.5,19250
23770,T001038,Total male and female,GM0498,Drechterland,2014JJ00,2014,19250,326,183,9.5,154,8,29,898,46.6,169,729,884,45.9,114,-12,770,14,44,2.3,19294
23771,T001038,Total male and female,GM0498,Drechterland,2015JJ00,2015,19294,327,175,9,141,7.3,34,996,51.5,132,864,925,47.8,85,-13,840,71,106,5.5,19400
23772,T001038,Total male and female,GM0498,Drechterland,2016JJ00,2016,19400,329,196,10.1,173,8.9,23,1019,52.5,105,914,1057,54.5,100,-19,957,-38,-16,-0.8,19384
23773,T001038,Total male and female,GM0498,Drechterland,2017JJ00,2017,19384,329,182,9.4,154,7.9,28,1104,56.9,119,985,1076,55.4,104,-7,972,28,56,2.9,19440
23774,T001038,Total male and female,GM0498,Drechterland,2018JJ00,2018,19440,330,171,8.8,144,7.4,27,1146,58.7,128,1018,1014,52,92,-22,922,132,157,8.1,19597
23775,T001038,Total male and female,GM0498,Drechterland,2019JJ00,2019,19597,333,172,8.7,148,7.5,24,1115,56.7,128,987,1018,51.8,93,-18,925,97,122,6.2,19719
23776,T001038,Total male and female,GM0498,Drechterland,2020JJ00,2020,19719,335,201,10.2,171,8.6,30,1116,56.4,156,960,1026,51.9,100,-19,926,90,119,6,19838
23777,T001038,Total male and female,GM0498,Drechterland,2021JJ00,2021,19838,337,202,10.1,162,8.1,40,1041,52.3,120,921,937,47.1,93,-11,844,104,145,7.3,19983
23778,T001038,Total male and female,GM0498,Drechterland,2022JJ00,2022,19983,339,185,9.2,180,8.9,5,1482,73.4,374,1108,1084,53.7,167,-16,917,398,402,20.1,20385
23779,T001038,Total male and female,GM0498,Drechterland,2023JJ00,2023,20385,346,169,8.3,187,9.1,-18,1241,60.7,218,1023,1114,54.5,187,-46,927,127,111,5.4,20496
24342,T001038,Total male and female,GM1719,Drimmelen,2012JJ00,2012,26664,277,203,7.6,216,8.1,-13,837,31.3,121,716,753,28.2,86,-15,667,84,73,2.7,26737
24343,T001038,Total male and female,GM1719,Drimmelen,2013JJ00,2013,26737,278,237,8.9,231,8.6,6,745,27.9,85,660,794,29.7,107,-5,687,-49,-42,-1.6,26695
24344,T001038,Total male and female,GM1719,Drimmelen,2014JJ00,2014,26695,278,210,7.9,229,8.6,-19,884,33.1,135,749,856,32.1,99,-13,757,28,8,0.3,26703
24345,T001038,Total male and female,GM1719,Drimmelen,2015JJ00,2015,26703,278,204,7.6,247,9.2,-43,1022,38.2,178,844,867,32.4,88,-5,779,155,112,4.2,26815
24346,T001038,Total male and female,GM1719,Drimmelen,2016JJ00,2016,26815,281,205,7.6,248,9.2,-43,1090,40.6,159,931,994,37,101,-6,893,96,54,2,26869
24347,T001038,Total male and female,GM1719,Drimmelen,2017JJ00,2017,26869,281,244,9,223,8.3,21,1284,47.6,243,1041,1112,41.2,167,-20,945,172,194,7.2,27063
24348,T001038,Total male and female,GM1719,Drimmelen,2018JJ00,2018,27063,284,202,7.5,250,9.2,-48,1182,43.6,292,890,1048,38.7,192,-9,856,134,87,3.2,27150
24349,T001038,Total male and female,GM1719,Drimmelen,2019JJ00,2019,27150,285,228,8.4,241,8.9,-13,1286,47.3,345,941,1152,42.3,262,-41,890,134,122,4.5,27272
24350,T001038,Total male and female,GM1719,Drimmelen,2020JJ00,2020,27272,287,209,7.7,282,10.3,-73,1322,48.4,344,978,1195,43.8,261,-38,934,127,53,1.9,27325
24351,T001038,Total male and female,GM1719,Drimmelen,2021JJ00,2021,27325,287,231,8.4,255,9.3,-24,1402,51.2,375,1027,1228,44.8,343,-17,885,174,151,5.5,27476
24352,T001038,Total male and female,GM1719,Drimmelen,2022JJ00,2022,27476,289,244,8.8,289,10.4,-45,1803,65,609,1194,1241,44.7,391,-26,850,562,518,18.9,27994
24353,T001038,Total male and female,GM1719,Drimmelen,2023JJ00,2023,27994,295,264,9.4,280,10,-16,1643,58.5,509,1134,1429,50.9,449,-35,980,214,198,7.1,28192
24424,T001038,Total male and female,GM0303,Dronten,2012JJ00,2012,40470,121,431,10.6,235,5.8,196,2326,57.3,659,1667,2317,57.1,253,-74,2064,9,209,5.2,40679
24425,T001038,Total male and female,GM0303,Dronten,2013JJ00,2013,40679,122,368,9.1,232,5.7,136,2529,62.4,989,1540,2940,72.5,824,-547,2116,-411,-266,-6.5,40413
24426,T001038,Total male and female,GM0303,Dronten,2014JJ00,2014,40413,121,421,10.4,217,5.4,204,2650,65.6,1126,1524,2913,72.1,362,-125,2551,-263,-50,-1.2,40363
24427,T001038,Total male and female,GM0303,Dronten,2015JJ00,2015,40363,121,376,9.3,262,6.5,114,3210,79.3,1256,1954,3102,76.6,344,-126,2758,108,229,5.7,40592
24428,T001038,Total male and female,GM0303,Dronten,2016JJ00,2016,40592,122,388,9.5,272,6.7,116,3160,77.7,925,2235,3123,76.8,273,-13,2850,37,154,3.8,40746
24429,T001038,Total male and female,GM0303,Dronten,2017JJ00,2017,40746,122,352,8.6,280,6.9,72,2614,64.2,398,2216,2702,66.3,344,-142,2358,-88,-11,-0.3,40735
24430,T001038,Total male and female,GM0303,Dronten,2018JJ00,2018,40735,122,396,9.7,310,7.6,86,2603,63.8,507,2096,2611,64,264,-75,2347,-8,80,2,40815
24431,T001038,Total male and female,GM0303,Dronten,2019JJ00,2019,40815,122,395,9.6,299,7.3,96,3060,74.3,773,2287,2420,58.8,274,-48,2146,640,740,18.1,41555
24432,T001038,Total male and female,GM0303,Dronten,2020JJ00,2020,41555,125,412,9.9,333,8,79,2821,67.5,428,2393,2444,58.5,219,-52,2225,377,456,11,42011
24433,T001038,Total male and female,GM0303,Dronten,2021JJ00,2021,42011,126,455,10.7,336,7.9,119,3484,82.1,638,2846,2749,64.8,445,-117,2304,735,854,20.3,42865
24434,T001038,Total male and female,GM0303,Dronten,2022JJ00,2022,42865,128,406,9.4,349,8.1,57,3484,80.6,866,2618,2806,64.9,542,-174,2264,678,728,17,43593
24435,T001038,Total male and female,GM0303,Dronten,2023JJ00,2023,43593,131,407,9.3,322,7.3,85,3574,81.3,438,3136,2897,65.9,529,-122,2368,677,761,17.5,44354
24588,T001038,Total male and female,GM0225,Druten,2012JJ00,2012,18193,482,149,8.2,138,7.6,11,632,34.7,70,562,634,34.8,56,-7,578,-2,10,0.5,18203
24589,T001038,Total male and female,GM0225,Druten,2013JJ00,2013,18203,483,155,8.5,115,6.3,40,623,34.2,45,578,656,36,50,-14,606,-33,7,0.4,18210
24590,T001038,Total male and female,GM0225,Druten,2014JJ00,2014,18210,483,144,7.9,123,6.7,21,738,40.4,73,665,678,37.1,47,-3,631,60,84,4.6,18294
24591,T001038,Total male and female,GM0225,Druten,2015JJ00,2015,18294,486,160,8.7,136,7.4,24,794,43.3,63,731,703,38.3,64,-12,639,91,113,6.2,18407
24592,T001038,Total male and female,GM0225,Druten,2016JJ00,2016,18407,488,151,8.2,140,7.6,11,862,46.6,77,785,718,38.8,46,-11,672,144,156,8.5,18563
24593,T001038,Total male and female,GM0225,Druten,2017JJ00,2017,18563,492,158,8.5,159,8.5,-1,926,49.7,48,878,783,42,50,-14,733,143,138,7.4,18701
24594,T001038,Total male and female,GM0225,Druten,2018JJ00,2018,18701,497,167,8.9,166,8.9,1,857,45.7,73,784,761,40.6,41,-2,720,96,96,5.1,18797
24595,T001038,Total male and female,GM0225,Druten,2019JJ00,2019,18797,499,165,8.7,145,7.7,20,940,49.8,86,854,829,44,53,-10,776,111,129,6.9,18926
24596,T001038,Total male and female,GM0225,Druten,2020JJ00,2020,18926,503,153,8.1,156,8.2,-3,962,50.7,94,868,893,47.1,67,-22,826,69,65,3.4,18991
24597,T001038,Total male and female,GM0225,Druten,2021JJ00,2021,18991,505,204,10.7,181,9.5,23,900,47.2,78,822,736,38.6,53,-13,683,164,187,9.8,19178
24598,T001038,Total male and female,GM0225,Druten,2022JJ00,2022,19178,511,174,9,187,9.7,-13,1130,58.4,313,817,788,40.7,110,-32,678,342,327,17.1,19505
24599,T001038,Total male and female,GM0225,Druten,2023JJ00,2023,19505,520,171,8.7,198,10.1,-27,951,48.7,157,794,833,42.6,99,-20,734,118,85,4.4,19590
24834,T001038,Total male and female,GM0226,Duiven,2012JJ00,2012,25525,753,203,7.9,142,5.6,61,1033,40.4,85,948,1067,41.8,63,-11,1004,-34,29,1.1,25554
24835,T001038,Total male and female,GM0226,Duiven,2013JJ00,2013,25554,754,215,8.4,178,7,37,1044,40.8,57,987,1028,40.2,75,-12,953,16,55,2.2,25609
24836,T001038,Total male and female,GM0226,Duiven,2014JJ00,2014,25609,755,212,8.3,174,6.8,38,1009,39.4,62,947,1106,43.2,60,2,1046,-97,-61,-2.4,25548
24837,T001038,Total male and female,GM0226,Duiven,2015JJ00,2015,25548,753,203,8,166,6.5,37,945,37.1,64,881,1096,43,49,-12,1047,-151,-115,-4.5,25433
24838,T001038,Total male and female,GM0226,Duiven,2016JJ00,2016,25433,750,192,7.6,178,7,14,1271,50,84,1187,1317,51.8,68,-11,1249,-46,-35,-1.4,25398
24839,T001038,Total male and female,GM0226,Duiven,2017JJ00,2017,25398,749,192,7.6,198,7.8,-6,1328,52.2,85,1243,1278,50.3,77,-11,1201,50,40,1.6,25438
24840,T001038,Total male and female,GM0226,Duiven,2018JJ00,2018,25438,750,196,7.7,192,7.6,4,1170,46.1,84,1086,1281,50.5,65,-19,1216,-111,-106,-4.2,25332
24841,T001038,Total male and female,GM0226,Duiven,2019JJ00,2019,25332,747,207,8.2,193,7.6,14,1124,44.6,64,1060,1344,53.3,74,-10,1270,-220,-206,-8.1,25126
24842,T001038,Total male and female,GM0226,Duiven,2020JJ00,2020,25126,741,203,8.1,209,8.3,-6,1212,48.3,98,1114,1264,50.4,49,-7,1215,-52,-60,-2.4,25066
24843,T001038,Total male and female,GM0226,Duiven,2021JJ00,2021,25066,739,214,8.6,220,8.8,-6,1128,45.1,60,1068,1242,49.7,60,-3,1182,-114,-120,-4.8,24946
24844,T001038,Total male and female,GM0226,Duiven,2022JJ00,2022,24946,736,203,8.1,212,8.5,-9,1167,46.8,119,1048,1167,46.8,104,-12,1063,0,-9,-0.4,24937
24845,T001038,Total male and female,GM0226,Duiven,2023JJ00,2023,24937,736,206,8.3,178,7.1,28,1154,46.3,194,960,1247,50.1,114,-21,1133,-93,-65,-2.6,24872
25408,T001038,Total male and female,GM1711,Echt-Susteren,2012JJ00,2012,32165,312,249,7.8,311,9.7,-62,1284,40,305,979,1316,41,179,-35,1137,-32,-93,-2.9,32072
25409,T001038,Total male and female,GM1711,Echt-Susteren,2013JJ00,2013,32072,311,241,7.5,322,10.1,-81,1347,42.1,324,1023,1366,42.7,192,-40,1174,-19,-96,-3,31976
25410,T001038,Total male and female,GM1711,Echt-Susteren,2014JJ00,2014,31976,310,229,7.2,336,10.5,-107,1587,49.7,517,1070,1509,47.2,184,-19,1325,78,-29,-0.9,31947
25411,T001038,Total male and female,GM1711,Echt-Susteren,2015JJ00,2015,31947,310,240,7.5,403,12.6,-163,1711,53.6,520,1191,1556,48.7,171,-15,1385,155,-4,-0.1,31943
25412,T001038,Total male and female,GM1711,Echt-Susteren,2016JJ00,2016,31943,310,231,7.2,341,10.7,-110,1562,49,371,1191,1587,49.8,171,-20,1416,-25,-128,-4,31815
25413,T001038,Total male and female,GM1711,Echt-Susteren,2017JJ00,2017,31815,309,233,7.3,376,11.8,-143,1725,54.3,324,1401,1645,51.8,190,-33,1455,80,-64,-2,31751
25414,T001038,Total male and female,GM1711,Echt-Susteren,2018JJ00,2018,31751,308,211,6.7,355,11.2,-144,1573,49.6,309,1264,1540,48.6,232,-79,1308,33,-113,-3.6,31638
25415,T001038,Total male and female,GM1711,Echt-Susteren,2019JJ00,2019,31638,307,227,7.2,366,11.6,-139,1653,52.3,368,1285,1544,48.8,199,-35,1345,109,-28,-0.9,31610
25416,T001038,Total male and female,GM1711,Echt-Susteren,2020JJ00,2020,31610,307,230,7.3,384,12.1,-154,1687,53.3,224,1463,1394,44,144,-3,1250,293,141,4.5,31751
25417,T001038,Total male and female,GM1711,Echt-Susteren,2021JJ00,2021,31751,308,254,8,426,13.4,-172,1704,53.7,205,1499,1551,48.9,201,-44,1350,153,-20,-0.6,31731
25418,T001038,Total male and female,GM1711,Echt-Susteren,2022JJ00,2022,31731,308,248,7.8,439,13.8,-191,2050,64.4,413,1637,1624,51,261,-60,1363,426,236,7.4,31967
25419,T001038,Total male and female,GM1711,Echt-Susteren,2023JJ00,2023,31967,310,240,7.5,413,12.9,-173,1651,51.6,227,1424,1403,43.8,216,-31,1187,248,74,2.3,32041
25572,T001038,Total male and female,GM0385,Edam-Volendam,2012JJ00,2012,28700,1760,308,10.7,219,7.6,89,445,15.5,69,376,480,16.7,79,-13,401,-35,54,1.9,28754
25573,T001038,Total male and female,GM0385,Edam-Volendam,2013JJ00,2013,28754,1765,268,9.3,207,7.2,61,571,19.8,73,498,465,16.1,85,-11,380,106,166,5.8,28920
25574,T001038,Total male and female,GM0385,Edam-Volendam,2014JJ00,2014,28920,1775,264,9.1,172,5.9,92,504,17.4,57,447,428,14.8,61,-6,367,76,167,5.8,29087
25575,T001038,Total male and female,GM0385,Edam-Volendam,2015JJ00,2015,29087,1786,277,9.5,199,6.8,78,552,18.9,61,491,502,17.2,79,-21,423,50,137,4.7,29224
25576,T001038,Total male and female,GM0385,Edam-Volendam,2016JJ00,2016,35465,652,314,8.8,250,7,64,1029,28.9,144,885,766,21.5,73,1,693,263,335,9.4,35800
25577,T001038,Total male and female,GM0385,Edam-Volendam,2017JJ00,2017,35800,659,309,8.6,250,7,59,950,26.5,131,819,857,23.9,144,-50,713,93,153,4.3,35953
25578,T001038,Total male and female,GM0385,Edam-Volendam,2018JJ00,2018,35953,662,326,9,304,8.4,22,935,26,142,793,811,22.5,121,-26,690,124,146,4.1,36099
25579,T001038,Total male and female,GM0385,Edam-Volendam,2019JJ00,2019,36099,664,313,8.7,303,8.4,10,933,25.8,126,807,843,23.3,82,-31,761,90,98,2.7,36197
25580,T001038,Total male and female,GM0385,Edam-Volendam,2020JJ00,2020,36197,666,292,8.1,347,9.6,-55,1010,27.9,126,884,886,24.5,112,-18,774,124,71,2,36268
25581,T001038,Total male and female,GM0385,Edam-Volendam,2021JJ00,2021,36268,668,378,10.4,317,8.7,61,1068,29.4,109,959,925,25.4,114,-14,811,143,203,5.6,36471
25582,T001038,Total male and female,GM0385,Edam-Volendam,2022JJ00,2022,36471,671,298,8.1,323,8.8,-25,1138,31.1,419,719,826,22.6,146,-11,680,312,289,7.9,36760
25583,T001038,Total male and female,GM0385,Edam-Volendam,2023JJ00,2023,36760,677,328,8.9,308,8.4,20,1064,28.9,136,928,929,25.2,138,-13,791,135,157,4.3,36917
25654,T001038,Total male and female,GM0228,Ede,2012JJ00,2012,108763,342,1303,11.9,877,8,426,4955,45.3,746,4209,4326,39.6,390,-39,3936,629,1060,9.7,109823
25655,T001038,Total male and female,GM0228,Ede,2013JJ00,2013,109823,345,1244,11.3,815,7.4,429,4874,44.2,716,4158,4472,40.6,530,-16,3942,402,833,7.6,110656
25656,T001038,Total male and female,GM0228,Ede,2014JJ00,2014,110656,348,1284,11.6,861,7.7,423,5414,48.7,702,4712,4908,44.2,596,-76,4312,506,919,8.3,111575
25657,T001038,Total male and female,GM0228,Ede,2015JJ00,2015,111575,351,1306,11.7,861,7.7,445,5330,47.6,749,4581,4933,44,597,-88,4336,397,852,7.6,112427
25658,T001038,Total male and female,GM0228,Ede,2016JJ00,2016,112427,353,1341,11.9,905,8,436,5773,51.1,620,5153,5211,46.1,597,-108,4614,562,994,8.8,113421
25659,T001038,Total male and female,GM0228,Ede,2017JJ00,2017,113421,356,1313,11.5,909,8,404,6035,52.9,842,5193,5182,45.4,542,-74,4640,853,1261,11.1,114682
25660,T001038,Total male and female,GM0228,Ede,2018JJ00,2018,114682,360,1338,11.6,915,7.9,423,5979,51.9,711,5268,5373,46.6,772,-120,4601,606,1028,9,115710
25661,T001038,Total male and female,GM0228,Ede,2019JJ00,2019,115710,364,1377,11.8,924,7.9,453,5950,51.1,792,5158,4943,42.5,516,-72,4427,1007,1455,12.6,117165
25662,T001038,Total male and female,GM0228,Ede,2020JJ00,2020,117165,368,1421,12.1,981,8.3,440,5820,49.4,663,5157,4892,41.5,417,-17,4475,928,1365,11.7,118530
25663,T001038,Total male and female,GM0228,Ede,2021JJ00,2021,118530,373,1526,12.8,1067,8.9,459,5944,49.8,788,5156,4949,41.5,448,-17,4501,995,1456,12.3,119986
25664,T001038,Total male and female,GM0228,Ede,2022JJ00,2022,119986,377,1413,11.7,1026,8.5,387,6584,54.4,1527,5057,4943,40.9,673,-90,4270,1641,2026,16.9,122012
25665,T001038,Total male and female,GM0228,Ede,2023JJ00,2023,122012,384,1364,11.1,995,8.1,369,6676,54.4,1060,5616,5520,45,895,-245,4625,1156,1520,12.5,123532
25818,T001038,Total male and female,GM0317,Eemnes,2012JJ00,2012,8824,284,74,8.4,49,5.6,25,328,37.2,26,302,382,43.4,33,-5,349,-54,-29,-3.3,8795
25819,T001038,Total male and female,GM0317,Eemnes,2013JJ00,2013,8795,283,65,7.4,52,5.9,13,289,32.9,23,266,317,36.1,32,2,285,-28,-16,-1.8,8779
25820,T001038,Total male and female,GM0317,Eemnes,2014JJ00,2014,8779,283,66,7.5,52,5.9,14,359,40.8,35,324,345,39.2,58,-4,287,14,28,3.2,8807
25821,T001038,Total male and female,GM0317,Eemnes,2015JJ00,2015,8807,284,61,6.9,43,4.9,18,475,53.7,22,453,425,48.1,38,-7,387,50,70,7.9,8877
25822,T001038,Total male and female,GM0317,Eemnes,2016JJ00,2016,8877,286,75,8.4,56,6.3,19,515,57.6,28,487,412,46.1,27,6,385,103,122,13.7,8999
25823,T001038,Total male and female,GM0317,Eemnes,2017JJ00,2017,8999,290,73,8.1,61,6.7,12,599,66.1,54,545,502,55.4,40,0,462,97,113,12.6,9112
25824,T001038,Total male and female,GM0317,Eemnes,2018JJ00,2018,9112,294,79,8.7,55,6,24,442,48.5,36,406,466,51.1,27,7,439,-24,1,0.1,9113
25825,T001038,Total male and female,GM0317,Eemnes,2019JJ00,2019,9113,294,72,7.8,74,8.1,-2,572,62.3,55,517,436,47.5,20,4,416,136,134,14.7,9247
25826,T001038,Total male and female,GM0317,Eemnes,2020JJ00,2020,9247,298,93,10,59,6.3,34,585,62.9,29,556,504,54.2,26,-4,478,81,115,12.4,9362
25827,T001038,Total male and female,GM0317,Eemnes,2021JJ00,2021,9362,302,97,10.3,86,9.1,11,577,61.3,50,527,500,53.2,36,-3,464,77,88,9.4,9450
25828,T001038,Total male and female,GM0317,Eemnes,2022JJ00,2022,9450,304,78,8.2,77,8.1,1,666,69.9,122,544,520,54.6,50,2,470,146,148,15.7,9598
25829,T001038,Total male and female,GM0317,Eemnes,2023JJ00,2023,9598,309,84,8.7,61,6.3,23,607,62.7,59,548,472,48.8,37,1,435,135,157,16.4,9755
25909,T001038,Total male and female,GM1979,Eemsdelta,2021JJ00,2021,45587,170,416,9.1,640,14.1,-224,2059,45.3,291,1768,2034,44.7,193,-27,1841,25,-198,-4.3,45389
25910,T001038,Total male and female,GM1979,Eemsdelta,2022JJ00,2022,45389,169,356,7.8,589,13,-233,2642,58.2,508,2134,2409,53.1,252,-66,2157,233,5,0.1,45394
25911,T001038,Total male and female,GM1979,Eemsdelta,2023JJ00,2023,45394,169,392,8.7,579,12.8,-187,2219,49,330,1889,2323,51.3,213,-33,2110,-104,-288,-6.3,45106
25982,T001038,Total male and female,GM1651,Eemsmond,2012JJ00,2012,16235,86,134,8.3,163,10.1,-29,561,34.7,151,410,684,42.3,110,-19,574,-123,-152,-9.4,16083
25983,T001038,Total male and female,GM1651,Eemsmond,2013JJ00,2013,16083,85,126,7.9,150,9.4,-24,562,35.1,183,379,693,43.3,140,-22,553,-131,-155,-9.6,15928
25984,T001038,Total male and female,GM1651,Eemsmond,2014JJ00,2014,15928,84,129,8.1,140,8.8,-11,468,29.5,46,422,614,38.7,86,-14,528,-146,-158,-9.9,15770
25985,T001038,Total male and female,GM1651,Eemsmond,2015JJ00,2015,15770,83,145,9.2,128,8.1,17,608,38.5,82,526,581,36.8,30,-4,551,27,45,2.9,15815
25986,T001038,Total male and female,GM1651,Eemsmond,2016JJ00,2016,15815,84,120,7.6,164,10.4,-44,596,37.9,106,490,711,45.2,78,-21,633,-115,-159,-10.1,15656
25987,T001038,Total male and female,GM1651,Eemsmond,2017JJ00,2017,15656,83,120,7.7,164,10.5,-44,635,40.7,75,560,694,44.5,64,-16,630,-59,-103,-6.6,15553
25988,T001038,Total male and female,GM1651,Eemsmond,2018JJ00,2018,15553,82,112,7.2,133,8.6,-21,633,40.9,104,529,752,48.6,62,-4,690,-119,-142,-9.1,15411
26146,T001038,Total male and female,GM0770,Eersel,2012JJ00,2012,18166,220,137,7.5,140,7.7,-3,650,35.8,68,582,618,34,52,-4,566,32,30,1.7,18196
26147,T001038,Total male and female,GM0770,Eersel,2013JJ00,2013,18196,221,168,9.2,164,9,4,676,37.2,88,588,693,38.1,55,-8,638,-17,-13,-0.7,18183
26148,T001038,Total male and female,GM0770,Eersel,2014JJ00,2014,18183,221,172,9.4,158,8.7,14,816,44.7,97,719,668,36.6,64,-8,604,148,164,9,18347
26149,T001038,Total male and female,GM0770,Eersel,2015JJ00,2015,18347,222,166,9,166,9,0,922,50,109,813,717,38.9,79,-8,638,205,204,11.1,18551
26150,T001038,Total male and female,GM0770,Eersel,2016JJ00,2016,18551,225,165,8.9,215,11.6,-50,858,46.2,88,770,805,43.4,97,-18,708,53,3,0.2,18554
26151,T001038,Total male and female,GM0770,Eersel,2017JJ00,2017,18554,225,160,8.6,155,8.3,5,969,51.9,116,853,753,40.3,73,-12,680,216,224,12.1,18778
26152,T001038,Total male and female,GM0770,Eersel,2018JJ00,2018,18778,228,178,9.4,156,8.2,22,1115,58.9,119,996,804,42.4,69,-10,735,311,332,17.7,19110
26153,T001038,Total male and female,GM0770,Eersel,2019JJ00,2019,19110,232,156,8.1,167,8.7,-11,940,48.9,109,831,726,37.8,50,-5,676,214,203,10.6,19313
26154,T001038,Total male and female,GM0770,Eersel,2020JJ00,2020,19313,234,167,8.6,203,10.5,-36,1022,52.6,130,892,771,39.7,77,-24,694,251,215,11.1,19528
26155,T001038,Total male and female,GM0770,Eersel,2021JJ00,2021,19528,237,219,11.1,188,9.6,31,1056,53.7,110,946,793,40.3,77,-5,716,263,295,15.1,19823
26156,T001038,Total male and female,GM0770,Eersel,2022JJ00,2022,19823,240,173,8.7,179,9,-6,1025,51.5,270,755,834,41.9,110,-7,724,191,181,9.1,20004
26157,T001038,Total male and female,GM0770,Eersel,2023JJ00,2023,20004,243,193,9.6,208,10.3,-15,1042,51.8,261,781,832,41.4,123,-34,709,210,195,9.7,20199
26802,T001038,Total male and female,GM1903,Eijsden-Margraten,2012JJ00,2012,24994,323,170,6.8,250,10,-80,1136,45.4,134,1002,1000,40,139,-26,861,136,55,2.2,25049
26803,T001038,Total male and female,GM1903,Eijsden-Margraten,2013JJ00,2013,25049,324,188,7.5,204,8.2,-16,1047,41.9,153,894,1099,43.9,124,0,975,-52,-70,-2.8,24979
26804,T001038,Total male and female,GM1903,Eijsden-Margraten,2014JJ00,2014,24979,323,189,7.6,220,8.8,-31,1091,43.7,123,968,1073,43,128,-17,945,18,-12,-0.5,24967
26805,T001038,Total male and female,GM1903,Eijsden-Margraten,2015JJ00,2015,24967,322,200,8,243,9.7,-43,1294,51.7,150,1144,1094,43.7,140,-13,954,200,156,6.2,25123
26806,T001038,Total male and female,GM1903,Eijsden-Margraten,2016JJ00,2016,25123,324,218,8.6,257,10.2,-39,1415,56.1,178,1237,1204,47.8,157,-11,1047,211,174,6.9,25297
26807,T001038,Total male and female,GM1903,Eijsden-Margraten,2017JJ00,2017,25297,327,258,10.1,253,9.9,5,1507,59.3,163,1344,1244,48.9,156,-25,1088,263,269,10.6,25566
26808,T001038,Total male and female,GM1903,Eijsden-Margraten,2018JJ00,2018,25566,329,226,8.8,243,9.5,-17,1384,54,206,1178,1275,49.8,162,-25,1113,109,92,3.6,25658
26809,T001038,Total male and female,GM1903,Eijsden-Margraten,2019JJ00,2019,25658,331,245,9.5,234,9.1,11,1394,54.2,163,1231,1294,50.3,181,-7,1113,100,110,4.3,25768
26810,T001038,Total male and female,GM1903,Eijsden-Margraten,2020JJ00,2020,25768,332,252,9.8,295,11.4,-43,1472,57,145,1327,1295,50.1,139,-1,1156,177,132,5.1,25900
26811,T001038,Total male and female,GM1903,Eijsden-Margraten,2021JJ00,2021,25900,334,249,9.6,267,10.3,-18,1208,46.7,121,1087,1233,47.6,165,-2,1068,-25,-43,-1.7,25857
26812,T001038,Total male and female,GM1903,Eijsden-Margraten,2022JJ00,2022,25857,333,257,9.9,252,9.7,5,1472,56.8,292,1180,1344,51.8,238,-6,1106,128,134,5.2,25991
26813,T001038,Total male and female,GM1903,Eijsden-Margraten,2023JJ00,2023,25991,335,222,8.5,277,10.6,-55,1389,53.4,223,1166,1295,49.8,171,-4,1124,94,43,1.7,26034
26884,T001038,Total male and female,GM0772,Eindhoven,2012JJ00,2012,217225,2476,2350,10.8,1939,8.9,411,13624,62.5,4290,9334,12816,58.8,3645,-995,9171,808,1208,5.6,218433
26885,T001038,Total male and female,GM0772,Eindhoven,2013JJ00,2013,218433,2492,2301,10.5,1905,8.7,396,14983,68.2,4725,10258,12901,58.7,3590,-586,9311,2082,2487,11.4,220920
26886,T001038,Total male and female,GM0772,Eindhoven,2014JJ00,2014,220920,2520,2390,10.8,1880,8.5,510,15686,70.6,4945,10741,13909,62.6,3929,-697,9980,1777,2289,10.4,223209
26887,T001038,Total male and female,GM0772,Eindhoven,2015JJ00,2015,223209,2546,2276,10.2,1997,8.9,279,16756,74.8,6153,10603,15498,69.2,4002,-640,11496,1258,1546,6.9,224755
26888,T001038,Total male and female,GM0772,Eindhoven,2016JJ00,2016,224755,2564,2342,10.4,1952,8.6,390,17886,79.2,6187,11699,16161,71.6,4467,-783,11694,1725,2113,9.4,226868
26889,T001038,Total male and female,GM0772,Eindhoven,2017JJ00,2017,226868,2587,2226,9.8,1975,8.7,251,18918,83,6833,12085,16904,74.1,4200,-580,12704,2014,2258,10,229126
26890,T001038,Total male and female,GM0772,Eindhoven,2018JJ00,2018,229126,2614,2217,9.6,1987,8.6,230,19095,82.9,8021,11074,16795,72.9,4489,-632,12306,2300,2516,11,231642
26891,T001038,Total male and female,GM0772,Eindhoven,2019JJ00,2019,231642,2643,2275,9.8,1993,8.6,282,19533,83.8,8634,10899,17055,73.2,4360,-549,12695,2478,2752,11.9,234394
26892,T001038,Total male and female,GM0772,Eindhoven,2020JJ00,2020,234394,2674,2183,9.3,2232,9.5,-49,18859,80.2,6928,11931,17502,74.5,4155,-391,13347,1357,1297,5.5,235691
26893,T001038,Total male and female,GM0772,Eindhoven,2021JJ00,2021,235691,2689,2410,10.2,2214,9.3,196,20129,84.9,8637,11492,17676,74.6,4043,-354,13633,2453,2635,11.2,238326
26894,T001038,Total male and female,GM0772,Eindhoven,2022JJ00,2022,238326,2708,2212,9.2,2126,8.8,86,23379,97,12470,10909,18042,74.9,4580,-423,13462,5337,5404,22.7,243730
26895,T001038,Total male and female,GM0772,Eindhoven,2023JJ00,2023,243730,2769,2119,8.6,2168,8.8,-49,21648,88.3,10006,11642,18891,77.1,4856,-603,14035,2757,2687,11,246417
26966,T001038,Total male and female,GM0230,Elburg,2012JJ00,2012,22416,351,289,12.9,163,7.3,126,749,33.3,51,698,782,34.8,64,-12,718,-33,94,4.2,22510
26967,T001038,Total male and female,GM0230,Elburg,2013JJ00,2013,22510,353,270,12,172,7.6,98,799,35.4,73,726,763,33.8,49,-13,714,36,135,6,22645
26968,T001038,Total male and female,GM0230,Elburg,2014JJ00,2014,22645,355,304,13.4,187,8.2,117,854,37.5,85,769,774,34,68,-20,706,80,198,8.7,22843
26969,T001038,Total male and female,GM0230,Elburg,2015JJ00,2015,22843,358,267,11.7,178,7.8,89,873,38.1,104,769,875,38.2,69,-28,806,-2,86,3.8,22929
26970,T001038,Total male and female,GM0230,Elburg,2016JJ00,2016,22929,359,275,12,173,7.5,102,921,40.1,52,869,927,40.3,56,-10,871,-6,97,4.2,23026
26971,T001038,Total male and female,GM0230,Elburg,2017JJ00,2017,23026,361,242,10.5,189,8.2,53,1015,44,62,953,988,42.8,57,-10,931,27,81,3.5,23107
26972,T001038,Total male and female,GM0230,Elburg,2018JJ00,2018,23107,362,253,11,192,8.3,61,1023,44.3,73,950,1104,47.8,71,-17,1033,-81,-21,-0.9,23086
26973,T001038,Total male and female,GM0230,Elburg,2019JJ00,2019,23086,362,255,11,212,9.2,43,970,41.9,88,882,940,40.7,53,-7,887,30,75,3.2,23161
26974,T001038,Total male and female,GM0230,Elburg,2020JJ00,2020,23161,363,240,10.3,231,9.9,9,1248,53.6,124,1124,989,42.5,41,2,948,259,268,11.6,23429
26975,T001038,Total male and female,GM0230,Elburg,2021JJ00,2021,23429,367,261,11.1,216,9.2,45,1164,49.4,69,1095,897,38,72,-22,825,267,311,13.3,23740
26976,T001038,Total male and female,GM0230,Elburg,2022JJ00,2022,23740,372,254,10.6,204,8.5,50,1190,49.8,322,868,943,39.5,130,-35,813,247,297,12.5,24037
26977,T001038,Total male and female,GM0230,Elburg,2023JJ00,2023,24037,377,236,9.8,213,8.9,23,886,37,140,746,1039,43.3,137,-28,902,-153,-131,-5.4,23906
27540,T001038,Total male and female,GM0114,Emmen,2012JJ00,2012,108838,324,975,9,1124,10.3,-149,3314,30.5,590,2724,3604,33.2,652,-251,2952,-290,-446,-4.1,108392
27541,T001038,Total male and female,GM0114,Emmen,2013JJ00,2013,108392,323,899,8.3,1118,10.3,-219,3164,29.2,550,2614,3282,30.3,485,-133,2797,-118,-340,-3.1,108052
27542,T001038,Total male and female,GM0114,Emmen,2014JJ00,2014,108052,322,941,8.7,1080,10,-139,3026,28,502,2524,3145,29.1,522,-154,2623,-119,-277,-2.6,107775
27543,T001038,Total male and female,GM0114,Emmen,2015JJ00,2015,107775,321,869,8.1,1092,10.1,-223,3351,31.1,559,2792,3298,30.6,526,-186,2772,53,-191,-1.8,107584
27544,T001038,Total male and female,GM0114,Emmen,2016JJ00,2016,107584,321,922,8.6,1143,10.6,-221,3624,33.7,572,3052,3496,32.5,499,-113,2997,128,-94,-0.9,107490
27545,T001038,Total male and female,GM0114,Emmen,2017JJ00,2017,107490,321,913,8.5,1172,10.9,-259,3681,34.3,472,3209,3709,34.6,397,-82,3312,-28,-298,-2.8,107192
27546,T001038,Total male and female,GM0114,Emmen,2018JJ00,2018,107192,320,825,7.7,1188,11.1,-363,3727,34.8,527,3200,3436,32.1,361,-38,3075,291,-79,-0.7,107113
27547,T001038,Total male and female,GM0114,Emmen,2019JJ00,2019,107113,320,896,8.4,1173,11,-277,3779,35.3,627,3152,3529,33,463,-113,3066,250,-65,-0.6,107048
27548,T001038,Total male and female,GM0114,Emmen,2020JJ00,2020,107048,319,901,8.4,1244,11.6,-343,3630,33.9,408,3222,3280,30.6,369,-64,2911,350,-24,-0.2,107024
27549,T001038,Total male and female,GM0114,Emmen,2021JJ00,2021,107024,319,942,8.8,1339,12.5,-397,4424,41.2,481,3943,3167,29.5,417,-116,2750,1257,832,7.8,107856
27550,T001038,Total male and female,GM0114,Emmen,2022JJ00,2022,107856,322,913,8.4,1394,12.9,-481,4822,44.5,1178,3644,3396,31.4,461,-140,2935,1426,909,8.4,108765
27551,T001038,Total male and female,GM0114,Emmen,2023JJ00,2023,108765,324,896,8.2,1346,12.3,-450,4671,42.8,1142,3529,3600,33,708,-179,2892,1071,581,5.3,109346
27786,T001038,Total male and female,GM0388,Enkhuizen,2012JJ00,2012,18268,1471,197,10.8,155,8.5,42,837,45.8,130,707,834,45.6,101,-2,733,3,47,2.6,18315
27787,T001038,Total male and female,GM0388,Enkhuizen,2013JJ00,2013,18315,1444,190,10.4,180,9.8,10,838,45.7,112,726,788,43,80,-7,708,50,61,3.3,18376
27788,T001038,Total male and female,GM0388,Enkhuizen,2014JJ00,2014,18376,1449,169,9.2,166,9,3,850,46.3,139,711,884,48.1,85,-1,799,-34,-31,-1.7,18345
27789,T001038,Total male and female,GM0388,Enkhuizen,2015JJ00,2015,18345,1447,198,10.8,176,9.6,22,905,49.2,145,760,821,44.6,85,-5,736,84,110,6,18455
27790,T001038,Total male and female,GM0388,Enkhuizen,2016JJ00,2016,18455,1455,181,9.8,158,8.6,23,929,50.3,157,772,929,50.3,115,-20,814,0,24,1.3,18479
27791,T001038,Total male and female,GM0388,Enkhuizen,2017JJ00,2017,18479,1457,186,10.1,153,8.3,33,866,46.9,109,757,902,48.8,119,-4,783,-36,-3,-0.2,18476
27792,T001038,Total male and female,GM0388,Enkhuizen,2018JJ00,2018,18476,1457,163,8.8,186,10.1,-23,916,49.5,145,771,860,46.5,77,-9,783,56,31,1.7,18507
27793,T001038,Total male and female,GM0388,Enkhuizen,2019JJ00,2019,18507,1460,170,9.2,162,8.7,8,993,53.5,173,820,914,49.3,128,-19,786,79,84,4.5,18591
27794,T001038,Total male and female,GM0388,Enkhuizen,2020JJ00,2020,18591,1466,197,10.6,207,11.1,-10,1001,53.8,158,843,945,50.8,117,-17,828,56,46,2.5,18637
27795,T001038,Total male and female,GM0388,Enkhuizen,2021JJ00,2021,18637,1470,177,9.5,197,10.6,-20,955,51.3,130,825,952,51.1,104,-13,848,3,-17,-0.9,18620
27796,T001038,Total male and female,GM0388,Enkhuizen,2022JJ00,2022,18620,1471,174,9.3,189,10.1,-15,1209,64.5,363,846,930,49.6,137,-26,793,279,265,14.2,18885
27797,T001038,Total male and female,GM0388,Enkhuizen,2023JJ00,2023,18885,1492,169,8.9,207,11,-38,1035,54.8,226,809,988,52.3,154,-22,834,47,10,0.5,18895
27868,T001038,Total male and female,GM0153,Enschede,2012JJ00,2012,158048,1121,1633,10.3,1438,9.1,195,7920,50,2361,5559,7527,47.5,2282,-398,5245,393,579,3.7,158627
27869,T001038,Total male and female,GM0153,Enschede,2013JJ00,2013,158627,1125,1610,10.2,1379,8.7,231,7691,48.5,2283,5408,7955,50.2,2486,-482,5469,-264,-41,-0.3,158586
27870,T001038,Total male and female,GM0153,Enschede,2014JJ00,2014,158586,1125,1661,10.5,1381,8.7,280,7898,49.8,2367,5531,8204,51.7,2386,-480,5818,-306,-33,-0.2,158553
27871,T001038,Total male and female,GM0153,Enschede,2015JJ00,2015,158553,1125,1588,10,1479,9.3,109,7844,49.5,2475,5369,8148,51.4,2414,-431,5734,-304,-202,-1.3,158351
27872,T001038,Total male and female,GM0153,Enschede,2016JJ00,2016,158351,1123,1529,9.7,1466,9.3,63,8410,53.1,2609,5801,8674,54.8,2528,-609,6146,-264,-211,-1.3,158140
27873,T001038,Total male and female,GM0153,Enschede,2017JJ00,2017,158140,1122,1449,9.2,1464,9.3,-15,8579,54.2,2969,5610,8440,53.4,2224,-292,6216,139,121,0.8,158261
27874,T001038,Total male and female,GM0153,Enschede,2018JJ00,2018,158261,1124,1401,8.8,1448,9.1,-47,8730,55,3228,5502,7957,50.2,2101,-74,5856,773,725,4.6,158986
27875,T001038,Total male and female,GM0153,Enschede,2019JJ00,2019,158986,1129,1396,8.8,1540,9.7,-144,9601,60.3,3839,5762,8766,55,2705,-614,6061,835,654,4.1,159640
27876,T001038,Total male and female,GM0153,Enschede,2020JJ00,2020,159640,1134,1299,8.1,1631,10.2,-332,8967,56.2,3283,5684,8528,53.4,2392,-432,6136,439,92,0.6,159732
27877,T001038,Total male and female,GM0153,Enschede,2021JJ00,2021,159732,1134,1414,8.8,1623,10.1,-209,9388,58.6,3885,5503,8268,51.6,2255,-382,6013,1120,908,5.7,160640
27878,T001038,Total male and female,GM0153,Enschede,2022JJ00,2022,160640,1141,1293,8,1680,10.4,-387,9927,61.7,4545,5382,8933,55.5,2610,-433,6323,994,595,3.7,161235
27879,T001038,Total male and female,GM0153,Enschede,2023JJ00,2023,161235,1146,1317,8.2,1621,10,-304,10364,64.2,4225,6139,9549,59.1,3048,-731,6501,815,503,3.1,161738
27950,T001038,Total male and female,GM0232,Epe,2012JJ00,2012,32519,208,256,7.9,300,9.2,-44,1000,30.8,134,866,1090,33.6,101,-24,989,-90,-134,-4.1,32385
27951,T001038,Total male and female,GM0232,Epe,2013JJ00,2013,32385,207,281,8.7,305,9.4,-24,1034,31.9,119,915,1049,32.4,85,-5,964,-15,-34,-1,32351
27952,T001038,Total male and female,GM0232,Epe,2014JJ00,2014,32351,207,250,7.7,316,9.8,-66,1055,32.7,103,952,1127,34.9,94,-4,1033,-72,-137,-4.2,32214
27953,T001038,Total male and female,GM0232,Epe,2015JJ00,2015,32214,206,263,8.2,321,10,-58,1211,37.6,134,1077,1085,33.6,104,-7,981,126,68,2.1,32282
27954,T001038,Total male and female,GM0232,Epe,2016JJ00,2016,32282,207,290,8.9,340,10.5,-50,1468,45.3,116,1352,1164,35.9,69,20,1095,304,255,7.9,32537
27955,T001038,Total male and female,GM0232,Epe,2017JJ00,2017,32537,208,286,8.7,344,10.5,-58,1610,49.2,105,1505,1223,37.4,76,-12,1147,387,326,10,32863
27956,T001038,Total male and female,GM0232,Epe,2018JJ00,2018,32863,211,305,9.2,355,10.8,-50,1482,44.9,104,1378,1149,34.8,86,-25,1063,333,282,8.6,33145
27957,T001038,Total male and female,GM0232,Epe,2019JJ00,2019,33145,212,256,7.7,345,10.4,-89,1264,38.1,99,1165,1141,34.4,65,-3,1076,123,33,1,33178
27958,T001038,Total male and female,GM0232,Epe,2020JJ00,2020,33178,213,295,8.9,396,11.9,-101,1386,41.8,126,1260,1265,38.1,60,4,1205,121,20,0.6,33198
27959,T001038,Total male and female,GM0232,Epe,2021JJ00,2021,33198,213,320,9.6,384,11.6,-64,1415,42.6,129,1286,1291,38.9,112,-35,1179,124,59,1.8,33257
27960,T001038,Total male and female,GM0232,Epe,2022JJ00,2022,33257,213,275,8.3,394,11.8,-119,1392,41.8,307,1085,1247,37.5,138,-20,1109,145,26,0.8,33283
27961,T001038,Total male and female,GM0232,Epe,2023JJ00,2023,33283,213,253,7.6,381,11.5,-128,1247,37.5,164,1083,1233,37.1,154,-10,1079,14,-115,-3.5,33168
28032,T001038,Total male and female,GM0233,Ermelo,2012JJ00,2012,26127,305,209,8,233,8.9,-24,1226,46.9,102,1124,1209,46.3,82,5,1127,17,-7,-0.3,26120
28033,T001038,Total male and female,GM0233,Ermelo,2013JJ00,2013,26120,305,220,8.4,268,10.3,-48,1224,46.9,91,1133,1251,48,38,18,1213,-27,-75,-2.9,26045
28034,T001038,Total male and female,GM0233,Ermelo,2014JJ00,2014,26045,304,242,9.3,254,9.7,-12,1410,54,97,1313,1253,48,48,5,1205,157,145,5.6,26190
28035,T001038,Total male and female,GM0233,Ermelo,2015JJ00,2015,26190,306,225,8.5,269,10.2,-44,1603,60.8,122,1481,1240,47.1,81,5,1159,363,317,12.1,26507
28036,T001038,Total male and female,GM0233,Ermelo,2016JJ00,2016,26507,310,227,8.6,263,9.9,-36,1456,54.8,87,1369,1336,50.3,84,-6,1252,120,83,3.1,26590
28037,T001038,Total male and female,GM0233,Ermelo,2017JJ00,2017,26590,311,252,9.4,273,10.2,-21,1527,57.2,132,1395,1304,48.9,89,-15,1215,223,203,7.6,26793
28038,T001038,Total male and female,GM0233,Ermelo,2018JJ00,2018,26793,313,239,8.9,326,12.2,-87,1555,58,164,1391,1406,52.4,57,6,1349,149,65,2.4,26858
28039,T001038,Total male and female,GM0233,Ermelo,2019JJ00,2019,26858,314,267,9.9,298,11.1,-31,1613,59.9,121,1492,1431,53.1,62,12,1369,182,150,5.6,27008
28040,T001038,Total male and female,GM0233,Ermelo,2020JJ00,2020,27008,315,214,7.9,331,12.3,-117,1453,53.8,106,1347,1329,49.2,54,-2,1275,124,8,0.3,27016
28041,T001038,Total male and female,GM0233,Ermelo,2021JJ00,2021,27016,315,245,9,328,12.1,-83,1595,58.8,136,1459,1269,46.8,78,1,1191,326,242,9,27258
28042,T001038,Total male and female,GM0233,Ermelo,2022JJ00,2022,27258,318,224,8.2,339,12.4,-115,1667,60.9,274,1393,1315,48,123,-10,1192,352,238,8.7,27496
28043,T001038,Total male and female,GM0233,Ermelo,2023JJ00,2023,27496,321,249,9,306,11.1,-57,1676,60.6,198,1478,1258,45.5,146,-7,1112,418,360,13.1,27856
28524,T001038,Total male and female,GM0777,Etten-Leur,2012JJ00,2012,42048,760,444,10.5,333,7.9,111,1632,38.7,221,1411,1517,36,245,-33,1272,115,226,5.4,42274
28525,T001038,Total male and female,GM0777,Etten-Leur,2013JJ00,2013,42274,764,391,9.2,336,7.9,55,1541,36.4,235,1306,1518,35.9,182,0,1336,23,83,2,42357
28526,T001038,Total male and female,GM0777,Etten-Leur,2014JJ00,2014,42357,765,441,10.4,313,7.4,128,1687,39.8,283,1404,1670,39.4,238,-49,1432,17,146,3.4,42503
28527,T001038,Total male and female,GM0777,Etten-Leur,2015JJ00,2015,42503,768,409,9.6,364,8.5,45,1946,45.6,285,1661,1661,38.9,232,-26,1429,285,329,7.7,42832
28528,T001038,Total male and female,GM0777,Etten-Leur,2016JJ00,2016,42832,774,432,10.1,384,8.9,48,1910,44.5,266,1644,1765,41.1,253,-30,1512,145,195,4.6,43027
28529,T001038,Total male and female,GM0777,Etten-Leur,2017JJ00,2017,43027,778,421,9.7,363,8.4,58,2255,52.1,236,2019,1810,41.8,180,-13,1630,445,505,11.7,43532
28530,T001038,Total male and female,GM0777,Etten-Leur,2018JJ00,2018,43532,787,427,9.8,371,8.5,56,1949,44.6,273,1676,1763,40.4,207,-29,1556,186,242,5.6,43774
28531,T001038,Total male and female,GM0777,Etten-Leur,2019JJ00,2019,43774,792,432,9.9,396,9,36,1935,44.2,316,1619,1868,42.6,270,-49,1598,67,104,2.4,43878
28532,T001038,Total male and female,GM0777,Etten-Leur,2020JJ00,2020,43878,793,376,8.6,421,9.6,-45,1915,43.6,253,1662,1877,42.8,239,-50,1638,38,-9,-0.2,43869
28533,T001038,Total male and female,GM0777,Etten-Leur,2021JJ00,2021,43869,793,424,9.6,404,9.2,20,1982,45,284,1698,1717,39,225,-36,1492,265,283,6.5,44152
28534,T001038,Total male and female,GM0777,Etten-Leur,2022JJ00,2022,44152,799,406,9.2,444,10,-38,2275,51.3,504,1771,1812,40.8,337,-53,1475,463,426,9.6,44578
28535,T001038,Total male and female,GM0777,Etten-Leur,2023JJ00,2023,44578,806,382,8.5,471,10.5,-89,2586,57.6,459,2127,1838,40.9,402,-59,1436,748,659,14.8,45237
28934,T001038,Total male and female,GM1722,Ferwerderadiel,2012JJ00,2012,8837,90,115,13,74,8.4,41,325,36.7,31,294,346,39.1,16,2,330,-21,19,2.2,8856
28935,T001038,Total male and female,GM1722,Ferwerderadiel,2013JJ00,2013,8856,91,89,10.1,79,9,10,281,31.8,23,258,356,40.3,25,-1,331,-75,-66,-7.5,8790
28936,T001038,Total male and female,GM1722,Ferwerderadiel,2014JJ00,2014,8790,90,87,9.9,59,6.7,28,299,34.1,31,268,379,43.2,25,-7,354,-80,-52,-5.9,8738
28937,T001038,Total male and female,GM1722,Ferwerderadiel,2015JJ00,2015,8738,89,102,11.7,86,9.9,16,333,38.2,16,317,386,44.3,16,-3,370,-53,-37,-4.2,8701
28938,T001038,Total male and female,GM1722,Ferwerderadiel,2016JJ00,2016,8701,89,95,10.9,66,7.6,29,397,45.5,32,365,392,45,24,-3,368,5,34,3.9,8735
28939,T001038,Total male and female,GM1722,Ferwerderadiel,2017JJ00,2017,8735,89,81,9.3,80,9.2,1,383,44,12,371,448,51.5,8,-3,440,-65,-64,-7.3,8671
28940,T001038,Total male and female,GM1722,Ferwerderadiel,2018JJ00,2018,8671,87,88,10.2,85,9.9,3,327,37.9,24,303,424,49.2,14,-5,410,-97,-96,-11.1,8575
29262,T001038,Total male and female,GM0070,Franekeradeel,2012JJ00,2012,20512,200,200,9.8,186,9.1,14,784,38.3,70,714,835,40.7,70,-5,765,-51,-36,-1.8,20476
29263,T001038,Total male and female,GM0070,Franekeradeel,2013JJ00,2013,20476,200,181,8.8,174,8.5,7,827,40.4,103,724,864,42.2,54,3,810,-37,-31,-1.5,20445
29264,T001038,Total male and female,GM0070,Franekeradeel,2014JJ00,2014,20445,199,195,9.6,192,9.4,3,840,41.2,112,728,960,47.1,110,-22,850,-120,-117,-5.7,20328
29265,T001038,Total male and female,GM0070,Franekeradeel,2015JJ00,2015,20328,198,177,8.7,190,9.4,-13,987,48.6,143,844,1037,51.1,113,-14,924,-50,-63,-3.1,20265
29266,T001038,Total male and female,GM0070,Franekeradeel,2016JJ00,2016,20265,198,178,8.8,178,8.8,0,985,48.7,101,884,1036,51.2,77,-5,959,-51,-50,-2.5,20215
29267,T001038,Total male and female,GM0070,Franekeradeel,2017JJ00,2017,20215,197,185,9.2,201,9.9,-16,1031,51,97,934,1011,50,75,-3,936,20,-2,-0.1,20213
29346,T001038,Total male and female,GM1921,De Friese Meren,2014JJ00,2014,51414,146,451,8.8,421,8.2,30,1619,31.6,206,1413,1820,35.5,185,-27,1635,-201,-201,-3.9,51213
29347,T001038,Total male and female,GM1921,De Friese Meren,2015JJ00,2015,51213,146,415,8.1,466,9.1,-51,1759,34.3,138,1621,1662,32.4,124,6,1538,97,52,1,51265
29430,T001038,Total male and female,GM1940,De Fryske Marren,2016JJ00,2016,51265,146,456,8.9,485,9.4,-29,2217,43.1,205,2012,1867,36.3,142,-4,1725,350,320,6.2,51585
29431,T001038,Total male and female,GM1940,De Fryske Marren,2017JJ00,2017,51585,147,438,8.5,451,8.7,-13,2494,48.3,230,2264,2325,45,190,-51,2135,169,157,3,51742
29432,T001038,Total male and female,GM1940,De Fryske Marren,2018JJ00,2018,51742,147,419,8.1,516,10,-97,2002,38.8,281,1721,2219,43,193,-59,2026,-217,-312,-6,51430
29433,T001038,Total male and female,GM1940,De Fryske Marren,2019JJ00,2019,51430,146,482,9.4,468,9.1,14,2126,41.3,244,1882,2008,39,149,-25,1859,118,134,2.6,51564
29434,T001038,Total male and female,GM1940,De Fryske Marren,2020JJ00,2020,51564,147,483,9.3,496,9.6,-13,2221,43,174,2047,1997,38.6,129,-21,1868,224,214,4.2,51778
29435,T001038,Total male and female,GM1940,De Fryske Marren,2021JJ00,2021,51778,147,501,9.7,584,11.3,-83,2333,45.1,183,2150,2431,47,137,-7,2294,-98,-181,-3.5,51597
29436,T001038,Total male and female,GM1940,De Fryske Marren,2022JJ00,2022,51597,147,435,8.4,570,11,-135,2646,51.1,517,2129,2122,41,223,-29,1899,524,395,7.7,51992
29437,T001038,Total male and female,GM1940,De Fryske Marren,2023JJ00,2023,51992,148,417,8,545,10.5,-128,2279,43.9,251,2028,2214,42.6,195,-15,2019,65,-63,-1.2,51929
29590,T001038,Total male and female,GM0653,Gaasterlân-Sleat,2012JJ00,2012,10194,107,107,10.5,113,11.1,-6,312,30.6,27,285,304,29.8,24,-4,280,8,2,0.2,10196
29591,T001038,Total male and female,GM0653,Gaasterlân-Sleat,2013JJ00,2013,10196,107,93,9.1,112,11,-19,325,31.9,22,303,313,30.7,20,0,293,12,-10,-1,10186
29918,T001038,Total male and female,GM0779,Geertruidenberg,2012JJ00,2012,21471,806,232,10.8,199,9.3,33,682,31.7,48,634,673,31.3,51,-10,622,9,42,2,21513
29919,T001038,Total male and female,GM0779,Geertruidenberg,2013JJ00,2013,21513,808,216,10,210,9.7,6,706,32.8,53,653,652,30.3,61,-18,591,54,58,2.7,21571
29920,T001038,Total male and female,GM0779,Geertruidenberg,2014JJ00,2014,21571,810,208,9.6,191,8.9,17,716,33.2,50,666,734,34,76,-23,658,-18,3,0.1,21574
29921,T001038,Total male and female,GM0779,Geertruidenberg,2015JJ00,2015,21574,810,214,9.9,212,9.8,2,832,38.5,66,766,779,36.1,72,-9,707,53,56,2.6,21630
29922,T001038,Total male and female,GM0779,Geertruidenberg,2016JJ00,2016,21630,812,187,8.7,245,11.4,-58,790,36.6,51,739,852,39.5,54,-6,798,-62,-126,-5.8,21504
29923,T001038,Total male and female,GM0779,Geertruidenberg,2017JJ00,2017,21504,807,190,8.8,196,9.1,-6,918,42.7,61,857,899,41.8,43,-3,856,19,13,0.6,21517
29924,T001038,Total male and female,GM0779,Geertruidenberg,2018JJ00,2018,21517,808,215,10,208,9.7,7,790,36.7,67,723,800,37.2,54,-14,746,-10,-2,-0.1,21515
29925,T001038,Total male and female,GM0779,Geertruidenberg,2019JJ00,2019,21515,808,182,8.5,214,9.9,-32,879,40.8,70,809,817,37.9,55,-18,762,62,29,1.3,21544
29926,T001038,Total male and female,GM0779,Geertruidenberg,2020JJ00,2020,21544,809,178,8.2,211,9.7,-33,1095,50.6,65,1030,835,38.6,58,5,777,260,226,10.5,21770
29927,T001038,Total male and female,GM0779,Geertruidenberg,2021JJ00,2021,21770,817,223,10.2,238,10.9,-15,992,45.4,61,931,803,36.7,30,0,773,189,174,8,21944
29928,T001038,Total male and female,GM0779,Geertruidenberg,2022JJ00,2022,21944,825,196,8.9,222,10.1,-26,1034,47,256,778,854,38.8,80,-20,774,180,155,7.1,22099
29929,T001038,Total male and female,GM0779,Geertruidenberg,2023JJ00,2023,22099,831,201,9.1,251,11.4,-50,798,36.1,97,701,786,35.6,98,-16,688,12,-39,-1.8,22060
30164,T001038,Total male and female,GM0236,Geldermalsen,2012JJ00,2012,26334,263,228,8.7,191,7.3,37,791,30.1,99,692,924,35.2,64,-7,860,-133,-94,-3.6,26240
30165,T001038,Total male and female,GM0236,Geldermalsen,2013JJ00,2013,26240,263,256,9.7,178,6.8,78,926,35.2,92,834,944,35.9,81,-10,863,-18,60,2.3,26300
30166,T001038,Total male and female,GM0236,Geldermalsen,2014JJ00,2014,26300,263,231,8.8,195,7.4,36,934,35.5,76,858,950,36.1,73,-3,877,-16,23,0.9,26323
30167,T001038,Total male and female,GM0236,Geldermalsen,2015JJ00,2015,26323,263,243,9.2,197,7.5,46,1020,38.7,119,901,1043,39.6,87,-3,956,-23,23,0.9,26346
30168,T001038,Total male and female,GM0236,Geldermalsen,2016JJ00,2016,26346,264,253,9.6,190,7.2,63,1233,46.6,89,1144,1050,39.7,74,-10,976,183,241,9.1,26587
30169,T001038,Total male and female,GM0236,Geldermalsen,2017JJ00,2017,26587,266,251,9.4,221,8.3,30,1484,55.6,114,1370,1283,48,88,-8,1195,201,231,8.7,26818
30170,T001038,Total male and female,GM0236,Geldermalsen,2018JJ00,2018,26818,269,265,9.8,231,8.6,34,1334,49.5,119,1215,1170,43.5,74,-2,1096,164,218,8.1,27036
30328,T001038,Total male and female,GM1771,Geldrop-Mierlo,2012JJ00,2012,38671,1247,376,9.7,313,8.1,63,1536,39.7,182,1354,1509,39,162,-19,1347,27,97,2.5,38768
30329,T001038,Total male and female,GM1771,Geldrop-Mierlo,2013JJ00,2013,38768,1250,375,9.7,337,8.7,38,1606,41.4,182,1424,1561,40.2,187,-34,1374,45,86,2.2,38854
30330,T001038,Total male and female,GM1771,Geldrop-Mierlo,2014JJ00,2014,38854,1253,365,9.4,359,9.2,6,1792,46.1,172,1620,1771,45.6,231,-61,1540,21,25,0.6,38879
30331,T001038,Total male and female,GM1771,Geldrop-Mierlo,2015JJ00,2015,38879,1254,366,9.4,353,9.1,13,1716,44.1,161,1555,1714,44.1,168,-39,1546,2,14,0.4,38893
30332,T001038,Total male and female,GM1771,Geldrop-Mierlo,2016JJ00,2016,38893,1254,336,8.6,373,9.6,-37,2009,51.5,205,1804,1788,45.9,151,-28,1637,221,185,4.8,39078
30333,T001038,Total male and female,GM1771,Geldrop-Mierlo,2017JJ00,2017,39078,1260,375,9.6,373,9.5,2,2288,58.4,228,2060,2117,54.1,157,-17,1960,171,174,4.5,39252
30334,T001038,Total male and female,GM1771,Geldrop-Mierlo,2018JJ00,2018,39252,1266,368,9.3,370,9.4,-2,2127,54,209,1918,1782,45.2,179,-21,1603,345,343,8.7,39595
30335,T001038,Total male and female,GM1771,Geldrop-Mierlo,2019JJ00,2019,39595,1277,367,9.3,393,9.9,-26,2047,51.6,278,1769,1891,47.7,170,-13,1721,156,131,3.3,39726
30336,T001038,Total male and female,GM1771,Geldrop-Mierlo,2020JJ00,2020,39726,1281,371,9.3,403,10.1,-32,2262,56.7,263,1999,1890,47.4,131,-17,1759,372,340,8.6,40066
30337,T001038,Total male and female,GM1771,Geldrop-Mierlo,2021JJ00,2021,40066,1292,407,10.2,392,9.8,15,2086,52,263,1823,2036,50.8,167,-18,1869,50,65,1.6,40131
30338,T001038,Total male and female,GM1771,Geldrop-Mierlo,2022JJ00,2022,40131,1294,371,9.2,395,9.8,-24,2364,58.7,580,1784,2029,50.4,234,-5,1795,335,310,7.7,40441
30339,T001038,Total male and female,GM1771,Geldrop-Mierlo,2023JJ00,2023,40441,1304,330,8.1,368,9.1,-38,2504,61.7,461,2043,2173,53.5,350,-96,1823,331,292,7.2,40733
30574,T001038,Total male and female,GM1652,Gemert-Bakel,2012JJ00,2012,29041,237,321,11,220,7.6,101,969,33.3,165,804,1012,34.8,138,-48,874,-43,60,2.1,29101
30575,T001038,Total male and female,GM1652,Gemert-Bakel,2013JJ00,2013,29101,238,308,10.5,232,7.9,76,1057,36.2,198,859,918,31.4,87,-14,831,139,214,7.4,29315
30576,T001038,Total male and female,GM1652,Gemert-Bakel,2014JJ00,2014,29315,240,319,10.8,236,8,83,1163,39.5,250,913,1048,35.6,120,-36,928,115,198,6.8,29513
30577,T001038,Total male and female,GM1652,Gemert-Bakel,2015JJ00,2015,29513,241,307,10.4,247,8.4,60,1204,40.7,244,960,1127,38.1,133,-16,994,77,134,4.5,29647
30578,T001038,Total male and female,GM1652,Gemert-Bakel,2016JJ00,2016,29647,243,317,10.6,237,7.9,80,1368,45.9,237,1131,1078,36.1,138,-38,940,290,377,12.7,30024
30579,T001038,Total male and female,GM1652,Gemert-Bakel,2017JJ00,2017,30024,246,303,10,249,8.2,54,1544,51.2,253,1291,1274,42.2,136,-15,1138,270,316,10.5,30340
30580,T001038,Total male and female,GM1652,Gemert-Bakel,2018JJ00,2018,30340,248,290,9.5,254,8.4,36,1303,42.9,228,1075,1231,40.5,177,-54,1054,72,107,3.5,30447
30581,T001038,Total male and female,GM1652,Gemert-Bakel,2019JJ00,2019,30447,249,287,9.4,246,8,41,1377,45,239,1138,1140,37.3,150,-43,990,237,276,9.1,30723
30582,T001038,Total male and female,GM1652,Gemert-Bakel,2020JJ00,2020,30723,252,275,8.9,278,9,-3,1265,41.1,225,1040,1225,39.8,184,-83,1041,40,37,1.2,30760
30583,T001038,Total male and female,GM1652,Gemert-Bakel,2021JJ00,2021,30760,252,352,11.4,272,8.8,80,1406,45.5,219,1187,1207,39.1,172,-54,1035,199,280,9.1,31040
30584,T001038,Total male and female,GM1652,Gemert-Bakel,2022JJ00,2022,31040,254,305,9.8,294,9.4,11,1412,45.2,419,993,1079,34.6,179,-78,900,333,343,11.1,31383
30585,T001038,Total male and female,GM1652,Gemert-Bakel,2023JJ00,2023,31383,257,306,9.7,292,9.3,14,1295,41.2,302,993,1256,40,209,-56,1047,39,52,1.7,31435
30902,T001038,Total male and female,GM0907,Gennep,2012JJ00,2012,17367,364,143,8.2,152,8.8,-9,611,35.2,76,535,651,37.5,54,7,597,-40,-48,-2.8,17319
30903,T001038,Total male and female,GM0907,Gennep,2013JJ00,2013,17319,364,181,10.5,173,10,8,580,33.5,76,504,620,35.8,50,8,570,-40,-33,-1.9,17286
30904,T001038,Total male and female,GM0907,Gennep,2014JJ00,2014,17286,363,139,8,133,7.7,6,588,34,81,507,603,34.9,39,-1,564,-15,-6,-0.3,17280
30905,T001038,Total male and female,GM0907,Gennep,2015JJ00,2015,17280,363,154,9,178,10.4,-24,623,36.3,81,542,792,46.1,55,2,737,-169,-195,-11.3,17085
30906,T001038,Total male and female,GM0907,Gennep,2016JJ00,2016,17085,358,130,7.6,202,11.8,-72,734,42.9,94,640,617,36.1,49,-2,568,117,44,2.6,17129
30907,T001038,Total male and female,GM0907,Gennep,2017JJ00,2017,17129,359,136,8,188,11,-52,751,43.9,69,682,778,45.5,60,-16,718,-27,-77,-4.5,17052
30908,T001038,Total male and female,GM0907,Gennep,2018JJ00,2018,17052,358,164,9.6,204,12,-40,720,42.2,108,612,661,38.7,48,-10,613,59,19,1.1,17071
30909,T001038,Total male and female,GM0907,Gennep,2019JJ00,2019,17071,358,96,5.6,173,10.2,-77,707,41.6,78,629,780,45.9,42,0,738,-73,-150,-8.8,16921
30910,T001038,Total male and female,GM0907,Gennep,2020JJ00,2020,16921,355,122,7.2,200,11.8,-78,890,52.4,170,720,697,41.1,72,-6,625,193,114,6.7,17035
30911,T001038,Total male and female,GM0907,Gennep,2021JJ00,2021,17035,358,119,6.9,196,11.4,-77,889,51.9,145,744,610,35.6,74,-14,536,279,202,11.9,17237
30912,T001038,Total male and female,GM0907,Gennep,2022JJ00,2022,17237,362,149,8.5,223,12.7,-74,1306,74.6,570,736,702,40.1,165,-24,537,604,527,30.6,17764
30913,T001038,Total male and female,GM0907,Gennep,2023JJ00,2023,17764,373,120,6.8,212,11.9,-92,810,45.6,190,620,693,39,123,-29,570,117,25,1.4,17789
31312,T001038,Total male and female,GM0689,Giessenlanden,2012JJ00,2012,14508,228,149,10.3,82,5.7,67,412,28.4,39,373,522,36,43,-11,479,-110,-42,-2.9,14466
31313,T001038,Total male and female,GM0689,Giessenlanden,2013JJ00,2013,14466,227,134,9.3,84,5.8,50,462,32,38,424,534,36.9,38,-3,496,-72,-24,-1.7,14442
31314,T001038,Total male and female,GM0689,Giessenlanden,2014JJ00,2014,14442,227,141,9.8,92,6.4,49,542,37.5,39,503,571,39.5,38,4,533,-29,22,1.5,14464
31315,T001038,Total male and female,GM0689,Giessenlanden,2015JJ00,2015,14464,227,131,9,93,6.4,38,637,43.9,43,594,595,41,31,-2,564,42,80,5.5,14544
31316,T001038,Total male and female,GM0689,Giessenlanden,2016JJ00,2016,14544,229,124,8.5,98,6.7,26,669,45.9,48,621,644,44.2,35,-9,609,25,52,3.6,14596
31317,T001038,Total male and female,GM0689,Giessenlanden,2017JJ00,2017,14596,230,124,8.5,96,6.6,28,674,46.2,70,604,742,50.9,45,-2,697,-68,-45,-3.1,14551
31318,T001038,Total male and female,GM0689,Giessenlanden,2018JJ00,2018,14551,229,124,8.5,92,6.3,32,653,44.9,70,583,701,48.2,58,-13,643,-48,-11,-0.8,14540
31640,T001038,Total male and female,GM0784,Gilze en Rijen,2012JJ00,2012,25589,391,253,9.8,183,7.1,70,1145,44.5,126,1019,949,36.9,113,-37,836,196,269,10.5,25858
31641,T001038,Total male and female,GM0784,Gilze en Rijen,2013JJ00,2013,25858,395,234,9,200,7.7,34,1202,46.3,216,986,1026,39.5,116,-29,910,176,211,8.2,26069
31642,T001038,Total male and female,GM0784,Gilze en Rijen,2014JJ00,2014,26069,398,260,10,214,8.2,46,1123,43.1,221,902,1180,45.3,130,-51,1050,-57,-4,-0.2,26065
31643,T001038,Total male and female,GM0784,Gilze en Rijen,2015JJ00,2015,26065,398,227,8.7,191,7.3,36,1486,56.9,540,946,1436,55,124,-11,1312,50,87,3.3,26152
31644,T001038,Total male and female,GM0784,Gilze en Rijen,2016JJ00,2016,26152,399,249,9.5,244,9.3,5,4322,165.1,2951,1371,4278,163.4,114,-31,4164,44,68,2.6,26220
31645,T001038,Total male and female,GM0784,Gilze en Rijen,2017JJ00,2017,26220,400,265,10.1,218,8.3,47,2179,83,885,1294,2140,81.5,137,-25,2003,39,93,3.5,26313
31646,T001038,Total male and female,GM0784,Gilze en Rijen,2018JJ00,2018,26313,402,248,9.4,227,8.6,21,2276,86.3,1132,1144,2182,82.7,119,-30,2063,94,118,4.5,26431
31647,T001038,Total male and female,GM0784,Gilze en Rijen,2019JJ00,2019,26431,404,246,9.3,210,7.9,36,2183,82.6,1120,1063,2237,84.6,149,-43,2088,-54,0,0,26431
31648,T001038,Total male and female,GM0784,Gilze en Rijen,2020JJ00,2020,26431,404,257,9.7,222,8.4,35,3742,140.8,2026,1716,3509,132,124,-42,3385,233,292,11,26723
31649,T001038,Total male and female,GM0784,Gilze en Rijen,2021JJ00,2021,26723,409,255,9.6,256,9.6,-1,4506,169.1,3085,1421,4697,176.3,204,-76,4493,-191,-166,-6.2,26557
31650,T001038,Total male and female,GM0784,Gilze en Rijen,2022JJ00,2022,26557,406,231,8.7,287,10.8,-56,6091,228.2,4709,1382,5794,217.1,130,-8,5664,297,258,9.7,26815
31651,T001038,Total male and female,GM0784,Gilze en Rijen,2023JJ00,2023,26815,410,254,9.4,231,8.5,23,8030,296.5,6496,1534,7575,279.7,152,-10,7423,455,528,19.7,27343
31722,T001038,Total male and female,GM0511,Goedereede,2012JJ00,2012,11380,160,99,8.7,86,7.6,13,260,22.9,29,231,320,28.2,44,-10,276,-60,-51,-4.5,11329
31805,T001038,Total male and female,GM1924,Goeree-Overflakkee,2013JJ00,2013,48259,185,473,9.8,424,8.8,49,1008,20.9,134,874,1047,21.7,96,-1,951,-39,-14,-0.3,48245
31806,T001038,Total male and female,GM1924,Goeree-Overflakkee,2014JJ00,2014,48245,185,500,10.4,429,8.9,71,1019,21.1,110,909,1130,23.4,135,-24,995,-111,-39,-0.8,48206
31807,T001038,Total male and female,GM1924,Goeree-Overflakkee,2015JJ00,2015,48206,185,436,9,467,9.7,-31,1171,24.3,129,1042,1026,21.3,135,-32,891,145,115,2.4,48321
31808,T001038,Total male and female,GM1924,Goeree-Overflakkee,2016JJ00,2016,48321,184,475,9.8,429,8.8,46,1361,28.1,109,1252,1072,22.1,133,-14,939,289,332,6.9,48653
31809,T001038,Total male and female,GM1924,Goeree-Overflakkee,2017JJ00,2017,48653,186,478,9.8,446,9.1,32,1629,33.3,224,1405,1185,24.2,134,-9,1051,444,476,9.8,49129
31810,T001038,Total male and female,GM1924,Goeree-Overflakkee,2018JJ00,2018,49129,189,424,8.6,473,9.6,-49,1687,34.2,163,1524,1156,23.4,122,-25,1034,531,482,9.8,49611
31811,T001038,Total male and female,GM1924,Goeree-Overflakkee,2019JJ00,2019,49611,190,508,10.2,525,10.5,-17,1761,35.3,183,1578,1305,26.2,129,-9,1176,456,438,8.8,50049
31812,T001038,Total male and female,GM1924,Goeree-Overflakkee,2020JJ00,2020,50049,192,473,9.4,558,11.1,-85,1859,36.9,155,1704,1233,24.5,97,-10,1136,626,540,10.8,50589
31813,T001038,Total male and female,GM1924,Goeree-Overflakkee,2021JJ00,2021,50589,194,502,9.9,535,10.5,-33,1728,34,154,1574,1233,24.3,122,-17,1111,495,462,9.1,51051
31814,T001038,Total male and female,GM1924,Goeree-Overflakkee,2022JJ00,2022,51051,195,469,9.1,575,11.2,-106,1909,37.2,565,1344,1263,24.6,250,-6,1013,646,539,10.6,51590
31815,T001038,Total male and female,GM1924,Goeree-Overflakkee,2023JJ00,2023,51590,197,452,8.7,537,10.4,-85,1824,35.3,279,1545,1460,28.2,225,-17,1235,364,277,5.4,51867
31886,T001038,Total male and female,GM0664,Goes,2012JJ00,2012,36921,398,313,8.5,396,10.7,-83,1974,53.4,508,1466,1844,49.9,166,-34,1678,130,50,1.4,36971
31887,T001038,Total male and female,GM0664,Goes,2013JJ00,2013,36971,399,319,8.6,408,11,-89,1990,53.8,487,1503,1916,51.8,162,-10,1754,74,-17,-0.5,36954
31888,T001038,Total male and female,GM0664,Goes,2014JJ00,2014,36954,399,342,9.2,335,9,7,1908,51.5,308,1600,1715,46.3,201,-48,1514,193,199,5.4,37153
31889,T001038,Total male and female,GM0664,Goes,2015JJ00,2015,37153,401,307,8.3,403,10.8,-96,1937,52.1,306,1631,1791,48.2,199,-45,1592,146,54,1.5,37207
31890,T001038,Total male and female,GM0664,Goes,2016JJ00,2016,37207,402,299,8,396,10.6,-97,2028,54.5,255,1773,1860,49.9,143,-23,1717,168,67,1.8,37274
31891,T001038,Total male and female,GM0664,Goes,2017JJ00,2017,37274,403,336,9,376,10,-40,2274,60.7,232,2042,1876,50.1,152,-26,1724,398,362,9.7,37636
31892,T001038,Total male and female,GM0664,Goes,2018JJ00,2018,37636,407,325,8.6,448,11.9,-123,1963,52.1,240,1723,1824,48.5,199,-88,1625,139,17,0.5,37653
31893,T001038,Total male and female,GM0664,Goes,2019JJ00,2019,37653,407,327,8.6,413,10.9,-86,2332,61.6,279,2053,1814,47.9,166,-18,1648,518,429,11.4,38082
31894,T001038,Total male and female,GM0664,Goes,2020JJ00,2020,38082,411,346,9,441,11.5,-95,2155,56.2,274,1881,1547,40.4,151,-23,1396,608,512,13.4,38594
31895,T001038,Total male and female,GM0664,Goes,2021JJ00,2021,38594,417,350,9,490,12.6,-140,2040,52.6,292,1748,1545,39.8,218,-50,1327,495,356,9.2,38950
31896,T001038,Total male and female,GM0664,Goes,2022JJ00,2022,38950,421,359,9.2,483,12.3,-124,2323,59.3,470,1853,1716,43.8,254,-34,1462,607,483,12.4,39433
31897,T001038,Total male and female,GM0664,Goes,2023JJ00,2023,39433,426,326,8.2,495,12.5,-169,2300,58.1,536,1764,1880,47.5,222,-40,1658,420,249,6.3,39682
31968,T001038,Total male and female,GM0785,Goirle,2012JJ00,2012,22805,542,231,10.1,206,9,25,984,43,83,901,883,38.6,37,10,846,101,128,5.6,22933
31969,T001038,Total male and female,GM0785,Goirle,2013JJ00,2013,22933,545,275,11.9,182,7.9,93,1057,45.9,97,960,985,42.8,47,1,938,72,165,7.2,23098
31970,T001038,Total male and female,GM0785,Goirle,2014JJ00,2014,23098,549,225,9.8,183,7.9,42,913,39.6,98,815,1039,45.1,79,-12,960,-126,-84,-3.6,23014
31971,T001038,Total male and female,GM0785,Goirle,2015JJ00,2015,23014,547,237,10.3,214,9.3,23,1113,48.3,98,1015,1039,45.1,60,-4,979,74,97,4.2,23111
31972,T001038,Total male and female,GM0785,Goirle,2016JJ00,2016,23111,549,227,9.8,197,8.5,30,1185,51,87,1098,1008,43.4,57,-10,951,177,206,8.9,23317
31973,T001038,Total male and female,GM0785,Goirle,2017JJ00,2017,23317,554,211,9,188,8,23,1293,55.2,82,1211,1079,46,55,-1,1024,214,237,10.2,23554
31974,T001038,Total male and female,GM0785,Goirle,2018JJ00,2018,23621,549,213,9,207,8.7,6,1274,53.7,99,1175,1113,46.9,82,-4,1031,161,172,7.3,23793
31975,T001038,Total male and female,GM0785,Goirle,2019JJ00,2019,23793,553,200,8.4,207,8.7,-7,1167,48.9,92,1075,1049,44,67,-7,982,118,111,4.7,23904
31976,T001038,Total male and female,GM0785,Goirle,2020JJ00,2020,23904,556,209,8.7,260,10.9,-51,1271,53.1,123,1148,1170,48.9,67,0,1103,101,48,2,23952
31977,T001038,Total male and female,GM0785,Goirle,2021JJ00,2021,23952,557,207,8.6,238,9.9,-31,1209,50.4,111,1098,1150,48,78,3,1072,59,27,1.1,23979
31978,T001038,Total male and female,GM0785,Goirle,2022JJ00,2022,23979,558,184,7.6,220,9.1,-36,1268,52.7,222,1046,1034,42.9,123,-9,911,234,198,8.3,24177
31979,T001038,Total male and female,GM0785,Goirle,2023JJ00,2023,24177,563,177,7.3,259,10.7,-82,1232,50.8,135,1097,999,41.2,128,-11,871,233,150,6.2,24327
32054,T001038,Total male and female,GM1942,Gooise Meren,2016JJ00,2016,56696,1363,495,8.7,571,10.1,-76,3738,65.8,534,3204,3418,60.2,398,-63,3020,320,239,4.2,56935
32055,T001038,Total male and female,GM1942,Gooise Meren,2017JJ00,2017,56935,1369,488,8.5,531,9.3,-43,3907,68.4,535,3372,3458,60.5,393,-27,3065,449,402,7.1,57337
32056,T001038,Total male and female,GM1942,Gooise Meren,2018JJ00,2018,57337,1379,485,8.4,555,9.6,-70,3890,67.6,603,3287,3441,59.8,382,-49,3059,449,378,6.6,57715
32057,T001038,Total male and female,GM1942,Gooise Meren,2019JJ00,2019,57715,1388,523,9,548,9.5,-25,3928,67.9,670,3258,3562,61.5,424,-39,3138,366,340,5.9,58055
32058,T001038,Total male and female,GM1942,Gooise Meren,2020JJ00,2020,58055,1396,506,8.7,660,11.3,-154,4413,75.7,613,3800,3790,65,380,-49,3410,623,469,8.1,58524
32059,T001038,Total male and female,GM1942,Gooise Meren,2021JJ00,2021,58524,1407,607,10.3,619,10.5,-12,4247,72.4,609,3638,3911,66.6,449,-59,3462,336,322,5.5,58846
32060,T001038,Total male and female,GM1942,Gooise Meren,2022JJ00,2022,58846,1419,519,8.7,624,10.5,-105,5232,87.8,1232,4000,3627,60.9,512,-52,3115,1605,1495,25.4,60341
32061,T001038,Total male and female,GM1942,Gooise Meren,2023JJ00,2023,60341,1456,532,8.8,679,11.3,-147,4324,71.6,850,3474,4167,69,624,-70,3543,157,29,0.5,60370
32214,T001038,Total male and female,GM0512,Gorinchem,2012JJ00,2012,35083,1854,398,11.3,271,7.7,127,1284,36.6,169,1115,1365,38.9,211,-20,1154,-81,45,1.3,35128
32215,T001038,Total male and female,GM0512,Gorinchem,2013JJ00,2013,35128,1861,362,10.3,297,8.4,65,1357,38.6,235,1122,1312,37.3,224,-39,1088,45,114,3.2,35242
32216,T001038,Total male and female,GM0512,Gorinchem,2014JJ00,2014,35242,1867,392,11.1,307,8.7,85,1479,41.9,205,1274,1467,41.6,246,-49,1221,12,96,2.7,35338
32217,T001038,Total male and female,GM0512,Gorinchem,2015JJ00,2015,35338,1872,339,9.6,361,10.2,-22,1589,45,248,1341,1645,46.6,236,-78,1409,-56,-78,-2.2,35260
32218,T001038,Total male and female,GM0512,Gorinchem,2016JJ00,2016,35260,1869,373,10.5,313,8.8,60,2203,62,321,1882,1767,49.8,211,-17,1556,436,495,14,35755
32219,T001038,Total male and female,GM0512,Gorinchem,2017JJ00,2017,35755,1895,393,10.9,320,8.9,73,2437,67.7,326,2111,1979,54.9,166,-29,1813,458,529,14.8,36284
32220,T001038,Total male and female,GM0512,Gorinchem,2018JJ00,2018,36284,1927,392,10.7,330,9,62,1936,53.1,294,1642,1600,43.9,165,2,1435,336,398,11,36682
32221,T001038,Total male and female,GM0512,Gorinchem,2019JJ00,2019,36682,1948,356,9.7,339,9.2,17,1999,54.2,333,1666,1675,45.5,213,-34,1462,324,340,9.3,37022
32222,T001038,Total male and female,GM0512,Gorinchem,2020JJ00,2020,37022,1966,401,10.8,335,9,66,1985,53.3,292,1693,1662,44.7,218,-44,1444,323,388,10.5,37410
32223,T001038,Total male and female,GM0512,Gorinchem,2021JJ00,2021,37410,1987,395,10.5,382,10.2,13,1999,53.3,294,1705,1787,47.6,209,-49,1578,212,222,5.9,37632
32224,T001038,Total male and female,GM0512,Gorinchem,2022JJ00,2022,37632,2011,375,9.9,323,8.5,52,2868,75.4,578,2290,2090,54.9,211,-31,1879,778,829,22,38461
32225,T001038,Total male and female,GM0512,Gorinchem,2023JJ00,2023,38461,2056,377,9.8,380,9.9,-3,2477,64.2,342,2135,2262,58.7,242,-69,2020,215,210,5.5,38671
32378,T001038,Total male and female,GM0513,Gouda,2012JJ00,2012,71235,4225,848,11.9,640,9,208,2406,33.9,330,2076,2947,41.5,384,-91,2563,-541,-331,-4.6,70904
32379,T001038,Total male and female,GM0513,Gouda,2013JJ00,2013,70904,4210,845,11.9,605,8.5,240,2710,38.2,434,2276,2912,41.1,338,-38,2574,-202,37,0.5,70941
32380,T001038,Total male and female,GM0513,Gouda,2014JJ00,2014,70941,4213,832,11.7,630,8.9,202,2855,40.2,419,2436,2893,40.7,329,-19,2564,-38,164,2.3,71105
32381,T001038,Total male and female,GM0513,Gouda,2015JJ00,2015,71105,4222,794,11.2,643,9,151,3074,43.2,474,2600,3145,44.2,384,-73,2761,-71,84,1.2,71189
32382,T001038,Total male and female,GM0513,Gouda,2016JJ00,2016,71189,4232,774,10.8,629,8.8,145,3968,55.5,1010,2958,3545,49.6,703,-132,2842,423,563,7.9,71752
32383,T001038,Total male and female,GM0513,Gouda,2017JJ00,2017,71752,4266,788,10.9,708,9.8,80,4738,65.6,946,3792,3865,53.5,831,-277,3034,873,948,13.2,72700
32384,T001038,Total male and female,GM0513,Gouda,2018JJ00,2018,72700,4406,767,10.5,648,8.9,119,4293,58.9,862,3431,3934,53.9,756,-246,3178,359,481,6.6,73181
32385,T001038,Total male and female,GM0513,Gouda,2019JJ00,2019,73181,4435,798,10.9,696,9.5,102,3886,53,823,3063,3731,50.9,675,-62,3056,155,246,3.4,73427
32386,T001038,Total male and female,GM0513,Gouda,2020JJ00,2020,73427,4450,756,10.3,780,10.6,-24,4161,56.6,740,3421,3881,52.8,496,-48,3385,280,254,3.5,73681
32387,T001038,Total male and female,GM0513,Gouda,2021JJ00,2021,73681,4466,814,11,727,9.8,87,3986,53.9,653,3333,3655,49.5,458,-147,3197,331,414,5.6,74095
32388,T001038,Total male and female,GM0513,Gouda,2022JJ00,2022,74095,4491,829,11.1,761,10.2,68,4890,65.5,1172,3718,3732,50,604,-242,3128,1158,1221,16.5,75316
32389,T001038,Total male and female,GM0513,Gouda,2023JJ00,2023,75316,4565,806,10.7,766,10.1,40,4408,58.4,775,3633,4002,53,703,-279,3299,406,442,5.9,75758
32706,T001038,Total male and female,GM0693,Graafstroom,2012JJ00,2012,9795,146,128,13,67,6.8,61,385,39.1,17,368,339,34.4,39,-8,300,46,99,10.1,9894
32952,T001038,Total male and female,GM0365,Graft-De Rijp,2012JJ00,2012,6436,321,42,6.5,44,6.8,-2,221,34.4,23,198,226,35.1,19,0,207,-5,-7,-1.1,6429
32953,T001038,Total male and female,GM0365,Graft-De Rijp,2013JJ00,2013,6429,322,51,7.9,51,7.9,0,233,36.2,31,202,211,32.8,14,5,197,22,23,3.6,6452
32954,T001038,Total male and female,GM0365,Graft-De Rijp,2014JJ00,2014,6452,324,50,7.8,49,7.6,1,255,39.7,24,231,301,46.8,44,-4,257,-46,-46,-7.1,6406
33198,T001038,Total male and female,GM0786,Grave,2012JJ00,2012,12799,471,130,10.2,95,7.4,35,870,68.2,227,643,979,76.7,39,-7,940,-109,-68,-5.3,12731
33199,T001038,Total male and female,GM0786,Grave,2013JJ00,2013,12731,468,113,8.9,116,9.1,-3,1045,82.2,476,569,1079,84.9,38,-5,1041,-34,-36,-2.8,12695
33200,T001038,Total male and female,GM0786,Grave,2014JJ00,2014,12695,467,117,9.2,88,6.9,29,1164,91.2,598,566,1049,82.2,38,8,1011,115,145,11.4,12840
33201,T001038,Total male and female,GM0786,Grave,2015JJ00,2015,12840,472,111,8.7,125,9.8,-14,1030,80.8,476,554,1215,95.4,69,-37,1146,-185,-197,-15.3,12643
33202,T001038,Total male and female,GM0786,Grave,2016JJ00,2016,12643,465,104,8.3,115,9.2,-11,1085,86.8,281,804,1348,107.8,251,-210,1097,-263,-273,-21.6,12370
33203,T001038,Total male and female,GM0786,Grave,2017JJ00,2017,12370,455,104,8.4,123,9.9,-19,1083,87.4,112,971,1016,82,14,15,1002,67,49,4,12419
33204,T001038,Total male and female,GM0786,Grave,2018JJ00,2018,12419,457,97,7.8,119,9.6,-22,1021,82,96,925,937,75.3,16,12,921,84,64,5.2,12483
33205,T001038,Total male and female,GM0786,Grave,2019JJ00,2019,12483,459,104,8.3,124,10,-20,880,70.6,103,777,908,72.9,52,-27,856,-28,-47,-3.8,12436
33206,T001038,Total male and female,GM0786,Grave,2020JJ00,2020,12436,458,102,8.2,167,13.4,-65,1077,86.4,79,998,962,77.2,52,-12,910,115,50,4,12486
33207,T001038,Total male and female,GM0786,Grave,2021JJ00,2021,12486,459,97,7.8,150,12,-53,1146,91.9,59,1087,1113,89.2,16,5,1097,33,-24,-1.9,12462
33444,T001038,Total male and female,GM0518,The Hague,2012JJ00,2012,502055,6132,6922,13.7,4180,8.3,2742,30698,60.9,13160,17538,29666,58.9,11293,-3275,18373,1032,3801,7.6,505856
33445,T001038,Total male and female,GM0518,The Hague,2013JJ00,2013,505856,6179,6591,13,4027,7.9,2564,32375,63.8,14180,18195,31893,62.9,13591,-5002,18302,482,3084,6.1,508940
33446,T001038,Total male and female,GM0518,The Hague,2014JJ00,2014,508940,6216,6903,13.5,4079,8,2824,33725,65.9,14800,18925,30450,59.5,10916,-2574,19534,3275,5921,11.6,514861
33447,T001038,Total male and female,GM0518,The Hague,2015JJ00,2015,514861,6289,6781,13.1,4270,8.3,2511,34059,65.8,14500,19559,31200,60.3,10517,-1589,20683,2859,5127,10,519988
33448,T001038,Total male and female,GM0518,The Hague,2016JJ00,2016,519988,6288,6809,13,4271,8.2,2538,36324,69.5,15515,20809,33853,64.8,11795,-2946,22058,2471,4894,9.4,524882
33449,T001038,Total male and female,GM0518,The Hague,2017JJ00,2017,524882,6348,6587,12.5,4156,7.9,2431,38612,73,17242,21370,33248,62.9,10727,-1898,22521,5364,7679,14.6,532561
33450,T001038,Total male and female,GM0518,The Hague,2018JJ00,2018,532561,6459,6556,12.2,4228,7.9,2328,37518,70.1,17485,20033,34226,64,11445,-2409,22781,3292,5272,9.9,537833
33451,T001038,Total male and female,GM0518,The Hague,2019JJ00,2019,537833,6523,6430,11.9,4091,7.6,2339,40256,74.3,20003,20253,34553,63.8,10623,-1232,23930,5703,8005,14.9,545838
33452,T001038,Total male and female,GM0518,The Hague,2020JJ00,2020,545838,6620,6129,11.2,4539,8.3,1590,38142,69.7,16214,21928,37170,67.9,12268,-2823,24902,972,2482,4.5,548320
33453,T001038,Total male and female,GM0518,The Hague,2021JJ00,2021,548320,6650,6101,11.1,4557,8.3,1544,39436,71.6,17820,21616,35830,65,9226,-452,26604,3606,5097,9.3,553417
33454,T001038,Total male and female,GM0518,The Hague,2022JJ00,2022,553417,6711,5701,10.2,4614,8.3,1087,46541,83.4,24607,21934,38139,68.3,12169,-1797,25970,8402,9422,17,562839
33455,T001038,Total male and female,GM0518,The Hague,2023JJ00,2023,562839,6827,5689,10.1,4418,7.8,1271,42963,76.1,21038,21925,40771,72.2,13623,-2346,27148,2192,3382,6,566221
34182,T001038,Total male and female,GM0241,Groesbeek,2012JJ00,2012,18884,428,138,7.3,260,13.7,-122,1000,52.8,97,903,755,39.8,86,-3,669,245,125,6.6,19009
34183,T001038,Total male and female,GM0241,Groesbeek,2013JJ00,2013,19009,431,136,7.2,283,14.9,-147,985,51.9,127,858,872,45.9,77,2,795,113,-32,-1.7,18977
34184,T001038,Total male and female,GM0241,Groesbeek,2014JJ00,2014,18977,430,175,9.2,268,14.1,-93,941,49.6,98,843,865,45.6,93,-7,772,76,-14,-0.7,18963
34185,T001038,Total male and female,GM0241,Groesbeek,2015JJ00,2015,34258,396,263,7.6,396,11.5,-133,1785,51.9,216,1569,1326,38.5,128,1,1198,459,316,9.2,34574
34264,T001038,Total male and female,GM0014,Groningen Municipality,2012JJ00,2012,193127,2474,2059,10.6,1382,7.1,677,18274,94.1,4477,13797,16663,85.8,3817,-698,12846,1611,2291,11.9,195418
34265,T001038,Total male and female,GM0014,Groningen Municipality,2013JJ00,2013,195418,2497,2006,10.2,1309,6.6,697,19024,96.6,4472,14552,16826,85.5,3700,-791,13126,2198,2899,14.8,198317
34266,T001038,Total male and female,GM0014,Groningen Municipality,2014JJ00,2014,198317,2534,2042,10.2,1363,6.8,679,19758,99.1,4877,14881,18420,92.4,4456,-1125,13964,1338,2019,10.2,200336
34267,T001038,Total male and female,GM0014,Groningen Municipality,2015JJ00,2015,200336,2560,2051,10.2,1336,6.7,715,18959,94.5,4744,14215,19065,95,4249,-941,14816,-106,616,3.1,200952
34268,T001038,Total male and female,GM0014,Groningen Municipality,2016JJ00,2016,200952,2549,1991,9.9,1319,6.6,672,20522,102,5812,14710,20533,102,4632,-1090,15901,-11,651,3.2,201603
34269,T001038,Total male and female,GM0014,Groningen Municipality,2017JJ00,2017,202636,2125,1944,9.6,1397,6.9,547,20304,100.2,5959,14345,20667,101.9,4782,-1102,15885,-363,174,0.9,202810
34270,T001038,Total male and female,GM0014,Groningen Municipality,2018JJ00,2018,202810,2137,1812,8.9,1345,6.6,467,20114,98.9,6579,13535,19577,96.3,4511,-653,15066,537,1009,5,203819
34271,T001038,Total male and female,GM0014,Groningen Municipality,2019JJ00,2019,231299,1246,2036,8.8,1706,7.4,330,20900,90.1,7355,13545,19642,84.6,5122,-829,14520,1258,1575,6.8,232874
34272,T001038,Total male and female,GM0014,Groningen Municipality,2020JJ00,2020,232874,1255,2078,8.9,1805,7.7,273,19791,84.9,6050,13741,19656,84.3,5413,-899,14243,135,399,1.7,233273
34273,T001038,Total male and female,GM0014,Groningen Municipality,2021JJ00,2021,233273,1257,2233,9.5,1846,7.9,387,20265,86.6,7372,12893,18954,81,4581,-525,14373,1311,1677,7.2,234950
34274,T001038,Total male and female,GM0014,Groningen Municipality,2022JJ00,2022,234950,1266,1987,8.4,1930,8.2,57,21803,92.2,9235,12568,18649,78.8,4860,-313,13789,3154,3197,13.6,238147
34275,T001038,Total male and female,GM0014,Groningen Municipality,2023JJ00,2023,238147,1284,1859,7.7,1882,7.8,-23,24725,102.6,7885,16840,19060,79.1,5376,-359,13684,5665,5621,23.6,243768
34592,T001038,Total male and female,GM0015,Grootegast,2012JJ00,2012,12275,141,140,11.4,109,8.9,31,375,30.6,16,359,460,37.6,18,8,442,-85,-53,-4.3,12222
34593,T001038,Total male and female,GM0015,Grootegast,2013JJ00,2013,12222,141,105,8.6,96,7.9,9,389,31.9,32,357,455,37.3,22,-4,433,-66,-57,-4.7,12165
34594,T001038,Total male and female,GM0015,Grootegast,2014JJ00,2014,12165,140,108,8.9,86,7.1,22,467,38.5,22,445,533,43.9,28,-9,505,-66,-42,-3.5,12123
34595,T001038,Total male and female,GM0015,Grootegast,2015JJ00,2015,12123,140,127,10.5,93,7.7,34,572,47.1,30,542,575,47.4,32,-1,543,-3,32,2.6,12155
34596,T001038,Total male and female,GM0015,Grootegast,2016JJ00,2016,12155,140,108,8.9,90,7.4,18,555,45.6,26,529,562,46.2,17,1,545,-7,11,0.9,12166
34597,T001038,Total male and female,GM0015,Grootegast,2017JJ00,2017,12166,140,122,10,98,8.1,24,555,45.7,18,537,602,49.5,14,2,588,-47,-23,-1.9,12143
34598,T001038,Total male and female,GM0015,Grootegast,2018JJ00,2018,12143,140,112,9.2,105,8.6,7,590,48.5,28,562,566,46.5,17,3,549,24,48,4,12191
34838,T001038,Total male and female,GM1729,Gulpen-Wittem,2012JJ00,2012,14479,198,82,5.7,149,10.3,-67,636,44,86,550,603,41.7,64,-2,539,33,-35,-2.4,14444
34839,T001038,Total male and female,GM1729,Gulpen-Wittem,2013JJ00,2013,14444,197,90,6.2,150,10.4,-60,660,45.6,82,578,561,38.8,68,-10,493,99,40,2.8,14484
34840,T001038,Total male and female,GM1729,Gulpen-Wittem,2014JJ00,2014,14484,198,94,6.5,147,10.1,-53,627,43.3,95,532,562,38.8,62,-9,500,65,13,0.9,14497
34841,T001038,Total male and female,GM1729,Gulpen-Wittem,2015JJ00,2015,14497,198,78,5.4,158,10.9,-80,1051,72.5,419,632,959,66.1,68,-9,891,92,11,0.8,14508
34842,T001038,Total male and female,GM1729,Gulpen-Wittem,2016JJ00,2016,14508,198,114,7.9,178,12.3,-64,1050,72.8,237,813,1158,80.3,70,-5,1088,-108,-171,-11.8,14337
34843,T001038,Total male and female,GM1729,Gulpen-Wittem,2017JJ00,2017,14337,196,107,7.5,187,13.1,-80,654,45.8,88,566,707,49.6,61,-9,646,-53,-141,-9.8,14196
34844,T001038,Total male and female,GM1729,Gulpen-Wittem,2018JJ00,2018,14196,194,96,6.8,183,12.9,-87,766,53.9,76,690,627,44.1,65,-8,562,139,50,3.5,14246
34845,T001038,Total male and female,GM1729,Gulpen-Wittem,2019JJ00,2019,14246,195,106,7.5,160,11.3,-54,648,45.6,67,581,668,47,80,-16,588,-20,-75,-5.3,14171
34846,T001038,Total male and female,GM1729,Gulpen-Wittem,2020JJ00,2020,14171,194,102,7.2,213,15,-111,723,51,86,637,577,40.7,48,-12,529,146,35,2.5,14206
34847,T001038,Total male and female,GM1729,Gulpen-Wittem,2021JJ00,2021,14206,194,101,7.1,183,12.9,-82,686,48.3,83,603,632,44.5,65,-8,567,54,-28,-2,14178
34848,T001038,Total male and female,GM1729,Gulpen-Wittem,2022JJ00,2022,14178,194,94,6.6,185,13,-91,830,58.5,187,643,706,49.7,97,-27,609,124,32,2.3,14210
34849,T001038,Total male and female,GM1729,Gulpen-Wittem,2023JJ00,2023,14210,194,101,7.1,186,13.2,-85,613,43.4,70,543,681,48.2,95,-19,586,-68,-156,-11,14054
35002,T001038,Total male and female,GM0158,Haaksbergen,2012JJ00,2012,24419,233,187,7.7,225,9.2,-38,658,27,51,607,717,29.4,41,8,676,-59,-97,-4,24322
35003,T001038,Total male and female,GM0158,Haaksbergen,2013JJ00,2013,24322,232,194,8,209,8.6,-15,709,29.1,44,665,673,27.7,29,17,644,36,22,0.9,24344
35004,T001038,Total male and female,GM0158,Haaksbergen,2014JJ00,2014,24344,232,199,8.2,253,10.4,-54,762,31.3,49,713,745,30.6,61,13,684,17,-37,-1.5,24307
35005,T001038,Total male and female,GM0158,Haaksbergen,2015JJ00,2015,24307,232,200,8.2,241,9.9,-41,794,32.6,85,709,729,30,66,7,663,65,25,1,24332
35006,T001038,Total male and female,GM0158,Haaksbergen,2016JJ00,2016,24332,232,184,7.6,279,11.5,-95,832,34.2,71,761,798,32.8,54,14,744,34,-60,-2.5,24272
35007,T001038,Total male and female,GM0158,Haaksbergen,2017JJ00,2017,24272,232,198,8.2,238,9.8,-40,868,35.7,54,814,810,33.4,34,7,776,58,19,0.8,24291
35008,T001038,Total male and female,GM0158,Haaksbergen,2018JJ00,2018,24291,232,185,7.6,231,9.5,-46,839,34.5,74,765,806,33.2,59,2,747,33,-14,-0.6,24277
35009,T001038,Total male and female,GM0158,Haaksbergen,2019JJ00,2019,24277,232,187,7.7,243,10,-56,813,33.5,85,728,723,29.8,33,8,690,90,34,1.4,24311
35010,T001038,Total male and female,GM0158,Haaksbergen,2020JJ00,2020,24311,232,201,8.3,285,11.7,-84,835,34.4,55,780,832,34.3,35,5,797,3,-82,-3.4,24229
35011,T001038,Total male and female,GM0158,Haaksbergen,2021JJ00,2021,24229,231,233,9.6,294,12.1,-61,858,35.4,92,766,757,31.2,63,8,694,101,39,1.6,24268
35012,T001038,Total male and female,GM0158,Haaksbergen,2022JJ00,2022,24268,232,195,8,302,12.4,-107,1086,44.5,261,825,743,30.5,70,0,673,343,234,9.6,24502
35013,T001038,Total male and female,GM0158,Haaksbergen,2023JJ00,2023,24502,234,188,7.7,303,12.4,-115,886,36.3,148,738,915,37.5,95,5,820,-29,-143,-5.8,24359
35166,T001038,Total male and female,GM0788,Haaren,2012JJ00,2012,13621,236,97,7.1,112,8.2,-15,599,44.1,46,553,630,46.3,61,-16,569,-31,-49,-3.6,13572
35167,T001038,Total male and female,GM0788,Haaren,2013JJ00,2013,13572,235,79,5.8,108,8,-29,585,43.1,58,527,535,39.4,27,2,508,50,15,1.1,13587
35168,T001038,Total male and female,GM0788,Haaren,2014JJ00,2014,13587,235,74,5.5,83,6.1,-9,597,44,48,549,655,48.3,58,-7,597,-58,-64,-4.7,13523
35169,T001038,Total male and female,GM0788,Haaren,2015JJ00,2015,13523,234,75,5.5,98,7.2,-23,715,52.8,30,685,644,47.5,30,-2,614,71,47,3.5,13570
35170,T001038,Total male and female,GM0788,Haaren,2016JJ00,2016,13570,235,88,6.4,109,7.9,-21,1075,78.2,122,953,710,51.7,77,-5,633,365,342,25.2,13912
35171,T001038,Total male and female,GM0788,Haaren,2017JJ00,2017,13912,241,111,7.9,118,8.4,-7,972,69.4,112,860,771,55,110,-6,661,201,191,13.7,14103
35172,T001038,Total male and female,GM0788,Haaren,2018JJ00,2018,14103,244,121,8.6,132,9.3,-11,778,55,86,692,676,47.8,39,-5,637,102,92,6.5,14195
35173,T001038,Total male and female,GM0788,Haaren,2019JJ00,2019,14195,246,109,7.6,127,8.9,-18,817,57.2,73,744,625,43.8,64,-2,561,192,175,12.3,14370
35174,T001038,Total male and female,GM0788,Haaren,2020JJ00,2020,14370,249,131,9.1,143,10,-12,679,47.3,50,629,714,49.8,28,-1,686,-35,-52,-3.6,14318
35248,T001038,Total male and female,GM0392,Haarlem,2012JJ00,2012,151818,5196,1924,12.6,1455,9.5,469,8222,53.9,1567,6655,7415,48.6,1327,-344,6088,807,1275,8.4,153093
35249,T001038,Total male and female,GM0392,Haarlem,2013JJ00,2013,153093,5239,1872,12.1,1408,9.1,464,8732,56.7,1538,7194,7142,46.3,1149,-93,5993,1590,2054,13.4,155147
35250,T001038,Total male and female,GM0392,Haarlem,2014JJ00,2014,155147,5310,1959,12.6,1362,8.7,597,9450,60.6,1578,7872,8548,54.8,1624,-481,6924,902,1498,9.7,156645
35251,T001038,Total male and female,GM0392,Haarlem,2015JJ00,2015,156645,5361,1902,12.1,1513,9.6,389,10080,64,1645,8435,8959,56.9,1325,-133,7634,1121,1495,9.5,158140
35252,T001038,Total male and female,GM0392,Haarlem,2016JJ00,2016,158140,5421,1823,11.5,1473,9.3,350,10729,67.6,2118,8611,9980,62.9,1434,-142,8546,749,1089,6.9,159229
35253,T001038,Total male and female,GM0392,Haarlem,2017JJ00,2017,159229,5459,1835,11.5,1475,9.2,360,10596,66.4,2028,8568,10472,65.7,1578,-249,8894,124,480,3,159709
35254,T001038,Total male and female,GM0392,Haarlem,2018JJ00,2018,159709,5475,1833,11.4,1482,9.2,351,10782,67.2,2263,8519,9573,59.6,1462,-100,8111,1209,1556,9.7,161265
35255,T001038,Total male and female,GM0392,Haarlem,2019JJ00,2019,161265,5528,1900,11.7,1406,8.7,494,11491,70.9,2665,8826,10343,63.8,1558,-207,8785,1148,1637,10.2,162902
35256,T001038,Total male and female,GM0392,Haarlem,2020JJ00,2020,162902,5585,1834,11.3,1511,9.3,323,10741,66,2125,8616,11412,70.1,1513,-203,9899,-671,-359,-2.2,162543
35257,T001038,Total male and female,GM0392,Haarlem,2021JJ00,2021,162543,5572,1925,11.8,1524,9.4,401,11080,68.1,2089,8991,11114,68.3,1548,-210,9566,-34,355,2.2,162898
35258,T001038,Total male and female,GM0392,Haarlem,2022JJ00,2022,162898,5577,1806,11,1586,9.7,220,12980,79.1,3614,9366,10694,65.1,1724,-201,8970,2286,2498,15.3,165396
35259,T001038,Total male and female,GM0392,Haarlem,2023JJ00,2023,165396,5662,1705,10.2,1507,9.1,198,12914,77.6,2814,10100,10863,65.2,1890,-239,8973,2051,2240,13.5,167636
35330,T001038,Total male and female,GM0393,Haarlemmerliede en Spaarnwoude,2012JJ00,2012,5474,285,53,9.6,26,4.7,27,339,61.6,36,303,314,57.1,25,0,289,25,52,9.5,5526
35331,T001038,Total male and female,GM0393,Haarlemmerliede en Spaarnwoude,2013JJ00,2013,5526,287,42,7.6,37,6.7,5,301,54.4,29,272,296,53.5,25,2,271,5,9,1.6,5535
35332,T001038,Total male and female,GM0393,Haarlemmerliede en Spaarnwoude,2014JJ00,2014,5535,287,36,6.5,25,4.5,11,360,64.8,28,332,332,59.8,26,-7,306,28,39,7,5574
35333,T001038,Total male and female,GM0393,Haarlemmerliede en Spaarnwoude,2015JJ00,2015,5574,289,46,8.2,31,5.6,15,315,56.5,20,295,326,58.5,34,-12,292,-11,4,0.7,5578
35334,T001038,Total male and female,GM0393,Haarlemmerliede en Spaarnwoude,2016JJ00,2016,5578,290,47,8.4,38,6.8,9,450,80,27,423,372,66.2,30,-11,342,78,87,15.6,5665
35335,T001038,Total male and female,GM0393,Haarlemmerliede en Spaarnwoude,2017JJ00,2017,5665,295,56,9.7,27,4.7,29,536,93,30,506,362,62.8,21,-4,341,174,202,35.7,5867
35336,T001038,Total male and female,GM0393,Haarlemmerliede en Spaarnwoude,2018JJ00,2018,5867,305,66,11,24,4,42,628,104.4,144,484,369,61.3,31,-1,338,259,300,51.1,6167
35412,T001038,Total male and female,GM0394,Haarlemmermeer,2012JJ00,2012,143943,806,1419,9.9,825,5.7,594,5474,38,1239,4235,5860,40.7,983,-121,4877,-386,210,1.5,144153
35413,T001038,Total male and female,GM0394,Haarlemmermeer,2013JJ00,2013,144153,807,1390,9.6,853,5.9,537,5467,37.9,1351,4116,5928,41.1,957,-82,4971,-461,78,0.5,144231
35414,T001038,Total male and female,GM0394,Haarlemmermeer,2014JJ00,2014,144061,806,1257,8.7,906,6.3,351,6889,47.8,2234,4655,7148,49.6,994,-164,6154,-259,91,0.6,144152
35415,T001038,Total male and female,GM0394,Haarlemmermeer,2015JJ00,2015,144152,807,1246,8.6,905,6.3,341,7477,51.8,2075,5402,7454,51.6,1196,-287,6258,23,366,2.5,144518
35416,T001038,Total male and female,GM0394,Haarlemmermeer,2016JJ00,2016,144518,811,1317,9.1,965,6.6,352,9082,62.5,2504,6578,7951,54.7,1195,-248,6756,1131,1485,10.3,146003
35417,T001038,Total male and female,GM0394,Haarlemmermeer,2017JJ00,2017,146003,819,1330,9.1,926,6.3,404,8912,60.8,2244,6668,8028,54.7,1191,-198,6837,884,1279,8.8,147282
35418,T001038,Total male and female,GM0394,Haarlemmermeer,2018JJ00,2018,147282,826,1273,8.6,1009,6.8,264,8995,60.9,2756,6239,8471,57.4,1250,-268,7221,524,786,5.3,148068
35419,T001038,Total male and female,GM0394,Haarlemmermeer,2019JJ00,2019,154235,781,1397,9,1034,6.7,363,10395,67,3474,6921,8993,58,1261,-212,7732,1402,1767,11.5,156002
35420,T001038,Total male and female,GM0394,Haarlemmermeer,2020JJ00,2020,156002,790,1513,9.6,1128,7.2,385,10205,65,2365,7840,8799,56.1,1392,-375,7407,1406,1787,11.5,157789
35421,T001038,Total male and female,GM0394,Haarlemmermeer,2021JJ00,2021,157789,799,1588,10,1144,7.2,444,9722,61.3,2142,7580,8607,54.3,1253,-287,7354,1115,1547,9.8,159336
35422,T001038,Total male and female,GM0394,Haarlemmermeer,2022JJ00,2022,159336,808,1535,9.5,1212,7.5,323,12721,79.1,4680,8041,10067,62.6,1591,-230,8476,2654,2964,18.6,162300
35423,T001038,Total male and female,GM0394,Haarlemmermeer,2023JJ00,2023,162300,823,1450,8.9,1126,6.9,324,12078,74.2,3391,8687,11578,71.2,1897,-412,9681,500,828,5.1,163128
35822,T001038,Total male and female,GM1655,Halderberge,2012JJ00,2012,29325,393,219,7.5,273,9.3,-54,1069,36.5,153,916,1108,37.8,131,-33,977,-39,-94,-3.2,29231
35823,T001038,Total male and female,GM1655,Halderberge,2013JJ00,2013,29231,392,247,8.4,254,8.7,-7,1241,42.4,188,1053,1127,38.5,114,-10,1013,114,109,3.7,29340
35824,T001038,Total male and female,GM1655,Halderberge,2014JJ00,2014,29340,394,274,9.3,262,8.9,12,1346,45.8,171,1175,1206,41,173,-12,1033,140,144,4.9,29484
35825,T001038,Total male and female,GM1655,Halderberge,2015JJ00,2015,29484,396,232,7.9,243,8.2,-11,1356,46,181,1175,1303,44.2,167,-28,1136,53,47,1.6,29531
35826,T001038,Total male and female,GM1655,Halderberge,2016JJ00,2016,29531,396,292,9.9,307,10.4,-15,1425,48.2,164,1261,1360,46,140,-8,1220,65,48,1.6,29579
35827,T001038,Total male and female,GM1655,Halderberge,2017JJ00,2017,29579,397,253,8.5,290,9.8,-37,1726,58,282,1444,1379,46.4,151,-11,1228,347,309,10.4,29888
35828,T001038,Total male and female,GM1655,Halderberge,2018JJ00,2018,29888,401,254,8.5,311,10.4,-57,1788,59.5,384,1404,1424,47.4,250,-105,1174,364,306,10.2,30194
35829,T001038,Total male and female,GM1655,Halderberge,2019JJ00,2019,30194,405,242,8,300,9.9,-58,1676,55.4,249,1427,1526,50.5,297,-160,1229,150,90,3,30284
35830,T001038,Total male and female,GM1655,Halderberge,2020JJ00,2020,30284,407,255,8.4,348,11.5,-93,1603,52.8,228,1375,1360,44.8,168,-47,1192,243,146,4.8,30430
35831,T001038,Total male and female,GM1655,Halderberge,2021JJ00,2021,30430,409,272,8.9,365,11.9,-93,1765,57.7,252,1513,1333,43.6,205,-64,1128,432,340,11.2,30770
35832,T001038,Total male and female,GM1655,Halderberge,2022JJ00,2022,30770,413,254,8.2,366,11.8,-112,1766,57.1,397,1369,1383,44.7,206,-48,1177,383,271,8.8,31041
35833,T001038,Total male and female,GM1655,Halderberge,2023JJ00,2023,31041,417,259,8.3,331,10.6,-72,1653,53.1,299,1354,1439,46.3,193,-43,1246,214,142,4.6,31183
36150,T001038,Total male and female,GM0160,Hardenberg,2012JJ00,2012,59430,190,657,11,452,7.6,205,1488,25,133,1355,1538,25.8,147,-29,1391,-50,155,2.6,59585
36151,T001038,Total male and female,GM0160,Hardenberg,2013JJ00,2013,59585,191,651,10.9,493,8.3,158,1370,23,137,1233,1535,25.8,115,-1,1420,-165,-8,-0.1,59577
36152,T001038,Total male and female,GM0160,Hardenberg,2014JJ00,2014,59577,191,655,11,457,7.7,198,1398,23.5,100,1298,1597,26.8,106,-9,1491,-199,0,0,59577
36153,T001038,Total male and female,GM0160,Hardenberg,2015JJ00,2015,59577,191,658,11,463,7.8,195,1609,27,152,1457,1699,28.5,128,13,1571,-90,110,1.8,59687
36154,T001038,Total male and female,GM0160,Hardenberg,2016JJ00,2016,59687,191,630,10.5,511,8.5,119,2111,35.2,179,1932,1708,28.5,132,2,1576,403,524,8.8,60211
36155,T001038,Total male and female,GM0160,Hardenberg,2017JJ00,2017,60211,193,634,10.5,497,8.2,137,2429,40.2,253,2176,2240,37.1,150,-20,2090,189,328,5.4,60539
36156,T001038,Total male and female,GM0160,Hardenberg,2018JJ00,2018,60539,194,608,10,537,8.9,71,2167,35.8,254,1913,2202,36.4,145,-31,2057,-35,35,0.6,60574
36157,T001038,Total male and female,GM0160,Hardenberg,2019JJ00,2019,60574,194,625,10.3,472,7.8,153,2313,38.1,419,1894,2094,34.5,193,-32,1901,219,374,6.2,60948
36158,T001038,Total male and female,GM0160,Hardenberg,2020JJ00,2020,60948,195,604,9.9,526,8.6,78,2291,37.5,274,2017,1953,31.9,150,-45,1803,338,409,6.7,61357
36159,T001038,Total male and female,GM0160,Hardenberg,2021JJ00,2021,61357,196,688,11.2,564,9.2,124,2538,41.2,154,2384,2217,36,158,-48,2059,321,441,7.2,61798
36160,T001038,Total male and female,GM0160,Hardenberg,2022JJ00,2022,61798,198,617,9.9,551,8.9,66,2820,45.4,394,2426,2181,35.1,228,-49,1953,639,711,11.5,62509
36161,T001038,Total male and female,GM0160,Hardenberg,2023JJ00,2023,62509,200,624,9.9,522,8.3,102,2416,38.5,203,2213,2094,33.4,264,-78,1830,322,423,6.8,62932
36232,T001038,Total male and female,GM0243,Harderwijk,2012JJ00,2012,45429,1177,611,13.4,335,7.4,276,1710,37.5,212,1498,1764,38.7,177,-45,1587,-54,221,4.9,45650
36233,T001038,Total male and female,GM0243,Harderwijk,2013JJ00,2013,45650,1181,524,11.5,350,7.7,174,1623,35.5,207,1416,1715,37.5,169,-45,1546,-92,82,1.8,45732
36234,T001038,Total male and female,GM0243,Harderwijk,2014JJ00,2014,45732,1184,527,11.5,342,7.5,185,1792,39.2,219,1573,1941,42.4,203,-21,1738,-149,44,1,45776
36235,T001038,Total male and female,GM0243,Harderwijk,2015JJ00,2015,45776,1185,527,11.5,355,7.7,172,1958,42.7,235,1723,1940,42.3,174,-22,1766,18,190,4.2,45966
36236,T001038,Total male and female,GM0243,Harderwijk,2016JJ00,2016,45966,1183,524,11.4,384,8.3,140,2018,43.7,219,1799,1767,38.3,166,4,1601,251,386,8.4,46352
36237,T001038,Total male and female,GM0243,Harderwijk,2017JJ00,2017,46352,1193,511,11,360,7.7,151,2620,56.2,279,2341,2295,49.3,101,26,2194,325,480,10.4,46832
36238,T001038,Total male and female,GM0243,Harderwijk,2018JJ00,2018,46832,1204,469,9.9,367,7.8,102,3110,65.9,314,2796,2465,52.2,176,-39,2289,645,749,16,47581
36239,T001038,Total male and female,GM0243,Harderwijk,2019JJ00,2019,47581,1223,559,11.6,382,8,177,3066,63.9,344,2722,2410,50.2,206,-53,2204,656,833,17.5,48414
36240,T001038,Total male and female,GM0243,Harderwijk,2020JJ00,2020,48414,1245,495,10.2,403,8.3,92,2898,59.7,311,2587,2667,54.9,275,-98,2392,231,312,6.4,48726
36241,T001038,Total male and female,GM0243,Harderwijk,2021JJ00,2021,48726,1253,536,11,472,9.7,64,2685,55,246,2439,2615,53.6,221,-60,2394,70,131,2.7,48857
36242,T001038,Total male and female,GM0243,Harderwijk,2022JJ00,2022,48857,1255,493,10.1,415,8.5,78,2524,51.6,384,2140,2552,52.2,225,-57,2327,-28,49,1,48906
36243,T001038,Total male and female,GM0243,Harderwijk,2023JJ00,2023,48906,1257,432,8.8,449,9.1,-17,2868,58.4,360,2508,2368,48.2,265,-91,2103,500,481,9.8,49387
36396,T001038,Total male and female,GM0523,Hardinxveld-Giessendam,2012JJ00,2012,17654,1043,222,12.6,148,8.4,74,425,24,36,389,426,24.1,20,-5,406,-1,68,3.9,17722
36397,T001038,Total male and female,GM0523,Hardinxveld-Giessendam,2013JJ00,2013,17722,1047,213,12,144,8.1,69,420,23.7,48,372,457,25.8,34,-6,423,-37,36,2,17758
36398,T001038,Total male and female,GM0523,Hardinxveld-Giessendam,2014JJ00,2014,17758,1049,221,12.4,139,7.8,82,490,27.6,48,442,529,29.8,46,1,483,-39,44,2.5,17802
36399,T001038,Total male and female,GM0523,Hardinxveld-Giessendam,2015JJ00,2015,17802,1052,215,12.1,168,9.4,47,534,30,66,468,610,34.3,39,-10,571,-76,-28,-1.6,17774
36400,T001038,Total male and female,GM0523,Hardinxveld-Giessendam,2016JJ00,2016,17774,1050,233,13.1,166,9.3,67,679,38.1,46,633,648,36.4,29,1,619,31,98,5.5,17872
36401,T001038,Total male and female,GM0523,Hardinxveld-Giessendam,2017JJ00,2017,17872,1056,205,11.4,153,8.5,52,641,35.8,31,610,606,33.8,23,-1,583,35,86,4.8,17958
36402,T001038,Total male and female,GM0523,Hardinxveld-Giessendam,2018JJ00,2018,17958,1062,229,12.7,157,8.7,72,674,37.4,50,624,654,36.3,33,-5,621,20,93,5.2,18051
36403,T001038,Total male and female,GM0523,Hardinxveld-Giessendam,2019JJ00,2019,18051,1067,229,12.6,176,9.7,53,719,39.6,54,665,542,29.8,17,-4,525,177,244,13.5,18295
36404,T001038,Total male and female,GM0523,Hardinxveld-Giessendam,2020JJ00,2020,18295,1082,245,13.3,205,11.2,40,707,38.5,45,662,629,34.3,34,-3,595,78,118,6.4,18413
36405,T001038,Total male and female,GM0523,Hardinxveld-Giessendam,2021JJ00,2021,18413,1089,253,13.7,184,10,69,748,40.5,60,688,719,38.9,27,-7,692,29,98,5.3,18511
36406,T001038,Total male and female,GM0523,Hardinxveld-Giessendam,2022JJ00,2022,18511,1098,241,13,158,8.5,83,784,42.2,266,518,697,37.5,104,-12,593,87,170,9.2,18681
36407,T001038,Total male and female,GM0523,Hardinxveld-Giessendam,2023JJ00,2023,18681,1108,221,11.8,193,10.3,28,721,38.5,105,616,669,35.7,87,-14,582,52,81,4.3,18762
36478,T001038,Total male and female,GM0017,Haren,2012JJ00,2012,18457,405,135,7.3,263,14.2,-128,1354,73,122,1232,1040,56.1,129,-13,911,314,185,10,18642
36479,T001038,Total male and female,GM0017,Haren,2013JJ00,2013,18642,410,160,8.6,279,14.9,-119,1347,72,118,1229,1087,58.1,89,-7,998,260,140,7.5,18782
36480,T001038,Total male and female,GM0017,Haren,2014JJ00,2014,18782,413,145,7.7,241,12.8,-96,1340,71.1,116,1224,1102,58.5,87,-13,1015,238,142,7.6,18924
36481,T001038,Total male and female,GM0017,Haren,2015JJ00,2015,18924,416,168,8.8,264,13.9,-96,1956,102.9,611,1345,1713,90.2,94,-5,1619,243,152,8,19076
36482,T001038,Total male and female,GM0017,Haren,2016JJ00,2016,19076,420,164,8.5,293,15.2,-129,2136,110.5,370,1766,1514,78.4,98,1,1416,622,494,25.9,19570
36483,T001038,Total male and female,GM0017,Haren,2017JJ00,2017,19570,431,175,8.9,269,13.6,-94,1839,93.3,117,1722,1454,73.8,120,-37,1334,385,290,14.8,19860
36484,T001038,Total male and female,GM0017,Haren,2018JJ00,2018,19860,438,172,8.6,247,12.3,-75,1575,78.6,115,1460,1165,58.2,82,-7,1083,410,331,16.7,20191
36560,T001038,Total male and female,GM0395,Harenkarspel,2012JJ00,2012,16194,300,153,9.5,120,7.4,33,560,34.7,45,515,678,42,66,-8,612,-118,-72,-4.4,16122
36642,T001038,Total male and female,GM0072,Harlingen,2012JJ00,2012,15844,633,158,10,180,11.4,-22,613,38.7,69,544,580,36.6,38,-7,542,33,10,0.6,15854
36643,T001038,Total male and female,GM0072,Harlingen,2013JJ00,2013,15854,635,135,8.5,169,10.7,-34,621,39.2,56,565,621,39.2,64,-19,557,0,-33,-2.1,15821
36644,T001038,Total male and female,GM0072,Harlingen,2014JJ00,2014,15821,634,130,8.2,174,11,-44,614,38.9,57,557,612,38.7,46,-4,566,2,-42,-2.7,15779
36645,T001038,Total male and female,GM0072,Harlingen,2015JJ00,2015,15779,632,130,8.2,185,11.7,-55,740,46.8,103,637,650,41.1,54,-10,596,90,34,2.2,15813
36646,T001038,Total male and female,GM0072,Harlingen,2016JJ00,2016,15813,634,147,9.3,183,11.6,-36,729,46,45,684,645,40.7,67,-14,578,84,47,3,15860
36647,T001038,Total male and female,GM0072,Harlingen,2017JJ00,2017,15860,635,110,7,199,12.6,-89,747,47.2,45,702,735,46.5,39,-6,696,12,-77,-4.9,15783
36648,T001038,Total male and female,GM0072,Harlingen,2018JJ00,2018,15783,632,128,8.1,169,10.7,-41,659,41.8,60,599,643,40.8,35,3,608,16,-25,-1.6,15758
36649,T001038,Total male and female,GM0072,Harlingen,2019JJ00,2019,15758,631,111,7.1,170,10.8,-59,734,46.6,63,671,711,45.2,47,-2,664,23,-36,-2.3,15722
36650,T001038,Total male and female,GM0072,Harlingen,2020JJ00,2020,15722,630,103,6.5,185,11.7,-82,797,50.6,85,712,630,40,23,6,607,167,85,5.4,15807
36651,T001038,Total male and female,GM0072,Harlingen,2021JJ00,2021,15807,633,153,9.6,202,12.7,-49,777,49,88,689,631,39.8,30,-5,601,146,97,6.1,15904
36652,T001038,Total male and female,GM0072,Harlingen,2022JJ00,2022,15904,637,109,6.8,227,14.1,-118,977,60.9,202,775,575,35.8,64,-18,511,402,284,17.9,16188
36653,T001038,Total male and female,GM0072,Harlingen,2023JJ00,2023,16188,649,123,7.6,204,12.6,-81,809,49.9,89,720,683,42.1,84,-17,599,126,41,2.5,16229
36970,T001038,Total male and female,GM0244,Hattem,2012JJ00,2012,11805,511,97,8.2,105,8.9,-8,393,33.3,26,367,421,35.7,25,1,396,-28,-36,-3,11769
36971,T001038,Total male and female,GM0244,Hattem,2013JJ00,2013,11769,510,120,10.2,105,8.9,15,411,35,26,385,463,39.4,44,4,419,-52,-37,-3.1,11732
36972,T001038,Total male and female,GM0244,Hattem,2014JJ00,2014,11732,509,113,9.6,105,8.9,8,545,46.3,38,507,463,39.3,28,-6,435,82,89,7.6,11821
36973,T001038,Total male and female,GM0244,Hattem,2015JJ00,2015,11821,512,108,9.1,111,9.4,-3,585,49.3,50,535,511,43.1,41,-1,470,74,69,5.8,11890
36974,T001038,Total male and female,GM0244,Hattem,2016JJ00,2016,11890,515,112,9.4,103,8.6,9,632,52.8,22,610,492,41.1,39,-2,453,140,150,12.6,12040
36975,T001038,Total male and female,GM0244,Hattem,2017JJ00,2017,12040,522,117,9.7,94,7.8,23,617,51,45,572,526,43.5,24,4,502,91,114,9.5,12154
36976,T001038,Total male and female,GM0244,Hattem,2018JJ00,2018,12154,527,104,8.6,115,9.5,-11,591,48.6,29,562,561,46.1,26,-3,535,30,19,1.6,12173
36977,T001038,Total male and female,GM0244,Hattem,2019JJ00,2019,12173,527,102,8.4,129,10.6,-27,572,46.9,33,539,510,41.8,23,-2,487,62,36,3,12209
36978,T001038,Total male and female,GM0244,Hattem,2020JJ00,2020,12209,529,125,10.2,124,10.1,1,545,44.6,33,512,527,43.1,27,1,500,18,19,1.6,12228
36979,T001038,Total male and female,GM0244,Hattem,2021JJ00,2021,12228,530,127,10.4,120,9.8,7,564,46,29,535,492,40.1,32,-1,460,72,79,6.5,12307
36980,T001038,Total male and female,GM0244,Hattem,2022JJ00,2022,12307,533,115,9.2,119,9.6,-4,733,58.9,128,605,473,38,33,0,440,260,256,20.8,12563
36981,T001038,Total male and female,GM0244,Hattem,2023JJ00,2023,12563,545,136,10.8,132,10.5,4,626,49.7,38,588,569,45.2,36,0,533,57,61,4.9,12624
37462,T001038,Total male and female,GM0396,Heemskerk,2012JJ00,2012,39268,1440,374,9.5,389,9.9,-15,1625,41.5,173,1452,1761,44.9,171,-25,1590,-136,-151,-3.8,39117
37463,T001038,Total male and female,GM0396,Heemskerk,2013JJ00,2013,39117,1438,347,8.9,380,9.7,-33,1664,42.6,187,1477,1661,42.5,167,-30,1494,3,-29,-0.7,39088
37464,T001038,Total male and female,GM0396,Heemskerk,2014JJ00,2014,39088,1437,326,8.3,386,9.9,-60,1837,47,143,1694,1727,44.2,207,-25,1520,110,50,1.3,39138
37465,T001038,Total male and female,GM0396,Heemskerk,2015JJ00,2015,39138,1438,330,8.4,400,10.2,-70,2088,53.2,131,1957,1854,47.3,217,-33,1637,234,161,4.1,39299
37466,T001038,Total male and female,GM0396,Heemskerk,2016JJ00,2016,39299,1444,350,8.9,451,11.5,-101,1890,48.2,151,1739,1914,48.8,142,-20,1772,-24,-128,-3.3,39171
37467,T001038,Total male and female,GM0396,Heemskerk,2017JJ00,2017,39171,1439,331,8.5,375,9.6,-44,1851,47.3,161,1690,1833,46.8,162,-7,1671,18,-25,-0.6,39146
37468,T001038,Total male and female,GM0396,Heemskerk,2018JJ00,2018,39146,1432,319,8.1,437,11.2,-118,1855,47.4,219,1636,1720,43.9,149,-13,1571,135,18,0.5,39164
37469,T001038,Total male and female,GM0396,Heemskerk,2019JJ00,2019,39164,1432,320,8.2,399,10.2,-79,1862,47.5,186,1676,1762,45,162,-37,1600,100,18,0.5,39182
37470,T001038,Total male and female,GM0396,Heemskerk,2020JJ00,2020,39182,1433,368,9.4,448,11.4,-80,1866,47.6,136,1730,1776,45.3,125,-20,1651,90,9,0.2,39191
37471,T001038,Total male and female,GM0396,Heemskerk,2021JJ00,2021,39191,1433,377,9.6,451,11.5,-74,1722,43.9,129,1593,1652,42.2,143,-20,1509,70,-2,-0.1,39189
37472,T001038,Total male and female,GM0396,Heemskerk,2022JJ00,2022,39189,1437,377,9.6,435,11.1,-58,2056,52.3,259,1797,1753,44.6,155,0,1598,303,242,6.2,39431
37473,T001038,Total male and female,GM0396,Heemskerk,2023JJ00,2023,39431,1446,343,8.7,495,12.6,-152,1786,45.3,161,1625,1611,40.8,157,1,1454,175,21,0.5,39452
37544,T001038,Total male and female,GM0397,Heemstede,2012JJ00,2012,26242,2849,174,6.6,296,11.3,-122,1512,57.5,194,1318,1318,50.2,171,-18,1147,194,75,2.9,26317
37545,T001038,Total male and female,GM0397,Heemstede,2013JJ00,2013,26317,2857,208,7.9,295,11.2,-87,1589,60.3,219,1370,1454,55.2,173,0,1281,135,47,1.8,26364
37546,T001038,Total male and female,GM0397,Heemstede,2014JJ00,2014,26364,2863,194,7.3,273,10.3,-79,1803,68.2,180,1623,1608,60.9,227,-25,1381,195,116,4.4,26480
37547,T001038,Total male and female,GM0397,Heemstede,2015JJ00,2015,26480,2875,199,7.5,349,13.1,-150,2036,76.5,222,1814,1602,60.2,190,-13,1412,434,286,10.8,26766
37548,T001038,Total male and female,GM0397,Heemstede,2016JJ00,2016,26766,2916,231,8.6,332,12.4,-101,1953,72.7,251,1702,1684,62.7,183,-11,1501,269,170,6.4,26936
37549,T001038,Total male and female,GM0397,Heemstede,2017JJ00,2017,26936,2934,209,7.7,358,13.3,-149,2024,74.9,230,1794,1729,64,143,-15,1586,295,144,5.3,27080
37550,T001038,Total male and female,GM0397,Heemstede,2018JJ00,2018,27080,2950,224,8.2,318,11.7,-94,1929,71,338,1591,1628,59.9,159,-15,1469,301,206,7.6,27286
37551,T001038,Total male and female,GM0397,Heemstede,2019JJ00,2019,27286,2972,213,7.8,341,12.5,-128,1818,66.7,285,1533,1739,63.8,204,-13,1535,79,-52,-1.9,27234
37552,T001038,Total male and female,GM0397,Heemstede,2020JJ00,2020,27234,2967,217,7.9,403,14.7,-186,2260,82.5,226,2034,1762,64.3,142,-3,1620,498,311,11.4,27545
37553,T001038,Total male and female,GM0397,Heemstede,2021JJ00,2021,27545,3001,219,7.9,369,13.4,-150,1873,68,228,1645,1710,62.1,151,4,1559,163,12,0.4,27557
37554,T001038,Total male and female,GM0397,Heemstede,2022JJ00,2022,27557,3005,190,6.9,359,13,-169,2042,73.8,410,1632,1657,59.9,207,-3,1450,385,221,8,27778
37555,T001038,Total male and female,GM0397,Heemstede,2023JJ00,2023,27778,3029,196,7.1,393,14.2,-197,1796,64.9,260,1536,1783,64.4,220,-6,1563,13,-185,-6.7,27593
37954,T001038,Total male and female,GM0246,Heerde,2012JJ00,2012,18244,232,172,9.4,183,10,-11,687,37.5,57,630,519,28.3,41,-18,478,168,155,8.5,18399
37955,T001038,Total male and female,GM0246,Heerde,2013JJ00,2013,18399,234,160,8.7,168,9.1,-8,658,35.7,50,608,559,30.3,24,5,535,99,91,4.9,18490
37956,T001038,Total male and female,GM0246,Heerde,2014JJ00,2014,18490,235,183,9.9,198,10.7,-15,649,35.1,24,625,612,33.1,28,1,584,37,22,1.2,18512
37957,T001038,Total male and female,GM0246,Heerde,2015JJ00,2015,18512,235,163,8.8,195,10.5,-32,704,38,56,648,633,34.2,43,-4,590,71,44,2.4,18556
37958,T001038,Total male and female,GM0246,Heerde,2016JJ00,2016,18556,236,171,9.2,204,11,-33,775,41.8,40,735,737,39.7,48,-7,689,38,5,0.3,18561
37959,T001038,Total male and female,GM0246,Heerde,2017JJ00,2017,18561,236,159,8.6,200,10.8,-41,817,44,52,765,734,39.5,50,-7,684,83,42,2.3,18603
37960,T001038,Total male and female,GM0246,Heerde,2018JJ00,2018,18603,236,162,8.7,201,10.8,-39,808,43.5,48,760,826,44.5,37,-5,789,-18,-57,-3.1,18546
37961,T001038,Total male and female,GM0246,Heerde,2019JJ00,2019,18546,236,153,8.2,245,13.2,-92,820,44.2,49,771,684,36.8,41,-2,643,136,43,2.3,18589
37962,T001038,Total male and female,GM0246,Heerde,2020JJ00,2020,18589,236,167,8.9,260,13.9,-93,979,52.4,75,904,698,37.4,32,2,666,281,187,10.1,18776
37963,T001038,Total male and female,GM0246,Heerde,2021JJ00,2021,18776,238,167,8.8,209,11.1,-42,965,51.1,42,923,722,38.2,36,1,686,243,200,10.7,18976
37964,T001038,Total male and female,GM0246,Heerde,2022JJ00,2022,18976,242,154,8.1,238,12.5,-84,1010,52.9,221,789,686,35.9,83,-16,603,324,238,12.5,19214
37965,T001038,Total male and female,GM0246,Heerde,2023JJ00,2023,19214,245,161,8.4,211,11,-50,780,40.6,88,692,720,37.5,67,-3,653,60,12,0.6,19226
38118,T001038,Total male and female,GM0074,Heerenveen,2012JJ00,2012,43514,322,424,9.8,426,9.8,-2,1752,40.4,141,1611,1942,44.7,167,-25,1775,-190,-191,-4.4,43323
38119,T001038,Total male and female,GM0074,Heerenveen,2013JJ00,2013,43323,321,396,9.1,383,8.8,13,1742,40.2,135,1607,1772,40.9,136,-19,1636,-30,-22,-0.5,43301
38120,T001038,Total male and female,GM0074,Heerenveen,2014JJ00,2014,49899,262,555,11.1,497,9.9,58,2200,44,188,2012,2018,40.3,152,-33,1866,182,242,4.8,50141
38121,T001038,Total male and female,GM0074,Heerenveen,2015JJ00,2015,50141,264,466,9.3,515,10.3,-49,2363,47.1,215,2148,2162,43.1,184,-33,1978,201,149,3,50290
38122,T001038,Total male and female,GM0074,Heerenveen,2016JJ00,2016,50290,265,452,9,573,11.4,-121,2378,47.3,232,2146,2342,46.6,207,-32,2135,36,-87,-1.7,50203
38123,T001038,Total male and female,GM0074,Heerenveen,2017JJ00,2017,50203,264,446,8.9,507,10.1,-61,2392,47.7,204,2188,2342,46.7,210,-35,2132,50,-11,-0.2,50192
38124,T001038,Total male and female,GM0074,Heerenveen,2018JJ00,2018,50192,264,421,8.4,562,11.2,-141,2511,50,213,2298,2304,45.9,182,-34,2122,207,65,1.3,50257
38125,T001038,Total male and female,GM0074,Heerenveen,2019JJ00,2019,50257,264,427,8.5,494,9.8,-67,2536,50.3,226,2310,2229,44.2,176,-6,2053,307,236,4.7,50493
38126,T001038,Total male and female,GM0074,Heerenveen,2020JJ00,2020,50493,266,451,8.9,547,10.8,-96,2398,47.4,177,2221,2143,42.4,142,0,2001,255,157,3.1,50650
38127,T001038,Total male and female,GM0074,Heerenveen,2021JJ00,2021,50650,266,457,9,533,10.5,-76,2614,51.4,177,2437,2062,40.5,129,-8,1933,552,469,9.3,51119
38128,T001038,Total male and female,GM0074,Heerenveen,2022JJ00,2022,51119,269,451,8.8,589,11.5,-138,2783,54.2,538,2245,2126,41.4,202,-10,1924,657,518,10.1,51637
38129,T001038,Total male and female,GM0074,Heerenveen,2023JJ00,2023,51637,272,404,7.8,598,11.6,-194,2666,51.6,338,2328,2318,44.8,250,-19,2068,348,150,2.9,51787
38282,T001038,Total male and female,GM0398,Heerhugowaard,2012JJ00,2012,52483,1367,617,11.7,318,6,299,2468,46.8,256,2212,2361,44.8,248,-8,2113,107,410,7.8,52893
38283,T001038,Total male and female,GM0398,Heerhugowaard,2013JJ00,2013,52893,1380,602,11.3,329,6.2,273,2456,46.3,284,2172,2320,43.7,204,-12,2116,136,414,7.8,53307
38284,T001038,Total male and female,GM0398,Heerhugowaard,2014JJ00,2014,53307,1391,583,10.9,310,5.8,273,2376,44.5,271,2105,2402,45,197,43,2205,-26,247,4.6,53554
38285,T001038,Total male and female,GM0398,Heerhugowaard,2015JJ00,2015,53554,1397,576,10.7,346,6.4,230,2701,50.3,252,2449,2558,47.6,237,-32,2321,143,373,7,53927
38286,T001038,Total male and female,GM0398,Heerhugowaard,2016JJ00,2016,53927,1409,569,10.5,367,6.7,202,3848,70.7,844,3004,3024,55.5,245,-44,2779,824,1023,19,54950
38287,T001038,Total male and female,GM0398,Heerhugowaard,2017JJ00,2017,54950,1435,616,11.1,356,6.4,260,3744,67.6,376,3368,3100,56,235,-27,2865,644,900,16.4,55850
38288,T001038,Total male and female,GM0398,Heerhugowaard,2018JJ00,2018,55850,1462,605,10.7,387,6.9,218,3688,65.5,341,3347,3007,53.4,209,-4,2798,681,892,16,56742
38289,T001038,Total male and female,GM0398,Heerhugowaard,2019JJ00,2019,56742,1485,557,9.7,374,6.5,183,3867,67.6,358,3509,3211,56.2,259,-46,2952,656,845,14.9,57587
38290,T001038,Total male and female,GM0398,Heerhugowaard,2020JJ00,2020,57587,1507,617,10.6,453,7.8,164,3862,66.6,287,3575,3224,55.6,226,-52,2998,638,800,13.9,58387
38291,T001038,Total male and female,GM0398,Heerhugowaard,2021JJ00,2021,58387,1528,665,11.3,468,8,197,3624,61.7,274,3350,3154,53.7,267,-50,2887,470,715,12.2,59102
38446,T001038,Total male and female,GM0917,Heerlen,2012JJ00,2012,89016,1977,730,8.2,1026,11.5,-296,4765,53.6,775,3990,4737,53.3,594,-172,4143,28,-269,-3,88747
38447,T001038,Total male and female,GM0917,Heerlen,2013JJ00,2013,88747,1973,786,8.9,1011,11.4,-225,4657,52.6,869,3788,4919,55.6,747,-298,4172,-262,-488,-5.5,88259
38448,T001038,Total male and female,GM0917,Heerlen,2014JJ00,2014,88259,1963,756,8.6,1017,11.6,-261,4742,54,857,3885,5240,59.6,873,-339,4367,-498,-759,-8.6,87500
38449,T001038,Total male and female,GM0917,Heerlen,2015JJ00,2015,87500,1946,722,8.3,1041,11.9,-319,5037,57.6,931,4106,4811,55,674,-181,4137,226,-94,-1.1,87406
38450,T001038,Total male and female,GM0917,Heerlen,2016JJ00,2016,87406,1944,715,8.2,1066,12.2,-351,5547,63.5,1059,4488,5409,62,722,-260,4687,138,-217,-2.5,87189
38451,T001038,Total male and female,GM0917,Heerlen,2017JJ00,2017,87189,1939,691,7.9,1054,12.1,-363,5334,61.3,771,4563,5390,62,694,-241,4696,-56,-427,-4.9,86762
38452,T001038,Total male and female,GM0917,Heerlen,2018JJ00,2018,86762,1931,688,7.9,1087,12.5,-399,5611,64.6,981,4630,5142,59.2,716,-259,4426,469,70,0.8,86832
38453,T001038,Total male and female,GM0917,Heerlen,2019JJ00,2019,86832,1932,669,7.7,1066,12.3,-397,5736,66,954,4782,5071,58.3,724,-219,4347,665,254,2.9,87086
38454,T001038,Total male and female,GM0917,Heerlen,2020JJ00,2020,87086,1938,694,8,1168,13.4,-474,5577,64.1,828,4749,5250,60.3,633,-165,4617,327,-150,-1.7,86936
38455,T001038,Total male and female,GM0917,Heerlen,2021JJ00,2021,86936,1934,702,8.1,1269,14.6,-567,5919,68.1,890,5029,5426,62.4,735,-269,4691,493,-91,-1,86845
38456,T001038,Total male and female,GM0917,Heerlen,2022JJ00,2022,86845,1934,705,8.1,1195,13.7,-490,5934,68.2,1237,4697,5163,59.4,797,-212,4366,771,277,3.2,87122
38457,T001038,Total male and female,GM0917,Heerlen,2023JJ00,2023,87122,1940,710,8.1,1188,13.6,-478,6003,68.8,1322,4681,5183,59.4,831,-261,4352,820,339,3.9,87461
38856,T001038,Total male and female,GM1658,Heeze-Leende,2012JJ00,2012,15352,148,127,8.3,135,8.8,-8,541,35.2,71,470,483,31.4,58,-3,425,58,53,3.5,15405
38857,T001038,Total male and female,GM1658,Heeze-Leende,2013JJ00,2013,15405,148,92,6,135,8.8,-43,556,36.2,75,481,565,36.7,75,-2,490,-9,-52,-3.4,15353
38858,T001038,Total male and female,GM1658,Heeze-Leende,2014JJ00,2014,15353,148,128,8.3,158,10.2,-30,682,44.2,96,586,528,34.3,66,-1,462,154,124,8.1,15477
38859,T001038,Total male and female,GM1658,Heeze-Leende,2015JJ00,2015,15477,149,137,8.8,148,9.5,-11,716,46,85,631,532,34.2,59,-2,473,184,173,11.2,15650
38860,T001038,Total male and female,GM1658,Heeze-Leende,2016JJ00,2016,15650,150,131,8.4,173,11,-42,703,44.8,64,639,597,38.1,55,0,542,106,64,4.1,15714
38861,T001038,Total male and female,GM1658,Heeze-Leende,2017JJ00,2017,15714,151,124,7.8,151,9.6,-27,842,53.3,84,758,643,40.7,71,3,572,199,172,10.9,15886
38862,T001038,Total male and female,GM1658,Heeze-Leende,2018JJ00,2018,15886,153,126,7.9,165,10.4,-39,756,47.5,79,677,639,40.1,65,-3,574,117,78,4.9,15964
38863,T001038,Total male and female,GM1658,Heeze-Leende,2019JJ00,2019,15964,153,149,9.3,165,10.3,-16,823,51.3,89,734,619,38.5,49,-1,570,204,188,11.8,16152
38864,T001038,Total male and female,GM1658,Heeze-Leende,2020JJ00,2020,16152,155,121,7.5,181,11.2,-60,809,49.9,101,708,657,40.6,67,-8,590,152,91,5.6,16243
38865,T001038,Total male and female,GM1658,Heeze-Leende,2021JJ00,2021,16243,156,149,9.1,178,10.9,-29,895,54.7,82,813,639,39.1,58,-6,581,256,227,14,16470
38866,T001038,Total male and female,GM1658,Heeze-Leende,2022JJ00,2022,16470,158,140,8.5,189,11.4,-49,863,52.1,171,692,657,39.7,98,-11,559,206,157,9.5,16627
38867,T001038,Total male and female,GM1658,Heeze-Leende,2023JJ00,2023,16627,160,137,8.2,165,9.9,-28,836,50,125,711,628,37.6,81,-6,547,208,180,10.8,16807
39102,T001038,Total male and female,GM0399,Heiloo,2012JJ00,2012,22650,1211,174,7.7,186,8.2,-12,883,39,84,799,927,41,101,9,826,-44,-56,-2.5,22594
39103,T001038,Total male and female,GM0399,Heiloo,2013JJ00,2013,22594,1208,136,6,195,8.6,-59,1009,44.6,84,925,909,40.2,70,9,839,100,42,1.9,22636
39104,T001038,Total male and female,GM0399,Heiloo,2014JJ00,2014,22636,1210,134,5.9,207,9.2,-73,985,43.6,93,892,995,44,78,1,917,-10,-83,-3.7,22553
39105,T001038,Total male and female,GM0399,Heiloo,2015JJ00,2015,22553,1205,158,7,202,8.9,-44,1301,57.5,95,1206,1122,49.6,66,6,1056,179,136,6,22689
39106,T001038,Total male and female,GM0399,Heiloo,2016JJ00,2016,22689,1213,159,7,235,10.3,-76,1314,57.7,96,1218,1070,47,64,5,1006,244,168,7.4,22857
39107,T001038,Total male and female,GM0399,Heiloo,2017JJ00,2017,22857,1222,146,6.4,203,8.8,-57,1486,64.7,113,1373,1187,51.7,90,2,1097,299,242,10.6,23099
39108,T001038,Total male and female,GM0399,Heiloo,2018JJ00,2018,23099,1235,165,7.1,230,9.9,-65,1481,63.6,122,1359,1051,45.1,82,-1,969,430,365,15.8,23464
39109,T001038,Total male and female,GM0399,Heiloo,2019JJ00,2019,23464,1255,172,7.3,189,8,-17,1658,69.9,133,1525,1136,47.9,103,-8,1033,522,504,21.5,23968
39110,T001038,Total male and female,GM0399,Heiloo,2020JJ00,2020,23968,1282,181,7.5,263,10.9,-82,1492,62,99,1393,1234,51.3,77,2,1157,258,176,7.3,24144
39111,T001038,Total male and female,GM0399,Heiloo,2021JJ00,2021,24144,1291,188,7.7,274,11.3,-86,1385,57,97,1288,1026,42.3,76,-5,950,359,273,11.3,24417
39112,T001038,Total male and female,GM0399,Heiloo,2022JJ00,2022,24417,1305,178,7.3,284,11.7,-106,1259,51.7,170,1089,1253,51.4,130,-8,1123,6,-98,-4,24319
39113,T001038,Total male and female,GM0399,Heiloo,2023JJ00,2023,24319,1300,171,7,276,11.4,-105,1314,54,116,1198,1216,50,112,-6,1104,98,-7,-0.3,24312
39676,T001038,Total male and female,GM0400,Den Helder,2012JJ00,2012,57065,1261,581,10.2,534,9.4,47,1787,31.3,350,1437,1955,34.3,289,-21,1666,-168,-118,-2.1,56947
39677,T001038,Total male and female,GM0400,Den Helder,2013JJ00,2013,56947,1263,508,8.9,554,9.8,-46,1573,27.7,379,1194,1880,33.1,410,-41,1470,-307,-350,-6.1,56597
39678,T001038,Total male and female,GM0400,Den Helder,2014JJ00,2014,56597,1255,546,9.7,513,9.1,33,1705,30.2,409,1296,1851,32.7,304,-2,1547,-146,-114,-2,56483
39679,T001038,Total male and female,GM0400,Den Helder,2015JJ00,2015,56483,1253,508,9,576,10.2,-68,2201,39,856,1345,2341,41.5,344,-52,1997,-140,-208,-3.7,56275
39680,T001038,Total male and female,GM0400,Den Helder,2016JJ00,2016,56275,1248,518,9.2,553,9.8,-35,2452,43.7,652,1800,2672,47.6,312,-18,2360,-220,-255,-4.5,56020
39681,T001038,Total male and female,GM0400,Den Helder,2017JJ00,2017,56020,1242,492,8.8,563,10.1,-71,2315,41.4,377,1938,2503,44.8,258,-21,2245,-188,-260,-4.6,55760
39682,T001038,Total male and female,GM0400,Den Helder,2018JJ00,2018,55760,1232,494,8.9,581,10.4,-87,2106,37.8,397,1709,2176,39.1,288,-56,1888,-70,-156,-2.8,55604
39683,T001038,Total male and female,GM0400,Den Helder,2019JJ00,2019,55604,1229,527,9.4,582,10.4,-55,2888,51.6,748,2140,2138,38.2,290,-11,1848,750,692,12.4,56296
39684,T001038,Total male and female,GM0400,Den Helder,2020JJ00,2020,56296,1244,483,8.6,614,10.9,-131,2561,45.4,486,2075,2138,37.9,268,-53,1870,423,286,5.1,56582
39685,T001038,Total male and female,GM0400,Den Helder,2021JJ00,2021,56582,1250,517,9.2,698,12.4,-181,2602,46.1,319,2283,2662,47.2,328,-55,2334,-60,-248,-4.4,56334
39686,T001038,Total male and female,GM0400,Den Helder,2022JJ00,2022,56334,1249,489,8.7,672,11.9,-183,2767,49,652,2115,2370,42,345,-57,2025,397,205,3.6,56539
39687,T001038,Total male and female,GM0400,Den Helder,2023JJ00,2023,56539,1254,517,9.2,704,12.5,-187,2296,40.6,449,1847,2206,39.1,341,-46,1865,90,-107,-1.9,56432
39758,T001038,Total male and female,GM0163,Hellendoorn,2012JJ00,2012,35796,259,318,8.9,310,8.7,8,751,21,64,687,812,22.7,48,0,764,-61,-53,-1.5,35743
39759,T001038,Total male and female,GM0163,Hellendoorn,2013JJ00,2013,35743,259,329,9.2,365,10.2,-36,784,21.9,51,733,779,21.8,55,-5,724,5,-32,-0.9,35711
39760,T001038,Total male and female,GM0163,Hellendoorn,2014JJ00,2014,35711,259,300,8.4,338,9.5,-38,844,23.7,50,794,895,25.1,72,-15,823,-51,-89,-2.5,35622
39761,T001038,Total male and female,GM0163,Hellendoorn,2015JJ00,2015,35622,258,320,9,341,9.6,-21,912,25.6,77,835,860,24.1,46,-5,814,52,29,0.8,35651
39762,T001038,Total male and female,GM0163,Hellendoorn,2016JJ00,2016,35651,258,343,9.6,325,9.1,18,1035,29,78,957,931,26.1,37,4,894,104,121,3.4,35772
39763,T001038,Total male and female,GM0163,Hellendoorn,2017JJ00,2017,35772,259,342,9.6,328,9.2,14,1064,29.7,72,992,1050,29.3,72,-8,978,14,24,0.7,35796
39764,T001038,Total male and female,GM0163,Hellendoorn,2018JJ00,2018,35796,260,335,9.4,400,11.2,-65,1022,28.5,72,950,944,26.4,45,1,899,78,12,0.3,35808
39765,T001038,Total male and female,GM0163,Hellendoorn,2019JJ00,2019,35808,260,346,9.6,333,9.3,13,1019,28.4,83,936,928,25.9,61,-7,867,91,108,3,35916
39766,T001038,Total male and female,GM0163,Hellendoorn,2020JJ00,2020,35916,260,312,8.7,390,10.9,-78,1055,29.4,70,985,962,26.8,57,-1,905,93,16,0.4,35932
39767,T001038,Total male and female,GM0163,Hellendoorn,2021JJ00,2021,35932,261,352,9.8,398,11.1,-46,959,26.7,79,880,905,25.2,54,1,851,54,8,0.2,35940
39768,T001038,Total male and female,GM0163,Hellendoorn,2022JJ00,2022,35940,261,318,8.8,396,11,-78,1305,36.1,364,941,906,25.1,118,-18,788,399,321,8.9,36261
39769,T001038,Total male and female,GM0163,Hellendoorn,2023JJ00,2023,36261,263,336,9.3,398,11,-62,1117,30.8,194,923,1049,28.9,155,-22,894,68,3,0.1,36264
39840,T001038,Total male and female,GM0530,Hellevoetsluis,2012JJ00,2012,39442,1250,359,9.1,316,8,43,1281,32.6,293,988,1677,42.7,504,-122,1173,-396,-356,-9,39086
39841,T001038,Total male and female,GM0530,Hellevoetsluis,2013JJ00,2013,39086,1239,338,8.7,312,8,26,1274,32.7,180,1094,1437,36.8,204,-41,1233,-163,-133,-3.4,38953
39842,T001038,Total male and female,GM0530,Hellevoetsluis,2014JJ00,2014,38953,1235,326,8.4,269,6.9,57,1258,32.3,196,1062,1384,35.6,199,-61,1185,-126,-71,-1.8,38882
39843,T001038,Total male and female,GM0530,Hellevoetsluis,2015JJ00,2015,38882,1232,313,8.1,286,7.4,27,1297,33.5,182,1115,1583,40.8,180,-32,1403,-286,-248,-6.4,38634
39844,T001038,Total male and female,GM0530,Hellevoetsluis,2016JJ00,2016,38634,1227,345,8.9,303,7.8,42,1538,39.8,184,1354,1491,38.5,148,-18,1343,47,88,2.3,38722
39845,T001038,Total male and female,GM0530,Hellevoetsluis,2017JJ00,2017,38722,1230,314,8.1,299,7.7,15,1634,42.2,192,1442,1588,41,163,-38,1425,46,62,1.6,38784
39846,T001038,Total male and female,GM0530,Hellevoetsluis,2018JJ00,2018,39992,973,333,8.3,359,9,-26,1728,43.2,208,1520,1649,41.2,141,-18,1508,79,57,1.4,40049
39847,T001038,Total male and female,GM0530,Hellevoetsluis,2019JJ00,2019,40049,974,318,7.9,347,8.7,-29,1827,45.6,253,1574,1703,42.5,150,-7,1553,124,93,2.3,40142
39848,T001038,Total male and female,GM0530,Hellevoetsluis,2020JJ00,2020,40142,977,338,8.4,342,8.5,-4,1817,45.2,200,1617,1647,40.9,171,-40,1476,170,170,4.2,40312
39849,T001038,Total male and female,GM0530,Hellevoetsluis,2021JJ00,2021,40312,981,351,8.7,376,9.3,-25,1815,44.9,189,1626,1529,37.8,174,-19,1355,286,262,6.5,40574
39850,T001038,Total male and female,GM0530,Hellevoetsluis,2022JJ00,2022,40574,988,365,9,371,9.1,-6,2055,50.4,304,1751,1646,40.4,123,3,1523,409,356,8.8,40930
39922,T001038,Total male and female,GM0794,Helmond,2012JJ00,2012,88801,1668,1021,11.5,651,7.3,370,2941,33.1,567,2374,3086,34.7,524,-41,2562,-145,222,2.5,89023
39923,T001038,Total male and female,GM0794,Helmond,2013JJ00,2013,89023,1673,981,11,670,7.5,311,3188,35.8,568,2620,3266,36.6,601,-78,2665,-78,233,2.6,89256
39924,T001038,Total male and female,GM0794,Helmond,2014JJ00,2014,89256,1677,959,10.7,675,7.5,284,3480,38.9,700,2780,3299,36.9,643,-88,2656,181,462,5.2,89718
39925,T001038,Total male and female,GM0794,Helmond,2015JJ00,2015,89718,1686,932,10.4,727,8.1,205,3538,39.3,699,2839,3328,37,700,-87,2628,210,409,4.6,90127
39926,T001038,Total male and female,GM0794,Helmond,2016JJ00,2016,90127,1694,920,10.2,721,8,199,3657,40.5,690,2967,3376,37.4,490,-27,2886,281,475,5.3,90602
39927,T001038,Total male and female,GM0794,Helmond,2017JJ00,2017,90602,1703,890,9.8,727,8,163,4100,45.2,799,3301,3963,43.7,597,-146,3366,137,301,3.3,90903
39928,T001038,Total male and female,GM0794,Helmond,2018JJ00,2018,90903,1709,864,9.5,721,7.9,143,4282,46.9,836,3446,3804,41.7,550,-92,3254,478,621,6.8,91524
39929,T001038,Total male and female,GM0794,Helmond,2019JJ00,2019,91524,1721,914,9.9,711,7.7,203,4407,47.9,1002,3405,3711,40.3,594,-118,3117,696,899,9.8,92423
39930,T001038,Total male and female,GM0794,Helmond,2020JJ00,2020,92423,1738,823,8.9,870,9.4,-47,4317,46.7,889,3428,4061,43.9,625,-128,3436,256,204,2.2,92627
39931,T001038,Total male and female,GM0794,Helmond,2021JJ00,2021,92627,1742,959,10.3,871,9.4,88,4751,51.1,923,3828,3987,42.8,662,-90,3325,764,849,9.2,93476
39932,T001038,Total male and female,GM0794,Helmond,2022JJ00,2022,93476,1758,900,9.6,825,8.8,75,5328,56.6,1476,3852,3979,42.2,781,-97,3198,1349,1422,15.2,94898
39933,T001038,Total male and female,GM0794,Helmond,2023JJ00,2023,94898,1785,850,8.9,877,9.2,-27,5073,53.2,1240,3833,4074,42.7,906,-176,3168,999,976,10.3,95874
40332,T001038,Total male and female,GM0531,Hendrik-Ido-Ambacht,2012JJ00,2012,28257,2648,403,14.2,207,7.3,196,1200,42.2,76,1124,1019,35.8,87,-11,932,181,384,13.6,28641
40333,T001038,Total male and female,GM0531,Hendrik-Ido-Ambacht,2013JJ00,2013,28641,2702,349,12.1,147,5.1,202,1194,41.5,69,1125,1126,39.1,91,-18,1035,68,270,9.4,28911
40334,T001038,Total male and female,GM0531,Hendrik-Ido-Ambacht,2014JJ00,2014,28911,2727,368,12.7,171,5.9,197,1198,41.3,89,1109,1151,39.6,81,-9,1070,47,245,8.5,29156
40335,T001038,Total male and female,GM0531,Hendrik-Ido-Ambacht,2015JJ00,2015,29156,2751,371,12.7,198,6.8,173,1304,44.5,89,1215,1227,41.9,110,-9,1117,77,252,8.6,29408
40336,T001038,Total male and female,GM0531,Hendrik-Ido-Ambacht,2016JJ00,2016,29408,2772,349,11.8,209,7.1,140,1517,51.3,78,1439,1333,45.1,71,1,1262,184,323,11,29731
40337,T001038,Total male and female,GM0531,Hendrik-Ido-Ambacht,2017JJ00,2017,29731,2802,396,13.1,230,7.6,166,2099,69.5,74,2025,1319,43.7,54,-6,1265,780,946,31.8,30677
40338,T001038,Total male and female,GM0531,Hendrik-Ido-Ambacht,2018JJ00,2018,30677,2891,380,12.3,223,7.2,157,1500,48.7,84,1416,1368,44.4,67,6,1301,132,289,9.4,30966
40339,T001038,Total male and female,GM0531,Hendrik-Ido-Ambacht,2019JJ00,2019,30966,2919,406,13.1,228,7.3,178,1538,49.5,80,1458,1480,47.6,77,-11,1403,58,236,7.6,31202
40340,T001038,Total male and female,GM0531,Hendrik-Ido-Ambacht,2020JJ00,2020,31202,2941,417,13.4,251,8,166,1265,40.5,81,1184,1375,44,63,-6,1312,-110,56,1.8,31258
40341,T001038,Total male and female,GM0531,Hendrik-Ido-Ambacht,2021JJ00,2021,31258,2946,377,12,260,8.3,117,1751,55.7,64,1687,1463,46.5,64,-9,1399,288,405,13,31663
40342,T001038,Total male and female,GM0531,Hendrik-Ido-Ambacht,2022JJ00,2022,31663,3107,400,12.5,225,7,175,1702,53.3,260,1442,1357,42.5,90,0,1267,345,520,16.4,32183
40343,T001038,Total male and female,GM0531,Hendrik-Ido-Ambacht,2023JJ00,2023,32183,3158,322,9.9,234,7.2,88,1890,58.3,178,1712,1472,45.4,116,-65,1356,418,506,15.7,32689
40496,T001038,Total male and female,GM0164,Hengelo (O.),2012JJ00,2012,80939,1329,816,10.1,683,8.4,133,2931,36.2,371,2560,3051,37.7,446,-98,2605,-120,13,0.2,80952
40497,T001038,Total male and female,GM0164,Hengelo (O.),2013JJ00,2013,80952,1329,831,10.3,745,9.2,86,2883,35.6,333,2550,2964,36.6,411,-27,2553,-81,5,0.1,80957
40498,T001038,Total male and female,GM0164,Hengelo (O.),2014JJ00,2014,80957,1330,818,10.1,674,8.3,144,3001,37,387,2614,3042,37.6,494,-62,2548,-41,102,1.3,81059
40499,T001038,Total male and female,GM0164,Hengelo (O.),2015JJ00,2015,81059,1331,782,9.6,704,8.7,78,3124,38.5,523,2601,3185,39.3,439,-51,2746,-61,16,0.2,81075
40500,T001038,Total male and female,GM0164,Hengelo (O.),2016JJ00,2016,81075,1331,730,9,764,9.4,-34,3712,45.9,553,3159,3952,48.8,408,-23,3544,-240,-273,-3.4,80802
40501,T001038,Total male and female,GM0164,Hengelo (O.),2017JJ00,2017,80802,1327,700,8.7,750,9.3,-50,3460,42.9,464,2996,3613,44.8,417,-51,3196,-153,-209,-2.6,80593
40502,T001038,Total male and female,GM0164,Hengelo (O.),2018JJ00,2018,80593,1325,685,8.5,824,10.2,-139,3542,43.9,540,3002,3303,41,388,-26,2915,239,90,1.1,80683
40503,T001038,Total male and female,GM0164,Hengelo (O.),2019JJ00,2019,80683,1326,669,8.3,803,9.9,-134,3739,46.2,549,3190,3146,38.9,379,-1,2767,593,457,5.7,81140
40504,T001038,Total male and female,GM0164,Hengelo (O.),2020JJ00,2020,81140,1334,697,8.6,868,10.7,-171,3800,46.9,545,3255,3719,45.9,369,-76,3350,81,-91,-1.1,81049
40505,T001038,Total male and female,GM0164,Hengelo (O.),2021JJ00,2021,81049,1332,707,8.7,852,10.5,-145,4053,49.9,631,3422,3481,42.8,364,-49,3117,572,427,5.3,81476
40506,T001038,Total male and female,GM0164,Hengelo (O.),2022JJ00,2022,81476,1339,719,8.8,866,10.6,-147,4680,57.1,1228,3452,3694,45.1,560,-104,3134,986,835,10.2,82311
40507,T001038,Total male and female,GM0164,Hengelo (O.),2023JJ00,2023,82311,1353,697,8.4,792,9.6,-95,4678,56.6,817,3861,3832,46.3,542,-96,3290,846,747,9.1,83058
40906,T001038,Total male and female,GM0796,s-Hertogenbosch,2012JJ00,2012,141893,1680,1683,11.8,1146,8.1,537,6541,45.9,912,5629,6151,43.2,1008,-239,5143,390,924,6.5,142817
40907,T001038,Total male and female,GM0796,s-Hertogenbosch,2013JJ00,2013,142817,1692,1692,11.8,1075,7.5,617,6567,45.8,859,5708,6269,43.8,831,-144,5438,298,916,6.4,143733
40908,T001038,Total male and female,GM0796,s-Hertogenbosch,2014JJ00,2014,143733,1703,1759,12.2,1106,7.7,653,6732,46.8,835,5897,6967,48.4,920,-98,6047,-235,437,3,144170
40909,T001038,Total male and female,GM0796,s-Hertogenbosch,2015JJ00,2015,150889,1364,1659,11,1105,7.3,554,7482,49.5,930,6552,7314,48.4,890,-129,6424,168,719,4.8,151608
40910,T001038,Total male and female,GM0796,s-Hertogenbosch,2016JJ00,2016,151608,1372,1719,11.3,1217,8,502,8487,55.8,1040,7447,8195,53.9,932,-131,7263,292,803,5.3,152411
40911,T001038,Total male and female,GM0796,s-Hertogenbosch,2017JJ00,2017,152411,1379,1590,10.4,1223,8,367,8518,55.7,1129,7389,7857,51.4,830,-138,7027,661,1023,6.7,153434
40912,T001038,Total male and female,GM0796,s-Hertogenbosch,2018JJ00,2018,153434,1392,1489,9.7,1351,8.8,138,8218,53.4,1313,6905,7586,49.3,1028,-185,6558,632,771,5,154205
40913,T001038,Total male and female,GM0796,s-Hertogenbosch,2019JJ00,2019,154205,1402,1540,10,1331,8.6,209,8475,54.8,1304,7171,7774,50.3,934,-122,6840,701,906,5.9,155111
40914,T001038,Total male and female,GM0796,s-Hertogenbosch,2020JJ00,2020,155111,1410,1524,9.8,1493,9.6,31,8338,53.7,1092,7246,7983,51.4,708,-86,7275,355,379,2.4,155490
40915,T001038,Total male and female,GM0796,s-Hertogenbosch,2021JJ00,2021,155490,1414,1696,10.9,1500,9.6,196,8680,55.6,1293,7387,7826,50.2,855,-105,6971,854,1048,6.7,156538
40916,T001038,Total male and female,GM0796,s-Hertogenbosch,2022JJ00,2022,156538,1430,1580,10,1522,9.7,58,10105,64.1,2740,7365,7939,50.4,1160,-206,6779,2166,2215,14.1,158753
40917,T001038,Total male and female,GM0796,s-Hertogenbosch,2023JJ00,2023,158753,1450,1465,9.2,1500,9.4,-35,10236,64.1,2032,8204,8196,51.3,1133,-192,7063,2040,2004,12.6,160757
41316,T001038,Total male and female,GM0252,Heumen,2012JJ00,2012,16413,412,144,8.8,114,6.9,30,732,44.5,54,678,722,43.9,51,-2,671,10,42,2.6,16455
41317,T001038,Total male and female,GM0252,Heumen,2013JJ00,2013,16455,413,97,5.9,117,7.1,-20,642,39.2,60,582,744,45.4,64,-3,680,-102,-121,-7.4,16334
41318,T001038,Total male and female,GM0252,Heumen,2014JJ00,2014,16334,410,126,7.7,116,7.1,10,831,50.8,69,762,793,48.5,36,9,757,38,49,3,16383
41319,T001038,Total male and female,GM0252,Heumen,2015JJ00,2015,16383,411,99,6,150,9.2,-51,855,52.2,82,773,826,50.5,70,-6,756,29,-23,-1.4,16360
41320,T001038,Total male and female,GM0252,Heumen,2016JJ00,2016,16360,411,126,7.7,142,8.6,-16,1551,94.5,75,1476,1423,86.7,55,-4,1368,128,115,7,16475
41321,T001038,Total male and female,GM0252,Heumen,2017JJ00,2017,16475,414,126,7.7,154,9.4,-28,974,59.1,69,905,959,58.2,72,-10,887,15,-13,-0.8,16462
41322,T001038,Total male and female,GM0252,Heumen,2018JJ00,2018,16462,414,132,8,129,7.8,3,973,59.1,72,901,952,57.8,65,-4,887,21,24,1.5,16486
41323,T001038,Total male and female,GM0252,Heumen,2019JJ00,2019,16486,415,98,6,159,9.7,-61,984,59.7,83,901,956,58,54,-2,902,28,-32,-1.9,16454
41324,T001038,Total male and female,GM0252,Heumen,2020JJ00,2020,16454,414,140,8.5,166,10.1,-26,1025,62.1,65,960,883,53.5,67,-7,816,142,115,7,16569
41325,T001038,Total male and female,GM0252,Heumen,2021JJ00,2021,16569,417,130,7.7,152,9,-22,1488,88.2,97,1391,858,50.9,75,-13,783,630,606,36.6,17175
41326,T001038,Total male and female,GM0252,Heumen,2022JJ00,2022,17175,432,147,8.6,175,10.3,-28,1158,68.1,239,919,1480,87.1,126,-50,1354,-322,-351,-20.4,16824
41327,T001038,Total male and female,GM0252,Heumen,2023JJ00,2023,16824,423,138,8.2,162,9.6,-24,1066,63.3,143,923,1030,61.2,98,-10,932,36,12,0.7,16836
41398,T001038,Total male and female,GM0797,Heusden,2012JJ00,2012,43112,547,420,9.7,302,7,118,1504,34.8,197,1307,1497,34.7,156,-44,1341,7,132,3.1,43244
41399,T001038,Total male and female,GM0797,Heusden,2013JJ00,2013,43244,548,367,8.5,303,7,64,1400,32.4,250,1150,1544,35.7,187,-31,1357,-144,-79,-1.8,43165
41400,T001038,Total male and female,GM0797,Heusden,2014JJ00,2014,43165,547,411,9.5,287,6.7,124,1530,35.5,244,1286,1693,39.2,251,-65,1442,-163,-33,-0.8,43132
41401,T001038,Total male and female,GM0797,Heusden,2015JJ00,2015,43132,547,369,8.5,324,7.5,45,1834,42.5,302,1532,1737,40.2,229,-39,1508,97,142,3.3,43274
41402,T001038,Total male and female,GM0797,Heusden,2016JJ00,2016,43274,549,412,9.5,331,7.6,81,1764,40.6,294,1470,1603,36.9,166,-41,1437,161,242,5.6,43516
41403,T001038,Total male and female,GM0797,Heusden,2017JJ00,2017,43516,552,383,8.8,352,8.1,31,1973,45.2,304,1669,1797,41.2,233,-61,1564,176,207,4.8,43723
41404,T001038,Total male and female,GM0797,Heusden,2018JJ00,2018,43723,554,372,8.5,337,7.7,35,2167,49.3,423,1744,1789,40.7,244,-58,1545,378,412,9.4,44135
41405,T001038,Total male and female,GM0797,Heusden,2019JJ00,2019,44135,560,397,8.9,364,8.2,33,2340,52.7,374,1966,1813,40.8,284,-48,1529,527,557,12.6,44692
41406,T001038,Total male and female,GM0797,Heusden,2020JJ00,2020,44692,567,369,8.2,423,9.4,-54,2230,49.7,358,1872,1863,41.5,251,-56,1612,367,313,7,45005
41407,T001038,Total male and female,GM0797,Heusden,2021JJ00,2021,45005,571,455,10,422,9.3,33,2426,53.6,461,1965,1906,42.1,261,-52,1645,520,552,12.3,45557
41408,T001038,Total male and female,GM0797,Heusden,2022JJ00,2022,45557,578,415,9.1,392,8.6,23,2143,46.9,565,1578,1893,41.4,350,-84,1543,250,273,6,45830
41409,T001038,Total male and female,GM0797,Heusden,2023JJ00,2023,45830,581,397,8.6,470,10.2,-73,2306,50.2,438,1868,2038,44.4,334,-85,1704,268,196,4.3,46026
41562,T001038,Total male and female,GM0534,Hillegom,2012JJ00,2012,20831,1612,197,9.4,204,9.8,-7,913,43.8,117,796,869,41.7,123,-27,746,44,37,1.8,20868
41563,T001038,Total male and female,GM0534,Hillegom,2013JJ00,2013,20868,1618,191,9.1,194,9.3,-3,953,45.6,146,807,874,41.8,82,-9,792,79,76,3.6,20944
41564,T001038,Total male and female,GM0534,Hillegom,2014JJ00,2014,20944,1624,205,9.8,217,10.3,-12,1073,51,169,904,907,43.1,123,-21,784,166,157,7.5,21101
41565,T001038,Total male and female,GM0534,Hillegom,2015JJ00,2015,21101,1636,189,9,200,9.5,-11,1050,49.8,175,875,1045,49.5,128,-14,917,5,-12,-0.6,21089
41566,T001038,Total male and female,GM0534,Hillegom,2016JJ00,2016,21089,1639,174,8.2,207,9.8,-33,1289,60.8,147,1142,1033,48.7,142,-20,891,256,227,10.8,21316
41567,T001038,Total male and female,GM0534,Hillegom,2017JJ00,2017,21316,1656,226,10.5,216,10,10,1560,72.3,171,1389,1075,49.9,108,3,967,485,496,23.3,21812
41568,T001038,Total male and female,GM0534,Hillegom,2018JJ00,2018,21812,1695,225,10.3,234,10.7,-9,1228,56.1,157,1071,1063,48.6,77,-4,986,165,154,7.1,21966
41569,T001038,Total male and female,GM0534,Hillegom,2019JJ00,2019,21966,1707,218,9.9,218,9.9,0,1235,55.9,197,1038,992,44.9,94,3,898,243,243,11.1,22209
41570,T001038,Total male and female,GM0534,Hillegom,2020JJ00,2020,22209,1726,210,9.5,219,9.9,-9,1183,53.3,207,976,1181,53.2,117,-25,1064,2,-12,-0.5,22197
41571,T001038,Total male and female,GM0534,Hillegom,2021JJ00,2021,22197,1725,239,10.7,278,12.5,-39,1295,58.2,220,1075,1141,51.3,154,-32,987,154,115,5.2,22312
41572,T001038,Total male and female,GM0534,Hillegom,2022JJ00,2022,22312,1735,204,9.1,227,10.1,-23,1422,63.5,361,1061,1257,56.2,150,-18,1107,165,141,6.3,22453
41573,T001038,Total male and female,GM0534,Hillegom,2023JJ00,2023,22453,1746,222,9.8,248,11,-26,1622,71.7,332,1290,1227,54.2,226,-30,1001,395,369,16.4,22822
41644,T001038,Total male and female,GM0798,Hilvarenbeek,2012JJ00,2012,15047,159,121,8,89,5.9,32,427,28.3,48,379,421,27.9,41,0,380,6,39,2.6,15086
41645,T001038,Total male and female,GM0798,Hilvarenbeek,2013JJ00,2013,15086,159,109,7.2,110,7.3,-1,474,31.4,37,437,469,31.1,34,-3,435,5,6,0.4,15092
41646,T001038,Total male and female,GM0798,Hilvarenbeek,2014JJ00,2014,15092,159,104,6.9,107,7.1,-3,435,28.9,50,385,480,31.9,40,-4,440,-45,-50,-3.3,15042
41647,T001038,Total male and female,GM0798,Hilvarenbeek,2015JJ00,2015,15042,158,126,8.3,115,7.6,11,595,39.4,68,527,489,32.4,37,1,452,106,122,8.1,15164
41648,T001038,Total male and female,GM0798,Hilvarenbeek,2016JJ00,2016,15164,160,123,8.1,113,7.4,10,627,41.2,77,550,517,34,54,-2,463,110,119,7.8,15283
41649,T001038,Total male and female,GM0798,Hilvarenbeek,2017JJ00,2017,15283,161,103,6.7,126,8.2,-23,704,45.9,44,660,597,39,33,-3,564,107,83,5.4,15366
41650,T001038,Total male and female,GM0798,Hilvarenbeek,2018JJ00,2018,15366,162,147,9.6,153,10,-6,564,36.7,44,520,590,38.4,73,-9,517,-26,-32,-2.1,15334
41651,T001038,Total male and female,GM0798,Hilvarenbeek,2019JJ00,2019,15334,162,112,7.3,116,7.5,-4,698,45.2,67,631,512,33.2,53,-3,459,186,184,12,15518
41652,T001038,Total male and female,GM0798,Hilvarenbeek,2020JJ00,2020,15518,164,152,9.7,154,9.9,-2,768,49.2,72,696,586,37.5,37,-6,549,182,180,11.6,15698
41653,T001038,Total male and female,GM0798,Hilvarenbeek,2021JJ00,2021,15698,166,134,8.5,144,9.1,-10,662,42,70,592,539,34.2,70,-8,469,123,112,7.1,15810
41654,T001038,Total male and female,GM0798,Hilvarenbeek,2022JJ00,2022,15810,167,143,9,144,9.1,-1,715,45,186,529,576,36.3,76,-9,500,139,139,8.8,15949
41655,T001038,Total male and female,GM0798,Hilvarenbeek,2023JJ00,2023,15949,168,141,8.8,143,9,-2,574,36,84,490,559,35,62,-10,497,15,12,0.8,15961
41726,T001038,Total male and female,GM0402,Hilversum,2012JJ00,2012,85537,1875,910,10.6,874,10.2,36,5184,60.4,960,4224,4740,55.3,836,-171,3904,444,480,5.6,86017
41727,T001038,Total male and female,GM0402,Hilversum,2013JJ00,2013,86017,1886,823,9.5,867,10.1,-44,4987,57.8,985,4002,4536,52.6,802,-60,3734,451,409,4.8,86426
41728,T001038,Total male and female,GM0402,Hilversum,2014JJ00,2014,86426,1894,911,10.5,894,10.3,17,5749,66.2,1240,4509,5031,58,826,-166,4205,718,735,8.5,87161
41729,T001038,Total male and female,GM0402,Hilversum,2015JJ00,2015,87161,1911,951,10.9,921,10.5,30,6090,69.6,1444,4646,5456,62.4,876,-91,4580,634,669,7.7,87830
41730,T001038,Total male and female,GM0402,Hilversum,2016JJ00,2016,87830,1926,858,9.7,885,10,-27,6697,75.8,1451,5246,5617,63.6,816,-76,4801,1080,1058,12,88888
41731,T001038,Total male and female,GM0402,Hilversum,2017JJ00,2017,88888,1949,873,9.8,901,10.1,-28,6749,75.7,1481,5268,6083,68.2,899,-96,5184,666,633,7.1,89521
41732,T001038,Total male and female,GM0402,Hilversum,2018JJ00,2018,89521,1963,966,10.7,916,10.2,50,6570,73.1,1736,4834,5904,65.7,900,-96,5004,666,717,8,90238
41733,T001038,Total male and female,GM0402,Hilversum,2019JJ00,2019,90238,1978,893,9.9,879,9.7,14,6990,77.2,1806,5184,6408,70.8,957,-88,5451,582,593,6.6,90831
41734,T001038,Total male and female,GM0402,Hilversum,2020JJ00,2020,90831,1991,915,10.1,922,10.1,-7,6579,72.3,1387,5192,6167,67.7,911,-106,5256,412,404,4.4,91235
41735,T001038,Total male and female,GM0402,Hilversum,2021JJ00,2021,91235,2000,941,10.3,958,10.5,-17,6790,74.2,1463,5327,6270,68.5,906,-89,5364,520,498,5.5,91733
41736,T001038,Total male and female,GM0402,Hilversum,2022JJ00,2022,91733,2013,942,10.2,910,9.8,32,8049,87,2645,5404,6471,69.9,1006,-73,5465,1578,1612,17.6,93345
41737,T001038,Total male and female,GM0402,Hilversum,2023JJ00,2023,93345,2047,847,9,899,9.6,-52,7283,77.6,1981,5302,6116,65.1,947,-105,5169,1167,1090,11.7,94435
42061,T001038,Total male and female,GM1963,Hoeksche Waard,2019JJ00,2019,86656,322,782,9,796,9.1,-14,2908,33.4,280,2628,2134,24.5,214,-24,1920,774,745,8.6,87401
42062,T001038,Total male and female,GM1963,Hoeksche Waard,2020JJ00,2020,87401,325,792,9,858,9.8,-66,2889,32.9,205,2684,2178,24.8,185,-30,1993,711,646,7.4,88047
42063,T001038,Total male and female,GM1963,Hoeksche Waard,2021JJ00,2021,88047,327,839,9.5,852,9.6,-13,3074,34.8,204,2870,2392,27.1,190,-5,2202,682,668,7.6,88715
42064,T001038,Total male and female,GM1963,Hoeksche Waard,2022JJ00,2022,88715,330,772,8.7,890,10,-118,3780,42.4,574,3206,2615,29.3,337,-38,2278,1165,1045,11.8,89760
42065,T001038,Total male and female,GM1963,Hoeksche Waard,2023JJ00,2023,89760,334,787,8.7,859,9.5,-72,3310,36.8,450,2860,2741,30.5,316,-38,2425,569,496,5.5,90256
42464,T001038,Total male and female,GM1735,Hof van Twente,2012JJ00,2012,35599,167,268,7.6,354,10,-86,1100,31.1,197,903,1399,39.5,141,-26,1258,-299,-384,-10.8,35215
42465,T001038,Total male and female,GM1735,Hof van Twente,2013JJ00,2013,35215,166,288,8.2,384,10.9,-96,946,26.9,110,836,1069,30.5,115,-30,954,-123,-218,-6.2,34997
42466,T001038,Total male and female,GM1735,Hof van Twente,2014JJ00,2014,34997,165,285,8.2,377,10.8,-92,1070,30.6,120,950,1055,30.2,91,-19,964,15,-80,-2.3,34917
42467,T001038,Total male and female,GM1735,Hof van Twente,2015JJ00,2015,34917,164,255,7.3,396,11.3,-141,1143,32.8,162,981,1039,29.8,126,-7,913,104,-36,-1,34881
42468,T001038,Total male and female,GM1735,Hof van Twente,2016JJ00,2016,34881,164,282,8.1,382,10.9,-100,1360,38.9,187,1173,1133,32.4,95,-20,1038,227,130,3.7,35011
42469,T001038,Total male and female,GM1735,Hof van Twente,2017JJ00,2017,35011,165,277,7.9,407,11.6,-130,1297,37.1,175,1122,1252,35.8,152,-22,1100,45,-81,-2.3,34930
42470,T001038,Total male and female,GM1735,Hof van Twente,2018JJ00,2018,34930,164,258,7.4,398,11.4,-140,1410,40.4,274,1136,1260,36.1,167,-26,1093,150,10,0.3,34940
42471,T001038,Total male and female,GM1735,Hof van Twente,2019JJ00,2019,34940,164,246,7,369,10.5,-123,1367,39.1,219,1148,1171,33.5,150,-2,1021,196,77,2.2,35017
42472,T001038,Total male and female,GM1735,Hof van Twente,2020JJ00,2020,35017,165,260,7.4,417,11.9,-157,1417,40.5,211,1206,1241,35.4,164,-32,1077,176,23,0.7,35040
42473,T001038,Total male and female,GM1735,Hof van Twente,2021JJ00,2021,35040,165,288,8.2,475,13.6,-187,1396,39.8,182,1214,1193,34,174,-22,1019,203,16,0.5,35056
42474,T001038,Total male and female,GM1735,Hof van Twente,2022JJ00,2022,35056,165,283,8,395,11.2,-112,1657,47,448,1209,1146,32.5,168,-17,978,511,399,11.4,35455
42475,T001038,Total male and female,GM1735,Hof van Twente,2023JJ00,2023,35455,167,280,7.9,469,13.2,-189,1544,43.6,299,1245,1363,38.4,193,-38,1170,181,-9,-0.3,35446
42553,T001038,Total male and female,GM1966,Het Hogeland,2019JJ00,2019,47888,99,415,8.7,490,10.2,-75,1852,38.7,189,1663,1863,38.9,145,-26,1718,-11,-87,-1.8,47801
42554,T001038,Total male and female,GM1966,Het Hogeland,2020JJ00,2020,47801,99,386,8.1,495,10.4,-109,1916,40.1,193,1723,1775,37.1,116,-20,1659,141,33,0.7,47834
42555,T001038,Total male and female,GM1966,Het Hogeland,2021JJ00,2021,47834,99,413,8.6,504,10.5,-91,2008,41.9,161,1847,1729,36.1,159,-23,1570,279,188,3.9,48022
42556,T001038,Total male and female,GM1966,Het Hogeland,2022JJ00,2022,48022,101,367,7.6,555,11.5,-188,2608,54.2,419,2189,2141,44.5,191,-31,1950,467,276,5.7,48298
42557,T001038,Total male and female,GM1966,Het Hogeland,2023JJ00,2023,48298,101,404,8.4,530,11,-126,2485,51.5,210,2275,2434,50.4,219,-36,2215,51,-74,-1.5,48224
42628,T001038,Total male and female,GM1911,Hollands Kroon,2012JJ00,2012,47703,133,443,9.3,322,6.8,121,1417,29.7,199,1218,1565,32.8,175,-35,1390,-148,-60,-1.3,47643
42629,T001038,Total male and female,GM1911,Hollands Kroon,2013JJ00,2013,47643,133,390,8.2,321,6.7,69,1402,29.5,246,1156,1615,33.9,160,-16,1455,-213,-141,-3,47502
42630,T001038,Total male and female,GM1911,Hollands Kroon,2014JJ00,2014,47502,133,455,9.6,364,7.7,91,1645,34.6,423,1222,1721,36.2,296,-51,1425,-76,44,0.9,47546
42631,T001038,Total male and female,GM1911,Hollands Kroon,2015JJ00,2015,47546,133,427,9,352,7.4,75,1745,36.7,300,1445,1822,38.3,243,-20,1579,-77,0,0,47546
42632,T001038,Total male and female,GM1911,Hollands Kroon,2016JJ00,2016,47546,133,445,9.4,363,7.6,82,1855,39,241,1614,1886,39.6,189,-30,1697,-31,54,1.1,47600
42633,T001038,Total male and female,GM1911,Hollands Kroon,2017JJ00,2017,47600,133,434,9.1,396,8.3,38,2157,45.3,272,1885,2113,44.4,231,-52,1882,44,81,1.7,47681
42634,T001038,Total male and female,GM1911,Hollands Kroon,2018JJ00,2018,47681,133,428,9,403,8.4,25,2094,43.9,371,1723,1980,41.5,180,-13,1800,114,134,2.8,47815
42635,T001038,Total male and female,GM1911,Hollands Kroon,2019JJ00,2019,47815,134,420,8.7,377,7.8,43,2824,58.7,1055,1769,2248,46.7,495,-189,1753,576,617,12.9,48432
42636,T001038,Total male and female,GM1911,Hollands Kroon,2020JJ00,2020,48432,136,430,8.9,409,8.4,21,2648,54.6,914,1734,2519,51.9,729,-156,1790,129,151,3.1,48583
42637,T001038,Total male and female,GM1911,Hollands Kroon,2021JJ00,2021,48583,136,441,9.1,453,9.3,-12,2630,54,627,2003,2419,49.7,765,-167,1654,211,195,4,48778
42638,T001038,Total male and female,GM1911,Hollands Kroon,2022JJ00,2022,48778,136,452,9.2,438,8.9,14,3258,66.3,1274,1984,2611,53.2,857,-111,1754,647,653,13.4,49431
42639,T001038,Total male and female,GM1911,Hollands Kroon,2023JJ00,2023,49431,138,398,8,436,8.8,-38,2636,53.3,833,1803,2511,50.8,766,-103,1745,125,91,1.8,49522
43284,T001038,Total male and female,GM0118,Hoogeveen,2012JJ00,2012,54889,430,584,10.6,482,8.8,102,1557,28.4,149,1408,1674,30.5,113,6,1561,-117,-15,-0.3,54874
43285,T001038,Total male and female,GM0118,Hoogeveen,2013JJ00,2013,54874,430,536,9.8,498,9.1,38,1458,26.6,147,1311,1698,31,142,-16,1556,-240,-210,-3.8,54664
43286,T001038,Total male and female,GM0118,Hoogeveen,2014JJ00,2014,54664,429,575,10.5,485,8.9,90,1694,30.9,147,1547,1590,29,109,3,1481,104,196,3.6,54860
43287,T001038,Total male and female,GM0118,Hoogeveen,2015JJ00,2015,54860,430,552,10,521,9.5,31,2512,45.6,890,1622,2163,39.3,159,-22,2004,349,380,6.9,55240
43288,T001038,Total male and female,GM0118,Hoogeveen,2016JJ00,2016,55240,433,573,10.4,551,10,22,2656,48.1,666,1990,2605,47.1,183,-59,2422,51,71,1.3,55311
43289,T001038,Total male and female,GM0118,Hoogeveen,2017JJ00,2017,55311,434,582,10.5,542,9.8,40,2425,43.7,359,2066,2092,37.7,118,-12,1974,333,366,6.6,55677
43290,T001038,Total male and female,GM0118,Hoogeveen,2018JJ00,2018,55677,437,484,8.7,584,10.5,-100,2523,45.3,479,2044,2441,43.8,283,-150,2158,82,-15,-0.3,55662
43291,T001038,Total male and female,GM0118,Hoogeveen,2019JJ00,2019,55662,436,536,9.6,520,9.3,16,2289,41.1,305,1984,2268,40.7,207,-57,2061,21,37,0.7,55699
43292,T001038,Total male and female,GM0118,Hoogeveen,2020JJ00,2020,55699,437,513,9.2,597,10.7,-84,2159,38.8,256,1903,2173,39,147,-30,2026,-14,-96,-1.7,55603
43293,T001038,Total male and female,GM0118,Hoogeveen,2021JJ00,2021,55603,436,554,9.9,671,12,-117,2653,47.6,271,2382,2279,40.9,192,-71,2087,374,254,4.6,55857
43294,T001038,Total male and female,GM0118,Hoogeveen,2022JJ00,2022,55857,438,490,8.7,681,12.1,-191,3240,57.7,760,2480,2478,44.1,240,-82,2238,762,576,10.3,56433
43295,T001038,Total male and female,GM0118,Hoogeveen,2023JJ00,2023,56433,442,478,8.5,648,11.5,-170,2791,49.4,492,2299,2459,43.5,329,-111,2130,332,158,2.8,56591
43448,T001038,Total male and female,GM0018,Hoogezand-Sappemeer,2012JJ00,2012,34778,521,318,9.2,341,9.8,-23,1252,36.1,112,1140,1485,42.9,168,-61,1317,-233,-255,-7.3,34523
43449,T001038,Total male and female,GM0018,Hoogezand-Sappemeer,2013JJ00,2013,34523,518,331,9.6,373,10.8,-42,1182,34.3,157,1025,1362,39.6,131,-25,1231,-180,-219,-6.3,34304
43450,T001038,Total male and female,GM0018,Hoogezand-Sappemeer,2014JJ00,2014,34304,515,315,9.2,365,10.6,-50,1420,41.4,200,1220,1342,39.1,185,-93,1157,78,30,0.9,34334
43451,T001038,Total male and female,GM0018,Hoogezand-Sappemeer,2015JJ00,2015,34334,515,293,8.6,370,10.8,-77,1426,41.6,164,1262,1505,43.9,163,-31,1342,-79,-157,-4.6,34177
43452,T001038,Total male and female,GM0018,Hoogezand-Sappemeer,2016JJ00,2016,34177,514,325,9.5,371,10.8,-46,1599,46.7,180,1419,1494,43.7,123,-21,1371,105,55,1.6,34232
43453,T001038,Total male and female,GM0018,Hoogezand-Sappemeer,2017JJ00,2017,34232,515,292,8.5,426,12.5,-134,1705,49.9,171,1534,1648,48.2,108,-28,1540,57,-74,-2.2,34158
43858,T001038,Total male and female,GM0405,Hoorn,2012JJ00,2012,71254,3519,833,11.7,544,7.6,289,2568,36,407,2161,2749,38.6,457,-148,2292,-181,106,1.5,71360
43859,T001038,Total male and female,GM0405,Hoorn,2013JJ00,2013,71360,3536,797,11.1,580,8.1,217,2593,36.2,380,2213,2457,34.3,250,-2,2207,136,343,4.8,71703
43860,T001038,Total male and female,GM0405,Hoorn,2014JJ00,2014,71703,3530,843,11.7,580,8.1,263,2503,34.9,405,2098,2583,36,301,-47,2282,-80,177,2.5,71880
43861,T001038,Total male and female,GM0405,Hoorn,2015JJ00,2015,71880,3530,816,11.3,614,8.5,202,3092,42.9,443,2649,3002,41.7,390,-34,2612,90,292,4.1,72172
43862,T001038,Total male and female,GM0405,Hoorn,2016JJ00,2016,72172,3545,770,10.6,621,8.6,149,3279,45.3,537,2742,3102,42.9,430,-102,2672,177,321,4.4,72493
43863,T001038,Total male and female,GM0405,Hoorn,2017JJ00,2017,72493,3561,796,11,633,8.7,163,3324,45.8,566,2758,3171,43.6,427,-21,2744,153,313,4.3,72806
43864,T001038,Total male and female,GM0405,Hoorn,2018JJ00,2018,72806,3572,717,9.8,635,8.7,82,3381,46.4,642,2739,3261,44.7,458,-120,2803,120,198,2.7,73004
43865,T001038,Total male and female,GM0405,Hoorn,2019JJ00,2019,73004,3582,743,10.2,679,9.3,64,3272,44.7,742,2530,3080,42.1,442,-95,2638,192,257,3.5,73261
43866,T001038,Total male and female,GM0405,Hoorn,2020JJ00,2020,73261,3595,761,10.4,689,9.4,72,3610,49.2,640,2970,3343,45.5,546,-112,2797,267,358,4.9,73619
43867,T001038,Total male and female,GM0405,Hoorn,2021JJ00,2021,73619,3612,769,10.4,747,10.1,22,3849,52,650,3199,3192,43.2,485,-71,2707,657,679,9.2,74298
43868,T001038,Total male and female,GM0405,Hoorn,2022JJ00,2022,74298,3647,801,10.7,664,8.9,137,4067,54.4,1012,3055,3283,43.9,590,-180,2693,784,918,12.4,75216
43869,T001038,Total male and female,GM0405,Hoorn,2023JJ00,2023,75216,3692,732,9.7,719,9.5,13,3721,49.3,829,2892,3301,43.8,628,-213,2673,420,429,5.7,75645
44268,T001038,Total male and female,GM1507,Horst aan de Maas,2012JJ00,2012,41917,222,372,8.9,326,7.8,46,1207,28.8,243,964,1360,32.5,250,-10,1110,-153,-107,-2.6,41810
44269,T001038,Total male and female,GM1507,Horst aan de Maas,2013JJ00,2013,41810,222,367,8.8,361,8.6,6,1183,28.3,286,897,1272,30.5,172,-4,1100,-89,-83,-2,41727
44270,T001038,Total male and female,GM1507,Horst aan de Maas,2014JJ00,2014,41727,221,373,8.9,315,7.6,58,1326,31.8,292,1034,1450,34.8,188,-24,1262,-124,-66,-1.6,41661
44271,T001038,Total male and female,GM1507,Horst aan de Maas,2015JJ00,2015,41661,221,347,8.3,367,8.8,-20,1367,32.8,310,1057,1333,32,202,-21,1131,34,14,0.3,41675
44272,T001038,Total male and female,GM1507,Horst aan de Maas,2016JJ00,2016,41675,221,371,8.9,333,7.9,38,1753,41.8,562,1191,1331,31.8,220,-42,1111,422,464,11.1,42139
44273,T001038,Total male and female,GM1507,Horst aan de Maas,2017JJ00,2017,42139,223,353,8.4,350,8.3,3,1696,40.2,422,1274,1568,37.2,307,-49,1261,128,132,3.1,42271
44274,T001038,Total male and female,GM1507,Horst aan de Maas,2018JJ00,2018,42271,224,345,8.2,372,8.8,-27,1665,39.4,421,1244,1617,38.2,309,-71,1308,48,20,0.5,42291
44275,T001038,Total male and female,GM1507,Horst aan de Maas,2019JJ00,2019,42291,224,353,8.3,419,9.9,-66,1773,41.9,579,1194,1566,37,284,-65,1282,207,138,3.3,42429
44276,T001038,Total male and female,GM1507,Horst aan de Maas,2020JJ00,2020,42429,225,327,7.7,455,10.7,-128,1759,41.4,530,1229,1574,37.1,389,-83,1185,185,58,1.4,42487
44277,T001038,Total male and female,GM1507,Horst aan de Maas,2021JJ00,2021,42487,225,403,9.4,422,9.9,-19,2115,49.5,614,1501,1542,36.1,401,-70,1141,573,552,13,43039
44278,T001038,Total male and female,GM1507,Horst aan de Maas,2022JJ00,2022,43039,228,369,8.5,425,9.8,-56,2438,56.3,1054,1384,1781,41.1,560,-59,1221,657,602,14,43641
44279,T001038,Total male and female,GM1507,Horst aan de Maas,2023JJ00,2023,43641,231,351,8,438,10,-87,2602,59.4,1282,1320,2238,51.1,866,-102,1372,364,276,6.3,43917
44350,T001038,Total male and female,GM0321,Houten,2012JJ00,2012,48309,872,529,10.9,236,4.9,293,1700,35.1,149,1551,1872,38.7,165,-13,1707,-172,120,2.5,48429
44351,T001038,Total male and female,GM0321,Houten,2013JJ00,2013,48429,878,508,10.5,288,5.9,220,1623,33.5,139,1484,1852,38.2,137,-1,1715,-229,-8,-0.2,48421
44352,T001038,Total male and female,GM0321,Houten,2014JJ00,2014,48421,878,501,10.3,250,5.2,251,1929,39.7,173,1756,1965,40.5,166,-33,1799,-36,216,4.5,48637
44353,T001038,Total male and female,GM0321,Houten,2015JJ00,2015,48637,882,522,10.7,300,6.2,222,2058,42.3,153,1905,2153,44.2,162,-8,1991,-95,128,2.6,48765
44354,T001038,Total male and female,GM0321,Houten,2016JJ00,2016,48765,886,479,9.8,283,5.8,196,2524,51.5,196,2328,2187,44.6,172,-23,2015,337,535,11,49300
44355,T001038,Total male and female,GM0321,Houten,2017JJ00,2017,49300,895,527,10.7,301,6.1,226,2306,46.6,191,2115,2248,45.5,155,-20,2093,58,279,5.7,49579
44356,T001038,Total male and female,GM0321,Houten,2018JJ00,2018,49579,902,475,9.5,308,6.2,167,2271,45.7,225,2046,2106,42.3,150,-20,1956,165,332,6.7,49911
44357,T001038,Total male and female,GM0321,Houten,2019JJ00,2019,49911,908,500,10,265,5.3,235,2075,41.5,256,1819,2075,41.5,136,-4,1939,0,235,4.7,50146
44358,T001038,Total male and female,GM0321,Houten,2020JJ00,2020,50146,913,489,9.7,324,6.5,165,2174,43.3,191,1983,2258,45,112,-8,2146,-84,77,1.5,50223
44359,T001038,Total male and female,GM0321,Houten,2021JJ00,2021,50223,914,536,10.7,304,6,232,2127,42.3,185,1942,2259,44.9,134,-10,2125,-132,100,2,50323
44360,T001038,Total male and female,GM0321,Houten,2022JJ00,2022,50323,917,448,8.9,319,6.3,129,2396,47.5,402,1994,2267,44.9,213,-33,2054,129,258,5.1,50581
44361,T001038,Total male and female,GM0321,Houten,2023JJ00,2023,50581,921,491,9.7,309,6.1,182,2448,48.3,353,2095,2362,46.6,224,-16,2138,86,266,5.3,50847
44596,T001038,Total male and female,GM0406,Huizen,2012JJ00,2012,41574,2628,348,8.4,360,8.7,-12,1570,37.8,191,1379,1686,40.6,169,-17,1517,-116,-129,-3.1,41445
44597,T001038,Total male and female,GM0406,Huizen,2013JJ00,2013,41445,2621,353,8.5,343,8.3,10,1511,36.5,179,1332,1722,41.6,183,-3,1539,-211,-200,-4.8,41245
44598,T001038,Total male and female,GM0406,Huizen,2014JJ00,2014,41245,2609,380,9.2,365,8.8,15,1809,43.8,189,1620,1753,42.5,188,3,1565,56,70,1.7,41315
44599,T001038,Total male and female,GM0406,Huizen,2015JJ00,2015,41315,2613,367,8.9,412,10,-45,1980,47.9,194,1786,1878,45.4,204,-40,1674,102,58,1.4,41373
44600,T001038,Total male and female,GM0406,Huizen,2016JJ00,2016,41373,2617,364,8.8,389,9.4,-25,2102,50.8,245,1857,2068,50,207,-28,1861,34,9,0.2,41382
44601,T001038,Total male and female,GM0406,Huizen,2017JJ00,2017,41382,2617,359,8.7,389,9.4,-30,2238,54.1,205,2033,2222,53.7,166,-3,2056,16,-13,-0.3,41369
44602,T001038,Total male and female,GM0406,Huizen,2018JJ00,2018,41369,2617,349,8.4,436,10.6,-87,1966,47.6,204,1762,1972,47.7,215,-24,1757,-6,-96,-2.3,41273
44603,T001038,Total male and female,GM0406,Huizen,2019JJ00,2019,41273,2611,343,8.3,425,10.3,-82,2009,48.7,224,1785,1902,46.1,159,-22,1743,107,0,0,41273
44604,T001038,Total male and female,GM0406,Huizen,2020JJ00,2020,41273,2611,326,7.9,488,11.8,-162,2133,51.8,193,1940,2155,52.3,146,-16,2009,-22,-183,-4.4,41090
44605,T001038,Total male and female,GM0406,Huizen,2021JJ00,2021,41090,2599,359,8.8,470,11.5,-111,2141,52.2,194,1947,2183,53.2,120,3,2063,-42,-152,-3.7,40938
44606,T001038,Total male and female,GM0406,Huizen,2022JJ00,2022,40938,2589,355,8.6,416,10.1,-61,2312,56.3,540,1772,1936,47.1,248,-23,1688,376,314,7.7,41252
44607,T001038,Total male and female,GM0406,Huizen,2023JJ00,2023,41252,2609,353,8.6,506,12.3,-153,2143,52,295,1848,2048,49.7,216,-63,1832,95,-59,-1.4,41193
44760,T001038,Total male and female,GM0677,Hulst,2012JJ00,2012,27632,137,198,7.2,260,9.4,-62,949,34.4,383,566,1004,36.4,240,-38,764,-55,-118,-4.3,27514
44761,T001038,Total male and female,GM0677,Hulst,2013JJ00,2013,27514,137,171,6.2,289,10.5,-118,957,34.9,398,559,969,35.3,253,-49,716,-12,-126,-4.6,27388
44762,T001038,Total male and female,GM0677,Hulst,2014JJ00,2014,27388,136,228,8.3,270,9.9,-42,956,34.9,373,583,940,34.3,250,-31,690,16,-28,-1,27360
44763,T001038,Total male and female,GM0677,Hulst,2015JJ00,2015,27360,136,230,8.4,295,10.8,-65,920,33.6,332,588,844,30.8,278,-72,566,76,12,0.4,27372
44764,T001038,Total male and female,GM0677,Hulst,2016JJ00,2016,27372,136,196,7.2,283,10.3,-87,1012,37,387,625,903,33,237,-15,666,109,23,0.8,27395
44765,T001038,Total male and female,GM0677,Hulst,2017JJ00,2017,27395,136,207,7.5,298,10.9,-91,1138,41.5,404,734,968,35.3,236,-10,732,170,77,2.8,27472
44766,T001038,Total male and female,GM0677,Hulst,2018JJ00,2018,27472,136,227,8.3,289,10.5,-62,1069,38.9,415,654,951,34.6,248,-12,703,118,52,1.9,27524
44767,T001038,Total male and female,GM0677,Hulst,2019JJ00,2019,27524,136,182,6.6,277,10.1,-95,1026,37.3,355,671,898,32.6,206,-11,692,128,32,1.2,27556
44768,T001038,Total male and female,GM0677,Hulst,2020JJ00,2020,27556,137,202,7.3,320,11.6,-118,1053,38.2,360,693,918,33.3,220,-19,698,135,19,0.7,27575
44769,T001038,Total male and female,GM0677,Hulst,2021JJ00,2021,27575,137,207,7.5,322,11.7,-115,960,34.8,307,653,888,32.2,226,-25,662,72,-42,-1.5,27533
44770,T001038,Total male and female,GM0677,Hulst,2022JJ00,2022,27533,137,201,7.3,340,12.3,-139,1150,41.7,451,699,947,34.4,302,-22,645,203,63,2.3,27596
44771,T001038,Total male and female,GM0677,Hulst,2023JJ00,2023,27596,137,183,6.7,346,12.6,-163,924,33.6,261,663,1025,37.3,228,-17,797,-101,-266,-9.6,27330
45416,T001038,Total male and female,GM0353,IJsselstein,2012JJ00,2012,34271,1620,379,11.1,216,6.3,163,1314,38.4,113,1201,1493,43.6,92,4,1401,-179,-17,-0.5,34254
45417,T001038,Total male and female,GM0353,IJsselstein,2013JJ00,2013,34254,1623,353,10.3,190,5.5,163,1373,40.1,134,1239,1515,44.2,145,3,1370,-142,21,0.6,34275
45418,T001038,Total male and female,GM0353,IJsselstein,2014JJ00,2014,34275,1624,335,9.8,233,6.8,102,1393,40.8,139,1254,1713,50.1,130,-8,1583,-320,-214,-6.2,34061
45419,T001038,Total male and female,GM0353,IJsselstein,2015JJ00,2015,34061,1614,332,9.7,218,6.4,114,1628,47.8,153,1475,1702,49.9,162,-41,1540,-74,40,1.2,34101
45420,T001038,Total male and female,GM0353,IJsselstein,2016JJ00,2016,34101,1616,324,9.5,246,7.2,78,1691,49.5,166,1525,1661,48.6,130,-18,1531,30,107,3.1,34208
45421,T001038,Total male and female,GM0353,IJsselstein,2017JJ00,2017,34208,1621,350,10.2,221,6.5,129,1663,48.5,141,1522,1698,49.6,129,-24,1569,-35,94,2.7,34302
45422,T001038,Total male and female,GM0353,IJsselstein,2018JJ00,2018,34302,1628,311,9.1,265,7.7,46,1500,43.8,150,1350,1685,49.2,136,-25,1549,-185,-142,-4.1,34160
45423,T001038,Total male and female,GM0353,IJsselstein,2019JJ00,2019,34160,1621,298,8.7,293,8.6,5,1455,42.6,198,1257,1511,44.3,107,-5,1404,-56,-51,-1.5,34109
45424,T001038,Total male and female,GM0353,IJsselstein,2020JJ00,2020,34109,1619,311,9.2,329,9.7,-18,1510,44.5,147,1363,1783,52.5,99,-8,1684,-273,-290,-8.5,33819
45425,T001038,Total male and female,GM0353,IJsselstein,2021JJ00,2021,33819,1605,321,9.5,305,9.1,16,1395,41.5,115,1280,1798,53.5,122,-10,1676,-403,-390,-11.5,33429
45426,T001038,Total male and female,GM0353,IJsselstein,2022JJ00,2022,33429,1591,285,8.5,301,9,-16,1606,48,305,1301,1527,45.6,154,-8,1373,79,63,1.9,33492
45427,T001038,Total male and female,GM0353,IJsselstein,2023JJ00,2023,33492,1594,279,8.3,303,9.1,-24,1559,46.6,190,1369,1606,48,119,-8,1487,-47,-71,-2.1,33421
46236,T001038,Total male and female,GM1884,Kaag en Braassem,2012JJ00,2012,25737,406,253,9.8,182,7.1,71,705,27.4,83,622,799,31.1,97,-17,702,-94,-22,-0.9,25715
46237,T001038,Total male and female,GM1884,Kaag en Braassem,2013JJ00,2013,25715,406,247,9.6,177,6.9,70,804,31.2,109,695,845,32.8,78,-14,767,-41,30,1.2,25745
46238,T001038,Total male and female,GM1884,Kaag en Braassem,2014JJ00,2014,25745,407,227,8.8,209,8.1,18,1025,39.7,163,862,944,36.6,103,-6,841,81,99,3.8,25844
46239,T001038,Total male and female,GM1884,Kaag en Braassem,2015JJ00,2015,25844,408,205,7.9,208,8,-3,1277,49.2,136,1141,1009,38.8,124,-27,885,268,264,10.2,26108
46240,T001038,Total male and female,GM1884,Kaag en Braassem,2016JJ00,2016,26108,413,248,9.5,212,8.1,36,1303,49.7,166,1137,1074,40.9,120,-4,954,229,266,10.2,26374
46241,T001038,Total male and female,GM1884,Kaag en Braassem,2017JJ00,2017,26374,417,222,8.4,197,7.4,25,1255,47.4,138,1117,1025,38.7,94,-11,931,230,251,9.5,26625
46242,T001038,Total male and female,GM1884,Kaag en Braassem,2018JJ00,2018,26625,421,218,8.2,213,8,5,1304,48.8,180,1124,1067,39.9,119,-17,948,237,241,9.1,26866
46243,T001038,Total male and female,GM1884,Kaag en Braassem,2019JJ00,2019,26866,425,285,10.5,215,7.9,70,1427,52.7,159,1268,1064,39.3,133,-25,931,363,431,16,27297
46244,T001038,Total male and female,GM1884,Kaag en Braassem,2020JJ00,2020,27297,432,267,9.7,218,8,49,1338,48.8,127,1211,1142,41.6,69,6,1073,196,244,8.9,27541
46245,T001038,Total male and female,GM1884,Kaag en Braassem,2021JJ00,2021,27541,435,308,11.1,227,8.2,81,1392,50.2,156,1236,1122,40.5,75,-4,1047,270,354,12.9,27895
46246,T001038,Total male and female,GM1884,Kaag en Braassem,2022JJ00,2022,27895,442,287,10.2,222,7.9,65,1765,62.5,426,1339,1154,40.9,164,-10,990,611,678,24.3,28573
46247,T001038,Total male and female,GM1884,Kaag en Braassem,2023JJ00,2023,28573,453,306,10.6,225,7.8,81,1715,59.4,195,1520,1198,41.5,171,-1,1027,517,595,20.8,29168
46400,T001038,Total male and female,GM0166,Kampen,2012JJ00,2012,50705,355,662,13,368,7.2,294,1349,26.5,178,1171,1424,28,146,-5,1278,-75,219,4.3,50924
46401,T001038,Total male and female,GM0166,Kampen,2013JJ00,2013,50924,358,671,13.2,351,6.9,320,1338,26.2,196,1142,1489,29.2,199,-18,1290,-151,168,3.3,51092
46402,T001038,Total male and female,GM0166,Kampen,2014JJ00,2014,51092,359,638,12.4,367,7.2,271,1620,31.6,167,1453,1552,30.3,216,-5,1336,68,340,6.7,51432
46403,T001038,Total male and female,GM0166,Kampen,2015JJ00,2015,51432,362,614,11.9,377,7.3,237,1770,34.2,236,1534,1492,28.9,192,-12,1300,278,518,10.1,51950
46404,T001038,Total male and female,GM0166,Kampen,2016JJ00,2016,51950,365,708,13.6,388,7.4,320,1873,35.9,183,1690,1630,31.2,154,3,1476,243,561,10.8,52511
46405,T001038,Total male and female,GM0166,Kampen,2017JJ00,2017,52511,369,626,11.8,358,6.8,268,2020,38.2,208,1812,1539,29.1,135,9,1404,481,748,14.2,53259
46406,T001038,Total male and female,GM0166,Kampen,2018JJ00,2018,53259,375,648,12.1,463,8.7,185,2065,38.6,218,1847,1730,32.3,142,4,1588,335,520,9.8,53779
46407,T001038,Total male and female,GM0166,Kampen,2019JJ00,2019,53779,378,629,11.6,398,7.4,231,1912,35.4,263,1649,1599,29.6,150,-14,1449,313,540,10,54319
46408,T001038,Total male and female,GM0166,Kampen,2020JJ00,2020,54319,382,637,11.7,476,8.8,161,1784,32.8,205,1579,1786,32.8,155,-9,1631,-2,155,2.9,54474
46409,T001038,Total male and female,GM0166,Kampen,2021JJ00,2021,54474,383,692,12.7,439,8,253,1754,32.1,213,1541,1690,30.9,174,-14,1516,64,317,5.8,54791
46410,T001038,Total male and female,GM0166,Kampen,2022JJ00,2022,54791,388,650,11.8,470,8.5,180,2510,45.5,630,1880,1871,33.9,245,-12,1626,639,823,15,55614
46411,T001038,Total male and female,GM0166,Kampen,2023JJ00,2023,55614,394,600,10.7,434,7.8,166,2399,42.9,503,1896,2003,35.8,235,-23,1768,396,563,10.1,56177
46564,T001038,Total male and female,GM0678,Kapelle,2012JJ00,2012,12398,334,134,10.8,87,7,47,521,41.9,35,486,468,37.6,24,0,444,53,97,7.8,12495
46565,T001038,Total male and female,GM0678,Kapelle,2013JJ00,2013,12495,337,129,10.3,91,7.3,38,507,40.6,55,452,540,43.2,55,-6,485,-33,5,0.4,12500
46566,T001038,Total male and female,GM0678,Kapelle,2014JJ00,2014,12500,337,128,10.2,79,6.3,49,498,39.8,50,448,501,40,25,2,476,-3,45,3.6,12545
46567,T001038,Total male and female,GM0678,Kapelle,2015JJ00,2015,12545,338,126,10,101,8,25,589,46.8,75,514,520,41.3,37,-12,483,69,94,7.5,12639
46568,T001038,Total male and female,GM0678,Kapelle,2016JJ00,2016,12639,340,120,9.5,116,9.2,4,615,48.7,95,520,636,50.4,59,-1,577,-21,-17,-1.3,12622
46569,T001038,Total male and female,GM0678,Kapelle,2017JJ00,2017,12622,340,118,9.3,95,7.5,23,706,55.7,46,660,630,49.7,32,0,598,76,98,7.8,12720
46570,T001038,Total male and female,GM0678,Kapelle,2018JJ00,2018,12720,343,106,8.3,100,7.8,6,630,49.4,55,575,567,44.5,38,-7,529,63,65,5.1,12785
46571,T001038,Total male and female,GM0678,Kapelle,2019JJ00,2019,12785,344,114,8.9,111,8.7,3,658,51.6,80,578,750,58.9,61,-18,689,-92,-90,-7,12695
46572,T001038,Total male and female,GM0678,Kapelle,2020JJ00,2020,12695,342,132,10.3,105,8.2,27,721,56.4,72,649,558,43.6,30,-5,528,163,187,14.7,12882
46573,T001038,Total male and female,GM0678,Kapelle,2021JJ00,2021,12882,347,129,10,112,8.6,17,679,52.4,53,626,557,43,42,-1,515,122,138,10.7,13020
46574,T001038,Total male and female,GM0678,Kapelle,2022JJ00,2022,13020,351,121,9.3,114,8.7,7,716,54.9,187,529,692,53.1,75,-7,617,24,31,2.4,13051
46575,T001038,Total male and female,GM0678,Kapelle,2023JJ00,2023,13051,351,102,7.8,99,7.6,3,606,46.5,97,509,651,50,66,-5,585,-45,-42,-3.2,13009
46728,T001038,Total male and female,GM0537,Katwijk,2012JJ00,2012,62476,2546,781,12.5,483,7.7,298,1597,25.5,246,1351,1696,27.1,214,-35,1482,-99,212,3.4,62688
46729,T001038,Total male and female,GM0537,Katwijk,2013JJ00,2013,62688,2555,760,12.1,533,8.5,227,1599,25.5,262,1337,1739,27.7,271,-85,1468,-140,94,1.5,62782
46730,T001038,Total male and female,GM0537,Katwijk,2014JJ00,2014,62782,2558,781,12.4,512,8.1,269,2132,33.7,298,1834,1550,24.5,250,-47,1300,582,851,13.6,63633
46731,T001038,Total male and female,GM0537,Katwijk,2015JJ00,2015,63633,2593,724,11.3,507,7.9,217,2762,43.2,1139,1623,2375,37.1,237,-50,2138,387,606,9.5,64239
46732,T001038,Total male and female,GM0537,Katwijk,2016JJ00,2016,64239,2610,737,11.4,551,8.6,186,2664,41.4,642,2022,2560,39.8,255,-55,2305,104,293,4.6,64532
46733,T001038,Total male and female,GM0537,Katwijk,2017JJ00,2017,64532,2622,753,11.6,520,8,233,2168,33.5,287,1881,1978,30.6,218,-34,1760,190,424,6.6,64956
46734,T001038,Total male and female,GM0537,Katwijk,2018JJ00,2018,64956,2624,820,12.6,578,8.9,242,2031,31.2,335,1696,1931,29.6,319,-106,1612,100,346,5.3,65302
46735,T001038,Total male and female,GM0537,Katwijk,2019JJ00,2019,65302,2638,718,11,536,8.2,182,2149,32.8,348,1801,1890,28.8,260,-40,1630,259,451,6.9,65753
46736,T001038,Total male and female,GM0537,Katwijk,2020JJ00,2020,65753,2657,712,10.8,614,9.3,98,2148,32.6,269,1879,2007,30.5,193,-19,1814,141,242,3.7,65995
46737,T001038,Total male and female,GM0537,Katwijk,2021JJ00,2021,65995,2666,765,11.6,564,8.5,201,1949,29.5,256,1693,2116,32.1,202,-6,1914,-167,37,0.6,66032
46738,T001038,Total male and female,GM0537,Katwijk,2022JJ00,2022,66032,2662,703,10.6,546,8.2,157,2627,39.6,609,2018,2209,33.3,318,-33,1891,418,575,8.7,66607
46739,T001038,Total male and female,GM0537,Katwijk,2023JJ00,2023,66607,2685,717,10.7,569,8.5,148,2480,37.1,429,2051,2273,34,272,-31,2001,207,359,5.4,66966
46974,T001038,Total male and female,GM0928,Kerkrade,2012JJ00,2012,47280,2159,396,8.4,575,12.2,-179,2223,47.1,348,1875,2129,45.1,392,-21,1737,94,-86,-1.8,47194
46975,T001038,Total male and female,GM0928,Kerkrade,2013JJ00,2013,47194,2155,377,8,642,13.7,-265,2030,43.2,363,1667,2175,46.3,435,-78,1740,-145,-410,-8.7,46784
46976,T001038,Total male and female,GM0928,Kerkrade,2014JJ00,2014,46784,2136,370,7.9,570,12.2,-200,2135,45.8,380,1755,2195,47,345,-16,1850,-60,-260,-5.6,46524
46977,T001038,Total male and female,GM0928,Kerkrade,2015JJ00,2015,46524,2122,344,7.4,683,14.8,-339,2171,46.9,375,1796,2336,50.5,416,-42,1920,-165,-501,-10.8,46023
46978,T001038,Total male and female,GM0928,Kerkrade,2016JJ00,2016,46023,2101,353,7.7,635,13.8,-282,2322,50.5,379,1943,2128,46.3,344,-44,1784,194,-86,-1.9,45937
46979,T001038,Total male and female,GM0928,Kerkrade,2017JJ00,2017,45937,2097,332,7.2,659,14.4,-327,2506,54.6,459,2047,2289,49.9,421,-47,1868,217,-114,-2.5,45823
46980,T001038,Total male and female,GM0928,Kerkrade,2018JJ00,2018,45823,2091,359,7.8,667,14.6,-308,2540,55.5,499,2041,2414,52.8,425,-65,1989,126,-181,-3.9,45642
46981,T001038,Total male and female,GM0928,Kerkrade,2019JJ00,2019,45642,2083,351,7.7,658,14.4,-307,2688,58.8,597,2091,2276,49.8,355,12,1921,412,107,2.3,45749
46982,T001038,Total male and female,GM0928,Kerkrade,2020JJ00,2020,45749,2088,322,7.1,732,16.1,-410,2664,58.4,477,2187,2556,56.1,452,-130,2104,108,-307,-6.7,45442
46983,T001038,Total male and female,GM0928,Kerkrade,2021JJ00,2021,45442,2074,366,8.1,764,16.8,-398,2886,63.6,544,2342,2606,57.4,451,-116,2155,280,-118,-2.6,45324
46984,T001038,Total male and female,GM0928,Kerkrade,2022JJ00,2022,45324,2069,352,7.7,663,14.6,-311,2937,64.6,804,2133,2324,51.1,439,-87,1885,613,296,6.5,45620
46985,T001038,Total male and female,GM0928,Kerkrade,2023JJ00,2023,45620,2082,346,7.6,621,13.7,-275,2440,53.7,600,1840,2474,54.4,471,-121,2003,-34,-309,-6.8,45311
48040,T001038,Total male and female,GM1598,Koggenland,2012JJ00,2012,22345,278,202,9,183,8.2,19,762,34.1,70,692,751,33.6,49,0,702,11,31,1.4,22376
48041,T001038,Total male and female,GM1598,Koggenland,2013JJ00,2013,22376,278,220,9.8,155,6.9,65,832,37.1,84,748,786,35,64,-8,722,46,109,4.9,22485
48042,T001038,Total male and female,GM1598,Koggenland,2014JJ00,2014,22485,280,240,10.7,195,8.7,45,775,34.5,88,687,880,39.2,97,-14,783,-105,-59,-2.6,22426
48043,T001038,Total male and female,GM1598,Koggenland,2015JJ00,2015,22426,279,200,8.9,185,8.2,15,925,41.2,96,829,899,40,88,-6,811,26,45,2,22471
48044,T001038,Total male and female,GM1598,Koggenland,2016JJ00,2016,22471,280,210,9.3,180,8,30,987,43.9,82,905,966,42.9,49,1,917,21,51,2.3,22522
48045,T001038,Total male and female,GM1598,Koggenland,2017JJ00,2017,22522,280,215,9.5,196,8.7,19,1101,48.7,64,1037,977,43.2,82,-11,895,124,137,6.1,22659
48046,T001038,Total male and female,GM1598,Koggenland,2018JJ00,2018,22659,282,229,10.1,191,8.4,38,1026,45.2,93,933,985,43.4,67,-3,918,41,79,3.5,22738
48047,T001038,Total male and female,GM1598,Koggenland,2019JJ00,2019,22738,283,183,8,187,8.2,-4,991,43.6,86,905,981,43.1,74,-10,907,10,11,0.5,22749
48048,T001038,Total male and female,GM1598,Koggenland,2020JJ00,2020,22749,283,201,8.8,196,8.6,5,1185,51.9,73,1112,998,43.7,91,-23,907,187,191,8.4,22940
48049,T001038,Total male and female,GM1598,Koggenland,2021JJ00,2021,22940,286,249,10.8,205,8.9,44,1049,45.6,80,969,984,42.8,68,-2,916,65,108,4.7,23048
48050,T001038,Total male and female,GM1598,Koggenland,2022JJ00,2022,23048,287,247,10.6,191,8.2,56,1435,61.6,453,982,1031,44.3,179,-71,852,404,461,20,23509
48051,T001038,Total male and female,GM1598,Koggenland,2023JJ00,2023,23509,293,247,10.5,221,9.4,26,1312,55.7,229,1083,1259,53.5,191,-51,1068,53,78,3.3,23587
48122,T001038,Total male and female,GM0079,Kollumerland en Nieuwkruisland,2012JJ00,2012,12906,118,130,10.1,125,9.7,5,390,30.3,18,372,472,36.7,14,7,458,-82,-77,-6,12829
48123,T001038,Total male and female,GM0079,Kollumerland en Nieuwkruisland,2013JJ00,2013,12829,117,138,10.7,127,9.9,11,452,35.2,14,438,413,32.1,15,-3,398,39,49,3.8,12878
48124,T001038,Total male and female,GM0079,Kollumerland en Nieuwkruisland,2014JJ00,2014,12878,117,141,11,107,8.3,34,454,35.3,26,428,531,41.3,19,-4,512,-77,-43,-3.3,12835
48125,T001038,Total male and female,GM0079,Kollumerland en Nieuwkruisland,2015JJ00,2015,12835,117,119,9.3,111,8.7,8,492,38.4,16,476,524,40.9,16,-1,508,-32,-24,-1.9,12811
48126,T001038,Total male and female,GM0079,Kollumerland en Nieuwkruisland,2016JJ00,2016,12811,117,154,12,126,9.8,28,562,43.8,18,544,529,41.2,21,5,508,33,61,4.8,12872
48127,T001038,Total male and female,GM0079,Kollumerland en Nieuwkruisland,2017JJ00,2017,12872,117,113,8.8,125,9.7,-12,557,43.3,18,539,590,45.9,12,1,578,-33,-45,-3.5,12827
48128,T001038,Total male and female,GM0079,Kollumerland en Nieuwkruisland,2018JJ00,2018,12827,117,130,10.2,123,9.6,7,523,40.9,23,500,590,46.1,16,1,574,-67,-66,-5.1,12761
48286,T001038,Total male and female,GM0588,Korendijk,2012JJ00,2012,10801,140,97,9,76,7,21,359,33.3,19,340,407,37.7,15,0,392,-48,-27,-2.5,10774
48287,T001038,Total male and female,GM0588,Korendijk,2013JJ00,2013,10774,141,110,10.2,107,10,3,313,29.1,17,296,390,36.3,15,0,375,-77,-72,-6.7,10702
48288,T001038,Total male and female,GM0588,Korendijk,2014JJ00,2014,10702,140,117,10.9,79,7.4,38,403,37.5,19,384,362,33.7,21,-4,341,41,76,7.1,10778
48289,T001038,Total male and female,GM0588,Korendijk,2015JJ00,2015,10778,141,110,10.2,84,7.8,26,475,44,27,448,454,42,28,-7,426,21,47,4.4,10825
48290,T001038,Total male and female,GM0588,Korendijk,2016JJ00,2016,10825,142,120,11,87,8,33,519,47.6,22,497,418,38.4,21,0,397,101,134,12.4,10959
48291,T001038,Total male and female,GM0588,Korendijk,2017JJ00,2017,10959,144,118,10.7,93,8.4,25,611,55.4,28,583,498,45.2,0,7,498,113,138,12.6,11097
48292,T001038,Total male and female,GM0588,Korendijk,2018JJ00,2018,11097,146,116,10.4,101,9,15,625,55.9,26,599,463,41.4,38,2,425,162,172,15.5,11269
48860,T001038,Total male and female,GM0542,Krimpen aan den IJssel,2012JJ00,2012,28692,3683,282,9.8,268,9.3,14,1198,41.6,95,1103,1051,36.5,64,14,987,147,163,5.7,28855
48861,T001038,Total male and female,GM0542,Krimpen aan den IJssel,2013JJ00,2013,28855,3757,265,9.2,259,9,6,1057,36.7,91,966,1094,37.9,38,12,1056,-37,-30,-1,28825
48862,T001038,Total male and female,GM0542,Krimpen aan den IJssel,2014JJ00,2014,28825,3753,303,10.5,269,9.3,34,1122,38.8,99,1023,1014,35.1,69,6,945,108,145,5,28970
48863,T001038,Total male and female,GM0542,Krimpen aan den IJssel,2015JJ00,2015,28970,3772,283,9.8,270,9.3,13,1198,41.3,100,1098,1129,38.9,69,7,1060,69,84,2.9,29054
48864,T001038,Total male and female,GM0542,Krimpen aan den IJssel,2016JJ00,2016,29054,3783,293,10.1,268,9.2,25,1276,43.9,97,1179,1228,42.2,55,-3,1173,48,69,2.4,29123
48865,T001038,Total male and female,GM0542,Krimpen aan den IJssel,2017JJ00,2017,29123,3792,275,9.4,271,9.3,4,1415,48.4,102,1313,1236,42.3,16,20,1220,179,183,6.3,29306
48866,T001038,Total male and female,GM0542,Krimpen aan den IJssel,2018JJ00,2018,29306,3811,280,9.5,288,9.8,-8,1262,43,93,1169,1185,40.4,66,11,1119,77,70,2.4,29376
48867,T001038,Total male and female,GM0542,Krimpen aan den IJssel,2019JJ00,2019,29376,3820,321,10.9,283,9.6,38,1285,43.6,104,1181,1169,39.7,78,8,1091,116,150,5.1,29526
48868,T001038,Total male and female,GM0542,Krimpen aan den IJssel,2020JJ00,2020,29526,3840,268,9.1,352,11.9,-84,1316,44.7,82,1234,1348,45.7,45,3,1303,-32,-116,-3.9,29410
48869,T001038,Total male and female,GM0542,Krimpen aan den IJssel,2021JJ00,2021,29410,3824,311,10.6,331,11.3,-20,1306,44.4,115,1191,1281,43.6,56,5,1225,25,5,0.2,29415
48870,T001038,Total male and female,GM0542,Krimpen aan den IJssel,2022JJ00,2022,29415,3835,290,9.8,317,10.8,-27,1345,45.7,201,1144,1229,41.7,125,-27,1104,116,89,3,29504
48871,T001038,Total male and female,GM0542,Krimpen aan den IJssel,2023JJ00,2023,29504,3847,310,10.5,302,10.2,8,1401,47.4,179,1222,1286,43.5,108,-18,1178,115,122,4.1,29626
48945,T001038,Total male and female,GM1931,Krimpenerwaard,2015JJ00,2015,54208,362,568,10.4,450,8.3,118,2064,37.9,211,1853,1693,31.1,179,-46,1514,371,445,8.2,54653
48946,T001038,Total male and female,GM1931,Krimpenerwaard,2016JJ00,2016,54653,365,521,9.5,482,8.8,39,2312,42.1,222,2090,1795,32.7,176,-41,1619,517,551,10.1,55204
48947,T001038,Total male and female,GM1931,Krimpenerwaard,2017JJ00,2017,55204,369,549,9.9,451,8.1,98,2410,43.5,193,2217,2064,37.2,193,-30,1871,346,440,8,55644
48948,T001038,Total male and female,GM1931,Krimpenerwaard,2018JJ00,2018,55644,375,574,10.3,456,8.2,118,2234,40,163,2071,1949,34.9,170,-37,1779,285,404,7.3,56048
48949,T001038,Total male and female,GM1931,Krimpenerwaard,2019JJ00,2019,56048,378,588,10.5,475,8.5,113,2070,36.8,182,1888,1916,34.1,138,-27,1778,154,271,4.8,56319
48950,T001038,Total male and female,GM1931,Krimpenerwaard,2020JJ00,2020,56319,380,589,10.4,513,9.1,76,2225,39.4,199,2026,1996,35.3,135,-32,1861,229,303,5.4,56622
48951,T001038,Total male and female,GM1931,Krimpenerwaard,2021JJ00,2021,56622,382,651,11.5,496,8.7,155,2175,38.3,166,2009,1891,33.3,155,-28,1736,284,440,7.8,57062
48952,T001038,Total male and female,GM1931,Krimpenerwaard,2022JJ00,2022,57062,385,596,10.4,526,9.2,70,2554,44.5,601,1953,1986,34.6,280,-56,1706,568,638,11.2,57700
48953,T001038,Total male and female,GM1931,Krimpenerwaard,2023JJ00,2023,57700,389,635,11,558,9.7,77,2055,35.6,298,1757,2047,35.5,214,-30,1833,8,85,1.5,57785
49434,T001038,Total male and female,GM1659,Laarbeek,2012JJ00,2012,21608,390,200,9.2,164,7.6,36,747,34.4,103,644,623,28.7,49,-2,574,124,159,7.4,21767
49435,T001038,Total male and female,GM1659,Laarbeek,2013JJ00,2013,21767,393,172,7.9,166,7.6,6,675,31,72,603,646,29.7,96,-30,550,29,35,1.6,21802
49436,T001038,Total male and female,GM1659,Laarbeek,2014JJ00,2014,21802,394,190,8.7,187,8.6,3,777,35.5,102,675,673,30.8,75,-11,598,104,111,5.1,21913
49437,T001038,Total male and female,GM1659,Laarbeek,2015JJ00,2015,21913,396,181,8.3,213,9.7,-32,774,35.3,108,666,688,31.4,61,-7,627,86,52,2.4,21965
49438,T001038,Total male and female,GM1659,Laarbeek,2016JJ00,2016,21965,397,161,7.3,195,8.9,-34,796,36.3,83,713,784,35.7,86,-27,698,12,-23,-1,21942
49439,T001038,Total male and female,GM1659,Laarbeek,2017JJ00,2017,21942,396,177,8,221,10,-44,1059,48,96,963,797,36.1,57,-13,740,262,216,9.8,22158
49440,T001038,Total male and female,GM1659,Laarbeek,2018JJ00,2018,22158,400,187,8.4,205,9.2,-18,980,44.1,97,883,786,35.3,62,-17,724,194,175,7.9,22333
49441,T001038,Total male and female,GM1659,Laarbeek,2019JJ00,2019,22333,403,214,9.5,217,9.7,-3,1048,46.7,107,941,854,38.1,75,-9,779,194,190,8.5,22523
49442,T001038,Total male and female,GM1659,Laarbeek,2020JJ00,2020,22523,407,198,8.7,257,11.3,-59,1146,50.6,98,1048,804,35.5,85,-12,719,342,282,12.5,22805
49443,T001038,Total male and female,GM1659,Laarbeek,2021JJ00,2021,22805,412,250,10.9,230,10.1,20,943,41.2,59,884,824,36,69,-10,755,119,138,6.1,22943
49444,T001038,Total male and female,GM1659,Laarbeek,2022JJ00,2022,22943,415,230,10,236,10.2,-6,1140,49.3,219,921,815,35.3,92,-17,723,325,317,13.8,23260
49445,T001038,Total male and female,GM1659,Laarbeek,2023JJ00,2023,23260,420,217,9.3,272,11.7,-55,909,39.1,173,736,892,38.4,116,-22,776,17,-40,-1.7,23220
49526,T001038,Total male and female,GM1982,Land van Cuijk,2022JJ00,2022,90707,266,828,9.1,931,10.2,-103,4381,48.1,886,3495,3559,39.1,355,-27,3204,822,716,7.9,91423
49527,T001038,Total male and female,GM1982,Land van Cuijk,2023JJ00,2023,91423,268,752,8.2,968,10.6,-216,3821,41.7,903,2918,3305,36.1,520,-193,2785,516,299,3.3,91722
49598,T001038,Total male and female,GM1685,Landerd,2012JJ00,2012,15066,214,153,10.1,137,9,16,611,40.3,38,573,470,31,32,-7,438,141,157,10.4,15223
49599,T001038,Total male and female,GM1685,Landerd,2013JJ00,2013,15223,216,142,9.3,110,7.2,32,603,39.6,65,538,592,38.8,41,-4,551,11,43,2.8,15266
49600,T001038,Total male and female,GM1685,Landerd,2014JJ00,2014,15266,217,127,8.3,135,8.8,-8,615,40.3,56,559,586,38.4,28,5,558,29,24,1.6,15290
49601,T001038,Total male and female,GM1685,Landerd,2015JJ00,2015,15290,217,129,8.4,152,9.9,-23,577,37.7,78,499,538,35.2,49,-9,489,39,13,0.9,15303
49602,T001038,Total male and female,GM1685,Landerd,2016JJ00,2016,15303,217,132,8.6,141,9.2,-9,699,45.6,51,648,661,43.2,37,-1,624,38,29,1.9,15332
49603,T001038,Total male and female,GM1685,Landerd,2017JJ00,2017,15332,218,129,8.4,145,9.5,-16,674,44,54,620,659,43,50,-15,609,15,0,0,15332
49604,T001038,Total male and female,GM1685,Landerd,2018JJ00,2018,15332,218,121,7.8,136,8.8,-15,823,53.3,89,734,611,39.6,35,3,576,212,197,12.8,15529
49605,T001038,Total male and female,GM1685,Landerd,2019JJ00,2019,15529,221,121,7.7,143,9.1,-22,825,52.8,74,751,603,38.6,47,3,556,222,201,12.9,15730
49606,T001038,Total male and female,GM1685,Landerd,2020JJ00,2020,15730,224,140,8.9,163,10.3,-23,739,46.9,99,640,629,39.9,53,-10,576,110,87,5.5,15817
49607,T001038,Total male and female,GM1685,Landerd,2021JJ00,2021,15817,225,156,9.8,161,10.2,-5,669,42.2,74,595,571,36,41,3,530,98,79,5,15896
49680,T001038,Total male and female,GM0882,Landgraaf,2012JJ00,2012,38067,1549,278,7.3,391,10.3,-113,1702,44.8,129,1573,1745,45.9,164,1,1581,-43,-156,-4.1,37911
49681,T001038,Total male and female,GM0882,Landgraaf,2013JJ00,2013,37911,1542,269,7.1,378,10,-109,1551,41.1,137,1414,1780,47.2,200,-20,1580,-229,-338,-8.9,37573
49682,T001038,Total male and female,GM0882,Landgraaf,2014JJ00,2014,37573,1529,289,7.7,343,9.1,-54,1760,46.9,136,1624,1824,48.6,169,5,1655,-64,-117,-3.1,37456
49683,T001038,Total male and female,GM0882,Landgraaf,2015JJ00,2015,37456,1524,270,7.2,371,9.9,-101,1876,50.1,182,1694,1762,47,152,-19,1610,114,9,0.2,37465
49684,T001038,Total male and female,GM0882,Landgraaf,2016JJ00,2016,37465,1524,263,7,381,10.2,-118,1915,51.1,171,1744,1806,48.2,136,16,1670,109,-7,-0.2,37458
49685,T001038,Total male and female,GM0882,Landgraaf,2017JJ00,2017,37458,1524,286,7.6,417,11.1,-131,2167,57.7,174,1993,1882,50.1,138,10,1744,285,154,4.1,37612
49686,T001038,Total male and female,GM0882,Landgraaf,2018JJ00,2018,37612,1530,291,7.7,437,11.6,-146,2053,54.6,188,1865,1927,51.2,152,-10,1775,126,-21,-0.6,37591
49687,T001038,Total male and female,GM0882,Landgraaf,2019JJ00,2019,37591,1529,278,7.4,428,11.4,-150,1932,51.5,178,1754,1927,51.4,174,-17,1753,5,-146,-3.9,37445
49688,T001038,Total male and female,GM0882,Landgraaf,2020JJ00,2020,37445,1523,291,7.8,483,12.9,-192,1916,51.3,195,1721,1907,51.1,142,-21,1765,9,-183,-4.9,37262
49689,T001038,Total male and female,GM0882,Landgraaf,2021JJ00,2021,37262,1516,285,7.7,549,14.8,-264,1932,52,187,1745,1904,51.3,122,13,1782,28,-239,-6.4,37023
49690,T001038,Total male and female,GM0882,Landgraaf,2022JJ00,2022,37023,1506,287,7.7,461,12.4,-174,2061,55.6,388,1673,1737,46.8,203,-11,1534,324,152,4.1,37175
49691,T001038,Total male and female,GM0882,Landgraaf,2023JJ00,2023,37175,1512,266,7.2,475,12.8,-209,1841,49.6,245,1596,1694,45.6,182,-35,1512,147,-63,-1.7,37112
49762,T001038,Total male and female,GM0415,Landsmeer,2012JJ00,2012,10334,458,89,8.6,81,7.8,8,477,45.9,57,420,364,35,37,-12,327,113,120,11.6,10454
49763,T001038,Total male and female,GM0415,Landsmeer,2013JJ00,2013,10454,464,81,7.8,85,8.1,-4,394,37.7,44,350,401,38.4,47,-13,354,-7,-10,-1,10444
49764,T001038,Total male and female,GM0415,Landsmeer,2014JJ00,2014,10444,463,90,8.5,70,6.6,20,790,74.3,55,735,435,40.9,36,-2,399,355,379,36.3,10823
49765,T001038,Total male and female,GM0415,Landsmeer,2015JJ00,2015,10823,480,89,8.2,91,8.3,-2,595,54.6,52,543,442,40.6,46,-3,396,153,154,14.2,10977
49766,T001038,Total male and female,GM0415,Landsmeer,2016JJ00,2016,10977,487,96,8.6,68,6.1,28,817,73.4,58,759,549,49.3,49,-6,500,268,298,27.1,11275
49767,T001038,Total male and female,GM0415,Landsmeer,2017JJ00,2017,11275,500,119,10.5,92,8.1,27,681,60,60,621,546,48.1,44,-16,502,135,160,14.2,11435
49768,T001038,Total male and female,GM0415,Landsmeer,2018JJ00,2018,11435,508,103,9,107,9.3,-4,627,54.7,68,559,568,49.6,42,5,526,59,53,4.6,11488
49769,T001038,Total male and female,GM0415,Landsmeer,2019JJ00,2019,11488,510,102,8.9,99,8.6,3,563,49,43,520,563,49,58,-14,505,0,3,0.3,11491
49770,T001038,Total male and female,GM0415,Landsmeer,2020JJ00,2020,11491,510,90,7.8,106,9.2,-16,663,57.5,48,615,573,49.7,29,-3,544,90,74,6.4,11565
49771,T001038,Total male and female,GM0415,Landsmeer,2021JJ00,2021,11565,513,102,8.8,98,8.5,4,614,53.1,51,563,623,53.9,57,-7,566,-9,-5,-0.4,11560
49772,T001038,Total male and female,GM0415,Landsmeer,2022JJ00,2022,11560,515,89,7.7,98,8.4,-9,699,60.1,130,569,546,46.9,64,-11,482,153,145,12.5,11705
49773,T001038,Total male and female,GM0415,Landsmeer,2023JJ00,2023,11705,522,75,6.4,102,8.7,-27,614,52.6,88,526,631,54,90,-14,541,-17,-44,-3.8,11661
50008,T001038,Total male and female,GM0416,Langedijk,2012JJ00,2012,26991,1123,253,9.4,155,5.8,98,972,36.1,75,897,1160,43.1,103,-7,1057,-188,-92,-3.4,26899
50009,T001038,Total male and female,GM0416,Langedijk,2013JJ00,2013,26899,1122,247,9.2,160,5.9,87,1132,42.1,89,1043,1187,44.1,67,9,1120,-55,36,1.3,26935
50010,T001038,Total male and female,GM0416,Langedijk,2014JJ00,2014,26935,1124,288,10.6,165,6.1,123,1305,48.1,98,1207,1076,39.7,74,2,1002,229,352,13.1,27287
50011,T001038,Total male and female,GM0416,Langedijk,2015JJ00,2015,27287,1138,260,9.5,206,7.5,54,1495,54.6,117,1378,1390,50.8,94,-14,1296,105,160,5.9,27447
50012,T001038,Total male and female,GM0416,Langedijk,2016JJ00,2016,27447,1148,248,9,172,6.2,76,1509,54.8,110,1399,1423,51.7,110,-19,1313,86,161,5.9,27608
50013,T001038,Total male and female,GM0416,Langedijk,2017JJ00,2017,27608,1155,235,8.5,180,6.5,55,1722,62.1,120,1602,1548,55.8,94,-9,1454,174,228,8.3,27836
50014,T001038,Total male and female,GM0416,Langedijk,2018JJ00,2018,27836,1166,278,10,195,7,83,1477,52.9,141,1336,1403,50.3,96,-45,1307,74,156,5.6,27992
50015,T001038,Total male and female,GM0416,Langedijk,2019JJ00,2019,27992,1172,261,9.3,186,6.6,75,1582,56.3,129,1453,1482,52.8,111,-26,1371,100,171,6.1,28163
50016,T001038,Total male and female,GM0416,Langedijk,2020JJ00,2020,28163,1179,281,9.9,205,7.3,76,1535,54.3,110,1425,1445,51.2,67,-3,1378,90,172,6.1,28335
50017,T001038,Total male and female,GM0416,Langedijk,2021JJ00,2021,28335,1187,280,9.8,247,8.7,33,1597,56.1,89,1508,1329,46.7,62,-16,1267,268,258,9.1,28593
50172,T001038,Total male and female,GM1621,Lansingerland,2012JJ00,2012,55265,1018,774,13.8,285,5.1,489,2407,43.1,234,2173,1659,29.7,225,1,1434,748,1241,22.5,56506
50173,T001038,Total male and female,GM1621,Lansingerland,2013JJ00,2013,56506,1041,740,13,328,5.8,412,2051,36.1,205,1846,1842,32.4,213,-19,1629,209,616,10.9,57122
50174,T001038,Total male and female,GM1621,Lansingerland,2014JJ00,2014,57122,1053,695,12.1,261,4.5,434,2512,43.6,252,2260,1938,33.6,225,-19,1713,574,1011,17.7,58133
50175,T001038,Total male and female,GM1621,Lansingerland,2015JJ00,2015,58133,1071,651,11.1,313,5.3,338,2732,46.6,264,2468,2169,37,265,-25,1904,563,902,15.5,59035
50176,T001038,Total male and female,GM1621,Lansingerland,2016JJ00,2016,59035,1090,703,11.8,348,5.8,355,3099,52,269,2830,2381,40,221,-20,2160,718,1070,18.1,60105
50177,T001038,Total male and female,GM1621,Lansingerland,2017JJ00,2017,60105,1109,753,12.4,368,6.1,385,3086,50.9,241,2845,2420,39.9,226,-21,2194,666,1050,17.5,61155
50178,T001038,Total male and female,GM1621,Lansingerland,2018JJ00,2018,61155,1145,724,11.8,384,6.3,340,2579,42,264,2315,2477,40.4,188,9,2289,102,446,7.3,61601
50179,T001038,Total male and female,GM1621,Lansingerland,2019JJ00,2019,61601,1153,666,10.7,389,6.3,277,2913,47,258,2655,2418,39,225,-43,2193,495,772,12.5,62373
50180,T001038,Total male and female,GM1621,Lansingerland,2020JJ00,2020,62384,1168,709,11.3,423,6.7,286,3171,50.4,264,2907,2478,39.4,199,-20,2279,693,979,15.7,63363
50181,T001038,Total male and female,GM1621,Lansingerland,2021JJ00,2021,63363,1186,750,11.8,432,6.8,318,3045,47.8,244,2801,2609,40.9,211,-32,2398,436,747,11.8,64110
50182,T001038,Total male and female,GM1621,Lansingerland,2022JJ00,2022,64110,1203,647,10,418,6.5,229,3100,48.1,399,2701,2687,41.7,305,-61,2382,413,644,10,64754
50183,T001038,Total male and female,GM1621,Lansingerland,2023JJ00,2023,64754,1216,690,10.6,456,7,234,3188,48.9,325,2863,2582,39.6,291,-41,2291,606,840,13,65594
50336,T001038,Total male and female,GM0417,Laren (NH.),2012JJ00,2012,11360,915,60,5.4,241,21.7,-181,916,82.3,181,735,1206,108.4,271,-176,935,-290,-471,-41.5,10889
50337,T001038,Total male and female,GM0417,Laren (NH.),2013JJ00,2013,10889,877,59,5.4,230,21.1,-171,797,73.3,109,688,655,60.2,107,-4,548,142,-27,-2.5,10862
50338,T001038,Total male and female,GM0417,Laren (NH.),2014JJ00,2014,10862,875,79,7.3,222,20.4,-143,834,76.8,116,718,699,64.4,91,-12,608,135,-5,-0.5,10857
50339,T001038,Total male and female,GM0417,Laren (NH.),2015JJ00,2015,10857,875,60,5.5,223,20.4,-163,1029,94.3,147,882,769,70.5,115,-8,654,260,99,9.1,10956
50340,T001038,Total male and female,GM0417,Laren (NH.),2016JJ00,2016,10956,883,72,6.5,239,21.7,-167,1118,101.4,169,949,817,74.1,86,-6,731,301,132,12,11088
50341,T001038,Total male and female,GM0417,Laren (NH.),2017JJ00,2017,11088,893,74,6.7,243,21.9,-169,1070,96.2,167,903,843,75.8,86,-1,757,227,58,5.2,11146
50342,T001038,Total male and female,GM0417,Laren (NH.),2018JJ00,2018,11146,898,74,6.6,222,19.9,-148,1000,89.5,177,823,809,72.4,143,1,666,191,49,4.4,11195
50343,T001038,Total male and female,GM0417,Laren (NH.),2019JJ00,2019,11195,902,76,6.8,234,20.8,-158,1034,92,184,850,790,70.3,111,-4,679,244,85,7.6,11280
50344,T001038,Total male and female,GM0417,Laren (NH.),2020JJ00,2020,11280,909,96,8.5,289,25.5,-193,1139,100.4,164,975,828,73,95,-3,733,311,118,10.5,11398
50345,T001038,Total male and female,GM0417,Laren (NH.),2021JJ00,2021,11398,918,79,6.9,280,24.4,-201,1154,100.7,147,1007,825,72,76,3,749,329,130,11.4,11528
50346,T001038,Total male and female,GM0417,Laren (NH.),2022JJ00,2022,11528,929,86,7.4,265,22.8,-179,1265,108.9,288,977,902,77.6,155,-3,747,363,184,16,11712
50347,T001038,Total male and female,GM0417,Laren (NH.),2023JJ00,2023,11712,944,66,5.7,256,22.1,-190,941,81.3,155,786,1024,88.5,125,-4,899,-83,-273,-23.3,11439
50418,T001038,Total male and female,GM0022,Leek,2012JJ00,2012,19467,307,176,9,167,8.5,9,998,51.1,96,902,865,44.3,86,-29,779,133,144,7.4,19611
50419,T001038,Total male and female,GM0022,Leek,2013JJ00,2013,19611,310,153,7.8,152,7.8,1,874,44.6,84,790,889,45.3,91,-50,798,-15,-14,-0.7,19597
50420,T001038,Total male and female,GM0022,Leek,2014JJ00,2014,19597,310,200,10.2,160,8.2,40,960,49.1,108,852,1119,57.3,137,-84,982,-159,-119,-6.1,19478
50421,T001038,Total male and female,GM0022,Leek,2015JJ00,2015,19478,308,174,8.9,192,9.8,-18,1105,56.6,64,1041,1030,52.8,98,-32,932,75,58,3,19536
50422,T001038,Total male and female,GM0022,Leek,2016JJ00,2016,19536,309,157,8,151,7.7,6,1206,61.6,60,1146,1107,56.5,59,-9,1048,99,107,5.5,19643
50423,T001038,Total male and female,GM0022,Leek,2017JJ00,2017,19643,311,163,8.3,212,10.8,-49,1185,60.3,47,1138,1110,56.5,93,-25,1017,75,26,1.3,19669
50424,T001038,Total male and female,GM0022,Leek,2018JJ00,2018,19669,311,183,9.3,195,9.9,-12,1187,60.3,62,1125,1103,56,49,-7,1054,84,63,3.2,19732
50746,T001038,Total male and female,GM0545,Leerdam,2012JJ00,2012,20664,612,229,11.1,207,10,22,727,35.1,72,655,694,33.5,135,-36,559,33,54,2.6,20718
50747,T001038,Total male and female,GM0545,Leerdam,2013JJ00,2013,20718,613,201,9.7,216,10.5,-15,635,30.7,94,541,749,36.3,117,-33,632,-114,-128,-6.2,20590
50748,T001038,Total male and female,GM0545,Leerdam,2014JJ00,2014,20590,609,213,10.4,221,10.7,-8,727,35.3,58,669,742,36.1,140,-15,602,-15,-22,-1.1,20568
50749,T001038,Total male and female,GM0545,Leerdam,2015JJ00,2015,20568,609,214,10.4,204,9.9,10,900,43.6,90,810,764,37,89,-27,675,136,143,7,20711
50750,T001038,Total male and female,GM0545,Leerdam,2016JJ00,2016,20711,613,226,10.9,216,10.4,10,986,47.4,119,867,802,38.5,62,0,740,184,194,9.4,20905
50751,T001038,Total male and female,GM0545,Leerdam,2017JJ00,2017,20905,619,222,10.6,246,11.7,-24,1134,54.1,90,1044,987,47.1,89,-7,898,147,125,6,21030
50752,T001038,Total male and female,GM0545,Leerdam,2018JJ00,2018,21030,623,218,10.3,226,10.7,-8,1072,50.7,131,941,881,41.7,82,4,799,191,218,10.4,21248
50910,T001038,Total male and female,GM0080,Leeuwarden,2012JJ00,2012,95321,1208,1096,11.5,855,8.9,241,6272,65.6,1107,5165,5880,61.5,1030,7,4850,392,628,6.6,95949
50911,T001038,Total male and female,GM0080,Leeuwarden,2013JJ00,2013,95949,1219,1055,11,885,9.2,170,6541,68,1068,5473,6355,66.1,1170,-56,5185,186,369,3.8,96318
50912,T001038,Total male and female,GM0080,Leeuwarden,2014JJ00,2014,107342,695,1187,11,907,8.4,280,7065,65.7,1195,5870,6979,64.9,1318,-108,5661,86,349,3.3,107691
50913,T001038,Total male and female,GM0080,Leeuwarden,2015JJ00,2015,107691,697,1102,10.2,925,8.6,177,6733,62.5,1248,5485,6704,62.2,947,22,5757,29,206,1.9,107897
50914,T001038,Total male and female,GM0080,Leeuwarden,2016JJ00,2016,107897,699,1135,10.5,948,8.8,187,7642,70.6,1398,6244,7051,65.1,1019,-25,6032,591,770,7.1,108667
50915,T001038,Total male and female,GM0080,Leeuwarden,2017JJ00,2017,108667,704,1147,10.5,1013,9.3,134,7587,69.7,1477,6110,7455,68.5,1318,-247,6137,132,275,2.5,108942
50916,T001038,Total male and female,GM0080,Leeuwarden,2018JJ00,2018,122415,514,1175,9.6,1050,8.6,125,7801,63.5,1691,6110,7230,58.9,1229,-109,6001,571,692,5.7,123107
50917,T001038,Total male and female,GM0080,Leeuwarden,2019JJ00,2019,123107,516,1181,9.6,1181,9.6,0,8030,65,1936,6094,7049,57,1103,-16,5946,981,977,7.9,124084
50918,T001038,Total male and female,GM0080,Leeuwarden,2020JJ00,2020,124084,521,1140,9.2,1100,8.9,40,7777,62.6,1520,6257,7407,59.6,1265,-137,6142,370,397,3.2,124481
50919,T001038,Total male and female,GM0080,Leeuwarden,2021JJ00,2021,124481,523,1298,10.4,1235,9.9,63,7708,61.7,1523,6185,6739,53.9,1029,-166,5710,969,1023,8.2,125504
50920,T001038,Total male and female,GM0080,Leeuwarden,2022JJ00,2022,125504,528,1197,9.5,1206,9.5,-9,8568,67.8,2763,5805,6985,55.3,1397,-218,5588,1583,1569,12.5,127073
50921,T001038,Total male and female,GM0080,Leeuwarden,2023JJ00,2023,127073,535,1179,9.2,1166,9.1,13,9608,75.1,2546,7062,7869,61.5,1691,-427,6178,1739,1737,13.7,128810
50992,T001038,Total male and female,GM0081,Leeuwarderadeel,2012JJ00,2012,10332,253,83,8,94,9.1,-11,407,39.4,24,383,414,40.1,20,-2,394,-7,-18,-1.7,10314
50993,T001038,Total male and female,GM0081,Leeuwarderadeel,2013JJ00,2013,10314,252,71,6.9,73,7.1,-2,469,45.6,20,449,503,48.9,28,-2,475,-34,-36,-3.5,10278
50994,T001038,Total male and female,GM0081,Leeuwarderadeel,2014JJ00,2014,10278,251,92,9,79,7.7,13,420,41,21,399,489,47.7,16,-1,473,-69,-57,-5.5,10221
50995,T001038,Total male and female,GM0081,Leeuwarderadeel,2015JJ00,2015,10221,250,75,7.4,92,9,-17,431,42.3,12,419,461,45.2,12,-1,449,-30,-46,-4.5,10175
50996,T001038,Total male and female,GM0081,Leeuwarderadeel,2016JJ00,2016,10175,249,75,7.4,102,10.1,-27,516,50.9,17,499,556,54.8,30,-2,526,-40,-67,-6.6,10108
50997,T001038,Total male and female,GM0081,Leeuwarderadeel,2017JJ00,2017,10108,247,86,8.5,99,9.8,-13,508,50.3,10,498,512,50.7,24,0,488,-4,-29,-2.9,10079
51074,T001038,Total male and female,GM0546,Leiden,2012JJ00,2012,118748,5410,1277,10.7,845,7.1,432,9245,77.5,2284,6961,8625,72.3,2196,-577,6429,620,1052,8.9,119800
51075,T001038,Total male and female,GM0546,Leiden,2013JJ00,2013,119800,5460,1252,10.4,878,7.3,374,9349,77.6,2461,6888,8348,69.3,2064,-256,6284,1001,1363,11.4,121163
51076,T001038,Total male and female,GM0546,Leiden,2014JJ00,2014,121163,5522,1303,10.7,885,7.3,418,9466,78,2432,7034,9486,78.2,2342,-504,7144,-20,399,3.3,121562
51077,T001038,Total male and female,GM0546,Leiden,2015JJ00,2015,121562,5541,1209,9.9,913,7.5,296,10406,85.3,2836,7570,9690,79.4,2284,-375,7406,716,999,8.2,122561
51078,T001038,Total male and female,GM0546,Leiden,2016JJ00,2016,122561,5579,1224,9.9,843,6.8,381,11327,92,2869,8458,10604,86.1,2873,-740,7731,723,1100,9,123661
51079,T001038,Total male and female,GM0546,Leiden,2017JJ00,2017,123661,5629,1193,9.6,883,7.1,310,11596,93.5,3409,8187,11256,90.8,3224,-1004,8032,340,645,5.2,124306
51080,T001038,Total male and female,GM0546,Leiden,2018JJ00,2018,124306,5673,1061,8.5,956,7.7,105,11107,89.1,3411,7696,10624,85.3,2598,-472,8026,483,593,4.8,124899
51081,T001038,Total male and female,GM0546,Leiden,2019JJ00,2019,124899,5701,1112,8.9,992,7.9,120,11067,88.5,3720,7347,10978,87.8,2516,-300,8462,89,200,1.6,125099
51082,T001038,Total male and female,GM0546,Leiden,2020JJ00,2020,125099,5710,1094,8.8,1008,8.1,86,10772,86.5,2595,8177,11868,95.3,2687,-641,9181,-1096,-1006,-8,124093
51083,T001038,Total male and female,GM0546,Leiden,2021JJ00,2021,124093,5664,1102,8.8,1056,8.5,46,11439,91.8,3068,8371,10503,84.3,1923,-194,8580,936,981,7.9,125074
51084,T001038,Total male and female,GM0546,Leiden,2022JJ00,2022,125074,5724,1007,8,1023,8.1,-16,12653,100.4,4503,8150,10625,84.3,2280,-237,8345,2028,2015,16.1,127089
51085,T001038,Total male and female,GM0546,Leiden,2023JJ00,2023,127089,5816,998,7.8,1042,8.1,-44,14313,111.3,3954,10359,11243,87.4,2466,-338,8777,3070,3019,23.8,130108
51156,T001038,Total male and female,GM0547,Leiderdorp,2012JJ00,2012,26706,2312,259,9.7,193,7.2,66,1303,48.8,142,1161,1329,49.7,118,-11,1211,-26,37,1.4,26743
51157,T001038,Total male and female,GM0547,Leiderdorp,2013JJ00,2013,26743,2315,258,9.6,195,7.3,63,1240,46.3,150,1090,1224,45.7,136,-14,1088,16,70,2.6,26813
51158,T001038,Total male and female,GM0547,Leiderdorp,2014JJ00,2014,26813,2321,228,8.5,205,7.6,23,1358,50.6,180,1178,1343,50.1,148,-13,1195,15,40,1.5,26853
51159,T001038,Total male and female,GM0547,Leiderdorp,2015JJ00,2015,26853,2325,256,9.5,209,7.8,47,1551,57.6,298,1253,1481,55,182,-25,1299,70,115,4.3,26968
51160,T001038,Total male and female,GM0547,Leiderdorp,2016JJ00,2016,26968,2335,279,10.3,221,8.2,58,1837,67.9,217,1620,1719,63.6,163,-7,1556,118,160,5.9,27128
51161,T001038,Total male and female,GM0547,Leiderdorp,2017JJ00,2017,27128,2349,222,8.2,239,8.8,-17,1710,63,172,1538,1623,59.8,184,-29,1439,87,69,2.5,27197
51162,T001038,Total male and female,GM0547,Leiderdorp,2018JJ00,2018,27197,2349,225,8.3,263,9.7,-38,1456,53.6,165,1291,1512,55.7,193,-39,1319,-56,-88,-3.2,27109
51163,T001038,Total male and female,GM0547,Leiderdorp,2019JJ00,2019,27109,2341,277,10.2,239,8.8,38,1455,53.7,151,1304,1542,56.9,147,-15,1395,-87,-53,-2,27056
51164,T001038,Total male and female,GM0547,Leiderdorp,2020JJ00,2020,27056,2336,242,8.9,249,9.1,-7,1888,69.4,198,1690,1558,57.2,163,-18,1395,330,321,11.9,27377
51165,T001038,Total male and female,GM0547,Leiderdorp,2021JJ00,2021,27377,2364,245,8.9,253,9.2,-8,1637,59.7,158,1479,1542,56.2,102,-5,1440,95,87,3.2,27464
51166,T001038,Total male and female,GM0547,Leiderdorp,2022JJ00,2022,27464,2388,266,9.7,289,10.5,-23,1658,60.2,264,1394,1440,52.2,126,-2,1314,218,193,7,27657
51167,T001038,Total male and female,GM0547,Leiderdorp,2023JJ00,2023,27657,2405,268,9.7,278,10,-10,1728,62.4,246,1482,1643,59.3,133,2,1510,85,79,2.9,27736
51320,T001038,Total male and female,GM1916,Leidschendam-Voorburg,2012JJ00,2012,72405,2214,806,11.1,690,9.5,116,4333,59.8,732,3601,4270,58.9,862,-142,3408,63,183,2.5,72588
51321,T001038,Total male and female,GM1916,Leidschendam-Voorburg,2013JJ00,2013,72588,2222,791,10.8,642,8.8,149,4583,62.8,797,3786,3967,54.4,719,-53,3248,616,768,10.6,73356
51322,T001038,Total male and female,GM1916,Leidschendam-Voorburg,2014JJ00,2014,73356,2245,843,11.4,654,8.9,189,4898,66.5,776,4122,4468,60.7,773,-44,3695,430,623,8.5,73979
51323,T001038,Total male and female,GM1916,Leidschendam-Voorburg,2015JJ00,2015,73979,2264,789,10.6,674,9.1,115,5015,67.7,822,4193,4891,66,832,-125,4059,124,244,3.3,74223
51324,T001038,Total male and female,GM1916,Leidschendam-Voorburg,2016JJ00,2016,74223,2275,771,10.4,752,10.1,19,5346,71.8,861,4485,4982,67,749,-43,4233,364,381,5.1,74604
51325,T001038,Total male and female,GM1916,Leidschendam-Voorburg,2017JJ00,2017,74604,2286,717,9.6,720,9.6,-3,5538,74.1,970,4568,5185,69.3,840,-50,4345,353,343,4.6,74947
51326,T001038,Total male and female,GM1916,Leidschendam-Voorburg,2018JJ00,2018,74947,2303,726,9.7,682,9.1,44,5369,71.4,1031,4338,4931,65.6,770,-72,4161,438,478,6.4,75425
51327,T001038,Total male and female,GM1916,Leidschendam-Voorburg,2019JJ00,2019,75425,2317,811,10.7,755,9.9,56,5936,78.1,1091,4845,4870,64.1,820,-57,4050,1066,1109,14.7,76534
51328,T001038,Total male and female,GM1916,Leidschendam-Voorburg,2020JJ00,2020,76534,2351,697,9.1,806,10.5,-109,5398,70.6,859,4539,5389,70.5,714,-39,4675,9,-101,-1.3,76433
51329,T001038,Total male and female,GM1916,Leidschendam-Voorburg,2021JJ00,2021,76433,2348,758,9.9,823,10.8,-65,5769,75.4,920,4849,5474,71.5,726,-22,4748,295,226,3,76659
51330,T001038,Total male and female,GM1916,Leidschendam-Voorburg,2022JJ00,2022,76659,2351,707,9.2,822,10.6,-115,6500,84.2,1352,5148,5289,68.5,774,-12,4515,1211,1094,14.3,77753
51331,T001038,Total male and female,GM1916,Leidschendam-Voorburg,2023JJ00,2023,77753,2384,707,9.1,804,10.3,-97,5878,75.4,1282,4596,5304,68,830,-76,4474,574,476,6.1,78229
51566,T001038,Total male and female,GM0995,Lelystad,2012JJ00,2012,75312,325,892,11.8,489,6.5,403,2934,38.8,550,2384,2871,38,583,-176,2288,63,466,6.2,75778
51567,T001038,Total male and female,GM0995,Lelystad,2013JJ00,2013,75778,328,852,11.2,545,7.2,307,2858,37.6,552,2306,2793,36.8,488,-89,2305,65,364,4.8,76142
51568,T001038,Total male and female,GM0995,Lelystad,2014JJ00,2014,76142,329,929,12.2,540,7.1,389,2949,38.7,574,2375,3092,40.5,662,-132,2430,-143,276,3.6,76418
51569,T001038,Total male and female,GM0995,Lelystad,2015JJ00,2015,76418,331,843,11,530,6.9,313,3164,41.3,574,2590,3107,40.6,452,-13,2655,57,374,4.9,76792
51570,T001038,Total male and female,GM0995,Lelystad,2016JJ00,2016,76792,333,820,10.7,586,7.6,234,3371,43.9,790,2581,3455,44.9,532,-138,2923,-84,145,1.9,76937
51571,T001038,Total male and female,GM0995,Lelystad,2017JJ00,2017,76937,334,784,10.2,540,7,244,3641,47.2,621,3020,3426,44.4,432,-15,2994,215,452,5.9,77389
51572,T001038,Total male and female,GM0995,Lelystad,2018JJ00,2018,77389,336,849,10.9,589,7.6,260,3688,47.5,802,2886,3445,44.4,506,-45,2939,243,504,6.5,77893
51573,T001038,Total male and female,GM0995,Lelystad,2019JJ00,2019,77893,338,783,10,599,7.7,184,4223,54,1037,3186,3695,47.2,510,-74,3185,528,705,9.1,78598
51574,T001038,Total male and female,GM0995,Lelystad,2020JJ00,2020,78598,341,814,10.3,683,8.6,131,4702,59.4,990,3712,3631,45.8,532,-163,3099,1071,1213,15.4,79811
51575,T001038,Total male and female,GM0995,Lelystad,2021JJ00,2021,79811,347,870,10.8,686,8.5,184,5028,62.4,1047,3981,3805,47.3,615,-73,3190,1223,1403,17.6,81214
51576,T001038,Total male and female,GM0995,Lelystad,2022JJ00,2022,81214,355,877,10.7,676,8.2,201,5902,71.9,2016,3886,4281,52.1,933,-175,3348,1621,1819,22.4,83033
51577,T001038,Total male and female,GM0995,Lelystad,2023JJ00,2023,83033,363,869,10.4,657,7.9,212,5300,63.4,1565,3735,4457,53.3,1139,-430,3318,843,1047,12.6,84080
51648,T001038,Total male and female,GM0082,Lemsterland,2012JJ00,2012,13564,179,132,9.7,106,7.8,26,462,34.1,49,413,486,35.8,52,-2,434,-24,2,0.1,13566
51649,T001038,Total male and female,GM0082,Lemsterland,2013JJ00,2013,13566,179,143,10.6,102,7.5,41,441,32.6,52,389,521,38.5,46,-2,475,-80,-42,-3.1,13524
51730,T001038,Total male and female,GM1640,Leudal,2012JJ00,2012,36462,224,258,7.1,314,8.6,-56,1650,45.3,458,1192,1631,44.8,227,-59,1404,19,-36,-1,36426
51731,T001038,Total male and female,GM1640,Leudal,2013JJ00,2013,36426,224,265,7.3,329,9.1,-64,1535,42.3,422,1113,1678,46.2,196,-70,1482,-143,-207,-5.7,36219
51732,T001038,Total male and female,GM1640,Leudal,2014JJ00,2014,36219,222,261,7.2,361,10,-100,1784,49.2,609,1175,1659,45.8,146,-32,1513,125,25,0.7,36244
51733,T001038,Total male and female,GM1640,Leudal,2015JJ00,2015,36244,223,271,7.5,352,9.7,-81,1842,50.9,561,1281,1862,51.4,209,-49,1653,-20,-104,-2.9,36140
51734,T001038,Total male and female,GM1640,Leudal,2016JJ00,2016,36140,222,277,7.7,365,10.1,-88,1902,52.8,466,1436,2081,57.8,198,-69,1883,-179,-262,-7.2,35878
51735,T001038,Total male and female,GM1640,Leudal,2017JJ00,2017,35878,220,245,6.8,340,9.5,-95,2158,60.2,300,1858,2087,58.2,206,-64,1881,71,-21,-0.6,35857
51736,T001038,Total male and female,GM1640,Leudal,2018JJ00,2018,35857,220,257,7.2,393,11,-136,1957,54.7,306,1651,1997,55.8,212,-51,1785,-40,-176,-4.9,35681
51737,T001038,Total male and female,GM1640,Leudal,2019JJ00,2019,35681,219,270,7.5,362,10.1,-92,2113,59.1,436,1677,1823,51,240,-77,1583,290,198,5.5,35879
51738,T001038,Total male and female,GM1640,Leudal,2020JJ00,2020,35879,220,275,7.6,451,12.5,-176,2211,61.5,282,1929,1869,52,234,-63,1635,342,166,4.6,36045
51739,T001038,Total male and female,GM1640,Leudal,2021JJ00,2021,36045,222,280,7.8,437,12.1,-157,2116,58.8,234,1882,2075,57.7,290,-109,1785,41,-117,-3.2,35928
51740,T001038,Total male and female,GM1640,Leudal,2022JJ00,2022,35928,221,288,8,435,12.1,-147,2340,64.9,490,1850,1980,54.9,299,-64,1681,360,213,5.9,36141
51741,T001038,Total male and female,GM1640,Leudal,2023JJ00,2023,36141,222,309,8.6,450,12.5,-141,1955,54.2,374,1581,1949,54,316,-96,1633,6,-135,-3.7,36006
51812,T001038,Total male and female,GM0327,Leusden,2012JJ00,2012,28905,493,263,9.1,223,7.7,40,1082,37.4,72,1010,1060,36.6,78,-14,982,22,64,2.2,28969
51813,T001038,Total male and female,GM0327,Leusden,2013JJ00,2013,28969,494,253,8.7,225,7.8,28,1042,36,99,943,1045,36.1,67,-4,978,-3,28,1,28997
51814,T001038,Total male and female,GM0327,Leusden,2014JJ00,2014,28997,494,272,9.4,214,7.4,58,1125,38.8,104,1021,1117,38.5,69,-9,1048,8,65,2.2,29062
51815,T001038,Total male and female,GM0327,Leusden,2015JJ00,2015,29062,496,267,9.1,215,7.4,52,1415,48.5,94,1321,1220,41.8,76,3,1144,195,247,8.5,29309
51816,T001038,Total male and female,GM0327,Leusden,2016JJ00,2016,29309,500,271,9.2,217,7.4,54,1821,61.7,103,1718,1509,51.2,103,-12,1406,312,368,12.6,29677
51817,T001038,Total male and female,GM0327,Leusden,2017JJ00,2017,29677,506,268,9,239,8,29,1430,48.1,84,1346,1381,46.5,86,-15,1295,49,78,2.6,29755
51818,T001038,Total male and female,GM0327,Leusden,2018JJ00,2018,29755,508,264,8.8,255,8.5,9,1613,54,93,1520,1345,45,100,-8,1245,268,275,9.2,30030
51819,T001038,Total male and female,GM0327,Leusden,2019JJ00,2019,30030,513,282,9.3,235,7.8,47,1566,51.8,124,1442,1243,41.1,62,4,1181,323,371,12.4,30401
51820,T001038,Total male and female,GM0327,Leusden,2020JJ00,2020,30401,519,291,9.5,254,8.3,37,1624,53.3,105,1519,1514,49.7,78,-18,1436,110,143,4.7,30544
51821,T001038,Total male and female,GM0327,Leusden,2021JJ00,2021,30544,522,294,9.6,310,10.1,-16,1593,52,108,1485,1406,45.9,73,-13,1333,187,169,5.5,30713
51822,T001038,Total male and female,GM0327,Leusden,2022JJ00,2022,30713,525,269,8.7,302,9.7,-33,2207,71,454,1753,1419,45.6,159,-46,1260,788,754,24.5,31467
51823,T001038,Total male and female,GM0327,Leusden,2023JJ00,2023,31467,538,321,10.2,324,10.3,-3,1664,52.7,180,1484,1448,45.9,150,-46,1298,216,214,6.8,31681
52468,T001038,Total male and female,GM0694,Liesveld,2012JJ00,2012,9787,239,106,10.8,62,6.3,44,269,27.5,16,253,320,32.7,27,-5,293,-51,-17,-1.7,9770
52796,T001038,Total male and female,GM0733,Lingewaal,2012JJ00,2012,10895,216,87,7.9,84,7.7,3,493,45,29,464,384,35.1,21,3,363,109,112,10.3,11007
52797,T001038,Total male and female,GM0733,Lingewaal,2013JJ00,2013,11007,218,110,10,61,5.5,49,408,37,37,371,404,36.6,18,6,386,4,53,4.8,11060
52798,T001038,Total male and female,GM0733,Lingewaal,2014JJ00,2014,11060,219,109,9.8,79,7.1,30,436,39.4,34,402,447,40.4,31,-9,416,-11,19,1.7,11079
52799,T001038,Total male and female,GM0733,Lingewaal,2015JJ00,2015,11079,220,91,8.2,88,7.9,3,493,44.4,58,435,463,41.7,28,-4,435,30,33,3,11112
52800,T001038,Total male and female,GM0733,Lingewaal,2016JJ00,2016,11112,221,123,11,69,6.2,54,540,48.5,53,487,548,49.2,38,1,510,-8,46,4.1,11158
52801,T001038,Total male and female,GM0733,Lingewaal,2017JJ00,2017,11158,221,114,10.2,98,8.8,16,567,50.9,36,531,607,54.5,32,3,575,-40,-24,-2.2,11134
52802,T001038,Total male and female,GM0733,Lingewaal,2018JJ00,2018,11134,221,97,8.7,85,7.6,12,628,56.3,41,587,579,51.9,35,-3,544,49,59,5.3,11193
52878,T001038,Total male and female,GM1705,Lingewaard,2012JJ00,2012,45770,735,435,9.5,382,8.3,53,1385,30.2,119,1266,1388,30.3,125,-22,1263,-3,48,1,45818
52879,T001038,Total male and female,GM1705,Lingewaard,2013JJ00,2013,45818,737,393,8.6,337,7.4,56,1426,31.1,133,1293,1531,33.4,115,5,1416,-105,-42,-0.9,45776
52880,T001038,Total male and female,GM1705,Lingewaard,2014JJ00,2014,45776,736,390,8.5,333,7.3,57,1462,31.9,127,1335,1506,32.9,109,7,1397,-44,12,0.3,45788
52881,T001038,Total male and female,GM1705,Lingewaard,2015JJ00,2015,45788,736,393,8.6,332,7.2,61,1686,36.8,149,1537,1592,34.7,137,-21,1455,94,162,3.5,45950
52882,T001038,Total male and female,GM1705,Lingewaard,2016JJ00,2016,45950,739,356,7.7,367,8,-11,2024,43.9,160,1864,1779,38.6,131,-6,1648,245,232,5,46182
52883,T001038,Total male and female,GM1705,Lingewaard,2017JJ00,2017,46182,742,369,8,355,7.7,14,1862,40.2,159,1703,1689,36.5,109,-1,1580,173,190,4.1,46372
52884,T001038,Total male and female,GM1705,Lingewaard,2018JJ00,2018,46372,748,392,8.4,401,8.6,-9,1835,39.5,146,1689,1725,37.2,142,-18,1583,110,103,2.2,46475
52885,T001038,Total male and female,GM1705,Lingewaard,2019JJ00,2019,46475,750,382,8.2,381,8.2,1,1853,39.8,188,1665,1726,37.1,122,-24,1604,127,126,2.7,46601
52886,T001038,Total male and female,GM1705,Lingewaard,2020JJ00,2020,46601,752,391,8.4,430,9.2,-39,2004,42.9,131,1873,1742,37.3,88,8,1654,262,221,4.7,46822
52887,T001038,Total male and female,GM1705,Lingewaard,2021JJ00,2021,46822,755,385,8.2,454,9.7,-69,1908,40.7,128,1780,1698,36.2,103,-4,1595,210,141,3,46963
52888,T001038,Total male and female,GM1705,Lingewaard,2022JJ00,2022,46963,758,390,8.3,426,9,-36,1928,40.9,270,1658,1638,34.8,106,-19,1532,290,257,5.5,47220
52889,T001038,Total male and female,GM1705,Lingewaard,2023JJ00,2023,47220,762,388,8.2,435,9.2,-47,1865,39.5,270,1595,1723,36.5,205,-50,1518,142,94,2,47314
53124,T001038,Total male and female,GM0553,Lisse,2012JJ00,2012,22511,1435,214,9.5,178,7.9,36,799,35.6,176,623,953,42.4,198,0,755,-154,-118,-5.2,22393
53125,T001038,Total male and female,GM0553,Lisse,2013JJ00,2013,22393,1427,199,8.9,186,8.3,13,785,35.1,133,652,857,38.3,140,6,717,-72,-57,-2.5,22336
53126,T001038,Total male and female,GM0553,Lisse,2014JJ00,2014,22336,1424,204,9.1,188,8.4,16,979,43.6,121,858,790,35.2,130,4,660,189,203,9.1,22539
53127,T001038,Total male and female,GM0553,Lisse,2015JJ00,2015,22539,1437,212,9.4,170,7.5,42,1007,44.6,127,880,982,43.5,133,7,849,25,67,3,22606
53128,T001038,Total male and female,GM0553,Lisse,2016JJ00,2016,22606,1441,214,9.4,192,8.5,22,1055,46.6,115,940,964,42.5,95,-10,869,91,111,4.9,22717
53129,T001038,Total male and female,GM0553,Lisse,2017JJ00,2017,22717,1448,224,9.9,188,8.3,36,1107,48.7,102,1005,1115,49.1,91,6,1024,-8,29,1.3,22746
53130,T001038,Total male and female,GM0553,Lisse,2018JJ00,2018,22746,1450,210,9.2,201,8.8,9,1055,46.3,138,917,1010,44.4,105,-12,905,45,54,2.4,22800
53131,T001038,Total male and female,GM0553,Lisse,2019JJ00,2019,22800,1453,220,9.6,187,8.2,33,1193,52.1,139,1054,1070,46.8,105,-11,965,123,155,6.8,22955
53132,T001038,Total male and female,GM0553,Lisse,2020JJ00,2020,22955,1463,218,9.5,231,10.1,-13,1029,44.8,104,925,991,43.1,83,-8,908,38,27,1.2,22982
53133,T001038,Total male and female,GM0553,Lisse,2021JJ00,2021,22982,1465,229,10,212,9.2,17,1029,44.7,126,903,1013,44,107,-14,906,16,33,1.4,23015
53134,T001038,Total male and female,GM0553,Lisse,2022JJ00,2022,23015,1466,204,8.8,222,9.6,-18,1397,60.2,331,1066,1004,43.3,121,-14,883,393,375,16.3,23390
53135,T001038,Total male and female,GM0553,Lisse,2023JJ00,2023,23390,1490,213,9.1,235,10,-22,1227,52.4,246,981,1148,49,185,-36,963,79,57,2.4,23447
53370,T001038,Total male and female,GM0140,Littenseradiel,2012JJ00,2012,10925,84,106,9.7,62,5.7,44,377,34.5,17,360,398,36.4,36,-1,362,-21,23,2.1,10948
53371,T001038,Total male and female,GM0140,Littenseradiel,2013JJ00,2013,10948,84,116,10.6,79,7.2,37,366,33.5,12,354,421,38.5,19,-1,402,-55,-22,-2,10926
53372,T001038,Total male and female,GM0140,Littenseradiel,2014JJ00,2014,10926,84,110,10.1,86,7.9,24,418,38.3,9,409,490,44.9,20,1,470,-72,-47,-4.3,10879
53373,T001038,Total male and female,GM0140,Littenseradiel,2015JJ00,2015,10879,83,113,10.4,72,6.6,41,403,37.1,19,384,491,45.2,30,1,461,-88,-46,-4.2,10833
53374,T001038,Total male and female,GM0140,Littenseradiel,2016JJ00,2016,10833,83,103,9.5,86,8,17,443,41.1,31,412,547,50.7,23,-4,524,-104,-87,-8,10746
53375,T001038,Total male and female,GM0140,Littenseradiel,2017JJ00,2017,10746,82,97,9.1,76,7.1,21,515,48.1,31,484,589,55,20,0,569,-74,-63,-5.9,10683
53452,T001038,Total male and female,GM0262,Lochem,2012JJ00,2012,33263,156,230,6.9,373,11.2,-143,1522,45.7,96,1426,1335,40.1,100,-12,1235,187,45,1.4,33308
53453,T001038,Total male and female,GM0262,Lochem,2013JJ00,2013,33308,156,241,7.2,404,12.1,-163,1488,44.7,130,1358,1386,41.6,131,-14,1255,102,-60,-1.8,33248
53454,T001038,Total male and female,GM0262,Lochem,2014JJ00,2014,33248,156,230,6.9,373,11.2,-143,1572,47.3,114,1458,1433,43.1,111,-14,1322,139,-4,-0.1,33244
53455,T001038,Total male and female,GM0262,Lochem,2015JJ00,2015,33244,156,248,7.5,416,12.5,-168,1715,51.5,157,1558,1460,43.9,91,-5,1369,255,89,2.7,33333
53456,T001038,Total male and female,GM0262,Lochem,2016JJ00,2016,33333,156,226,6.8,373,11.2,-147,1877,56.1,137,1740,1521,45.5,115,-11,1406,356,212,6.4,33545
53457,T001038,Total male and female,GM0262,Lochem,2017JJ00,2017,33545,157,215,6.4,390,11.6,-175,1879,56,78,1801,1674,49.9,75,-5,1599,205,29,0.9,33574
53458,T001038,Total male and female,GM0262,Lochem,2018JJ00,2018,33574,158,231,6.9,382,11.4,-151,1811,53.9,111,1700,1646,49,110,-26,1536,165,16,0.5,33590
53459,T001038,Total male and female,GM0262,Lochem,2019JJ00,2019,33590,158,230,6.8,401,11.9,-171,1828,54.3,177,1651,1518,45.1,83,-5,1435,310,139,4.1,33729
53460,T001038,Total male and female,GM0262,Lochem,2020JJ00,2020,33729,158,205,6.1,445,13.2,-240,1961,58,115,1846,1500,44.3,81,-14,1419,461,219,6.5,33948
53461,T001038,Total male and female,GM0262,Lochem,2021JJ00,2021,33948,159,251,7.4,460,13.5,-209,1779,52.3,99,1680,1448,42.6,81,-8,1367,331,121,3.6,34069
53462,T001038,Total male and female,GM0262,Lochem,2022JJ00,2022,34069,160,220,6.4,467,13.7,-247,2108,61.7,433,1675,1617,47.3,173,-34,1444,491,245,7.2,34314
53463,T001038,Total male and female,GM0262,Lochem,2023JJ00,2023,34314,161,221,6.4,439,12.8,-218,1877,54.7,160,1717,1684,49.1,139,-20,1545,193,-25,-0.7,34289
53698,T001038,Total male and female,GM0809,Loon op Zand,2012JJ00,2012,23071,460,212,9.2,227,9.8,-15,974,42.2,89,885,947,41,73,-21,874,27,12,0.5,23083
53699,T001038,Total male and female,GM0809,Loon op Zand,2013JJ00,2013,23083,460,196,8.5,218,9.4,-22,989,42.8,106,883,970,42,90,-21,880,19,-3,-0.1,23080
53700,T001038,Total male and female,GM0809,Loon op Zand,2014JJ00,2014,23080,460,189,8.2,225,9.8,-36,897,39,102,795,981,42.6,76,-14,905,-84,-120,-5.2,22960
53701,T001038,Total male and female,GM0809,Loon op Zand,2015JJ00,2015,22960,458,197,8.6,214,9.3,-17,1099,47.9,111,988,1113,48.5,112,-44,1001,-14,-31,-1.4,22929
53702,T001038,Total male and female,GM0809,Loon op Zand,2016JJ00,2016,22929,458,217,9.4,213,9.3,4,1272,55.3,147,1125,1114,48.4,90,-22,1024,158,164,7.2,23093
53703,T001038,Total male and female,GM0809,Loon op Zand,2017JJ00,2017,23093,462,191,8.3,259,11.2,-68,1324,57.3,150,1174,1226,53.1,99,-27,1127,98,27,1.2,23120
53704,T001038,Total male and female,GM0809,Loon op Zand,2018JJ00,2018,23120,463,212,9.1,249,10.7,-37,1354,58.3,176,1178,1107,47.7,112,-18,995,247,207,9,23327
53705,T001038,Total male and female,GM0809,Loon op Zand,2019JJ00,2019,23327,467,222,9.5,220,9.4,2,1205,51.6,142,1063,1127,48.2,109,-25,1018,78,81,3.5,23408
53706,T001038,Total male and female,GM0809,Loon op Zand,2020JJ00,2020,23408,469,202,8.6,274,11.7,-72,1330,56.7,129,1201,1162,49.5,91,-8,1071,168,96,4.1,23504
53707,T001038,Total male and female,GM0809,Loon op Zand,2021JJ00,2021,23504,471,254,10.7,267,11.3,-13,1416,59.9,114,1302,1138,48.1,94,-14,1044,278,264,11.2,23768
53708,T001038,Total male and female,GM0809,Loon op Zand,2022JJ00,2022,23768,476,220,9.3,285,12,-65,1233,51.8,195,1038,1139,47.9,157,-21,982,94,29,1.2,23797
53709,T001038,Total male and female,GM0809,Loon op Zand,2023JJ00,2023,23797,477,209,8.8,268,11.2,-59,1167,49,221,946,1056,44.3,120,-17,936,111,53,2.2,23850
53862,T001038,Total male and female,GM0331,Lopik,2012JJ00,2012,14050,185,125,8.9,70,5,55,440,31.4,23,417,553,39.4,41,-7,512,-113,-58,-4.1,13992
53863,T001038,Total male and female,GM0331,Lopik,2013JJ00,2013,13992,185,124,8.9,65,4.6,59,511,36.5,48,463,564,40.3,44,-10,520,-53,7,0.5,13999
53864,T001038,Total male and female,GM0331,Lopik,2014JJ00,2014,13999,185,128,9.1,65,4.6,63,510,36.3,38,472,474,33.7,16,2,458,36,100,7.1,14099
53865,T001038,Total male and female,GM0331,Lopik,2015JJ00,2015,14099,186,121,8.6,83,5.9,38,651,46.1,68,583,636,45,35,-4,601,15,57,4,14156
53866,T001038,Total male and female,GM0331,Lopik,2016JJ00,2016,14156,187,131,9.2,85,6,46,632,44.6,40,592,628,44.3,38,-5,590,4,52,3.7,14208
53867,T001038,Total male and female,GM0331,Lopik,2017JJ00,2017,14208,188,153,10.7,89,6.2,64,780,54.5,39,741,659,46.1,33,-15,626,121,187,13.2,14395
53868,T001038,Total male and female,GM0331,Lopik,2018JJ00,2018,14395,190,149,10.3,81,5.6,68,669,46.3,47,622,659,45.7,32,-5,627,10,78,5.4,14473
53869,T001038,Total male and female,GM0331,Lopik,2019JJ00,2019,14473,192,166,11.5,86,5.9,80,563,38.9,43,520,646,44.6,43,-10,603,-83,-6,-0.4,14467
53870,T001038,Total male and female,GM0331,Lopik,2020JJ00,2020,14467,191,144,10,89,6.2,55,589,40.7,48,541,652,45.1,31,-7,621,-63,-11,-0.8,14456
53871,T001038,Total male and female,GM0331,Lopik,2021JJ00,2021,14456,191,150,10.4,102,7,48,692,47.8,45,647,684,47.2,21,-2,663,8,56,3.9,14512
53872,T001038,Total male and female,GM0331,Lopik,2022JJ00,2022,14512,192,149,10.2,109,7.5,40,754,51.6,177,577,602,41.2,73,-12,529,152,192,13.2,14704
53873,T001038,Total male and female,GM0331,Lopik,2023JJ00,2023,14704,195,133,9,95,6.5,38,646,43.9,72,574,662,45,88,-20,574,-16,20,1.4,14724
53944,T001038,Total male and female,GM0024,Loppersum,2012JJ00,2012,10366,93,94,9.1,93,9,1,429,41.5,11,418,504,48.8,65,-42,439,-75,-74,-7.1,10292
53945,T001038,Total male and female,GM0024,Loppersum,2013JJ00,2013,10292,93,93,9.1,94,9.2,-1,391,38.2,17,374,485,47.3,26,-3,459,-94,-96,-9.3,10196
53946,T001038,Total male and female,GM0024,Loppersum,2014JJ00,2014,10196,92,89,8.8,95,9.3,-6,437,43,19,418,487,47.9,26,2,461,-50,-56,-5.5,10140
53947,T001038,Total male and female,GM0024,Loppersum,2015JJ00,2015,10140,91,86,8.5,85,8.4,1,448,44.4,45,403,547,54.2,29,-2,518,-99,-98,-9.7,10042
53948,T001038,Total male and female,GM0024,Loppersum,2016JJ00,2016,10042,90,83,8.3,88,8.8,-5,489,49,29,460,612,61.3,23,-2,589,-123,-128,-12.7,9914
53949,T001038,Total male and female,GM0024,Loppersum,2017JJ00,2017,9914,89,65,6.6,97,9.9,-32,436,44.4,24,412,586,59.7,21,0,565,-150,-182,-18.4,9732
53950,T001038,Total male and female,GM0024,Loppersum,2018JJ00,2018,9732,88,74,7.7,87,9,-13,523,54.1,16,507,628,64.9,20,1,608,-105,-118,-12.1,9614
53951,T001038,Total male and female,GM0024,Loppersum,2019JJ00,2019,9614,87,82,8.6,89,9.3,-7,510,53.3,32,478,581,60.7,17,1,564,-71,-77,-8,9537
53952,T001038,Total male and female,GM0024,Loppersum,2020JJ00,2020,9537,86,82,8.6,69,7.3,13,427,44.9,30,397,482,50.7,22,-2,460,-55,-42,-4.4,9495
54026,T001038,Total male and female,GM0168,Losser,2012JJ00,2012,22673,229,177,7.8,225,9.9,-48,764,33.8,106,658,834,36.9,104,-15,730,-70,-119,-5.2,22554
54027,T001038,Total male and female,GM0168,Losser,2013JJ00,2013,22554,228,208,9.2,243,10.8,-35,816,36.1,90,726,724,32.1,92,0,632,92,58,2.6,22612
54028,T001038,Total male and female,GM0168,Losser,2014JJ00,2014,22612,229,160,7.1,210,9.3,-50,736,32.7,93,643,829,36.8,91,-14,738,-93,-145,-6.4,22467
54029,T001038,Total male and female,GM0168,Losser,2015JJ00,2015,22467,227,165,7.3,241,10.7,-76,869,38.7,126,743,817,36.4,121,-10,696,52,-23,-1,22444
54030,T001038,Total male and female,GM0168,Losser,2016JJ00,2016,22444,227,187,8.3,223,9.9,-36,844,37.6,84,760,769,34.2,86,-3,683,75,38,1.7,22482
54031,T001038,Total male and female,GM0168,Losser,2017JJ00,2017,22482,228,199,8.8,228,10.1,-29,980,43.5,95,885,887,39.4,82,-2,805,93,65,2.9,22547
54032,T001038,Total male and female,GM0168,Losser,2018JJ00,2018,22547,228,176,7.8,203,9,-27,908,40.2,87,821,806,35.7,69,-2,737,102,75,3.3,22622
54033,T001038,Total male and female,GM0168,Losser,2019JJ00,2019,22622,229,203,9,223,9.8,-20,932,41.1,116,816,853,37.7,71,-9,782,79,61,2.7,22683
54034,T001038,Total male and female,GM0168,Losser,2020JJ00,2020,22683,230,188,8.3,261,11.5,-73,1075,47.2,122,953,800,35.1,61,-15,739,275,205,9,22888
54035,T001038,Total male and female,GM0168,Losser,2021JJ00,2021,22888,232,216,9.4,258,11.2,-42,1007,43.8,101,906,768,33.4,84,-17,684,239,196,8.6,23084
54036,T001038,Total male and female,GM0168,Losser,2022JJ00,2022,23084,234,196,8.4,220,9.5,-24,1078,46.4,212,866,776,33.4,119,-12,657,302,278,12,23362
54037,T001038,Total male and female,GM0168,Losser,2023JJ00,2023,23362,237,190,8.1,242,10.4,-52,928,39.7,193,735,861,36.8,112,-37,749,67,14,0.6,23376
54846,T001038,Total male and female,GM1671,Maasdonk,2012JJ00,2012,11259,302,100,8.9,87,7.7,13,372,33.1,38,334,425,37.8,5,11,420,-53,-39,-3.5,11220
54847,T001038,Total male and female,GM1671,Maasdonk,2013JJ00,2013,11220,301,98,8.7,85,7.6,13,473,42.1,40,433,464,41.3,36,-8,428,9,22,2,11242
54848,T001038,Total male and female,GM1671,Maasdonk,2014JJ00,2014,11242,302,105,9.3,83,7.3,22,542,48,44,498,434,38.4,32,-5,402,108,106,9.4,11348
54928,T001038,Total male and female,GM0263,Maasdriel,2012JJ00,2012,24022,364,219,9.1,205,8.5,14,913,38,247,666,856,35.6,138,-28,718,57,70,2.9,24092
54929,T001038,Total male and female,GM0263,Maasdriel,2013JJ00,2013,24092,364,230,9.5,165,6.8,65,913,37.8,305,608,914,37.9,98,7,816,-1,64,2.7,24156
54930,T001038,Total male and female,GM0263,Maasdriel,2014JJ00,2014,24156,365,246,10.2,201,8.3,45,975,40.3,279,696,993,41.1,183,-11,810,-18,29,1.2,24185
54931,T001038,Total male and female,GM0263,Maasdriel,2015JJ00,2015,24185,366,234,9.7,228,9.4,6,935,38.7,204,731,1043,43.2,158,-25,885,-108,-101,-4.2,24084
54932,T001038,Total male and female,GM0263,Maasdriel,2016JJ00,2016,24084,364,239,9.9,203,8.4,36,1065,44.1,208,857,935,38.7,124,-17,811,130,166,6.9,24250
54933,T001038,Total male and female,GM0263,Maasdriel,2017JJ00,2017,24250,367,243,10,215,8.8,28,1256,51.7,195,1061,1183,48.7,159,-28,1024,73,100,4.1,24350
54934,T001038,Total male and female,GM0263,Maasdriel,2018JJ00,2018,24350,368,234,9.5,226,9.2,8,1454,59.3,406,1048,1119,45.6,173,-26,946,335,343,14.1,24693
54935,T001038,Total male and female,GM0263,Maasdriel,2019JJ00,2019,24693,374,206,8.3,208,8.4,-2,1583,63.7,566,1017,1244,50,256,-79,988,339,337,13.6,25030
54936,T001038,Total male and female,GM0263,Maasdriel,2020JJ00,2020,25030,379,206,8.2,234,9.3,-28,1990,78.8,961,1029,1541,61.1,514,-185,1027,449,422,16.9,25452
54937,T001038,Total male and female,GM0263,Maasdriel,2021JJ00,2021,25452,385,241,9.5,242,9.5,-1,1760,69.1,721,1039,1706,67,676,-157,1030,54,52,2,25504
54938,T001038,Total male and female,GM0263,Maasdriel,2022JJ00,2022,25504,387,207,8,234,9.1,-27,2269,88.1,1257,1012,1723,66.9,772,-325,951,546,516,20.2,26020
54939,T001038,Total male and female,GM0263,Maasdriel,2023JJ00,2023,26020,395,222,8.5,237,9.1,-15,1782,68.3,709,1073,1587,60.8,549,-194,1038,195,177,6.8,26197
55010,T001038,Total male and female,GM1641,Maasgouw,2012JJ00,2012,24095,526,151,6.3,260,10.8,-109,957,39.8,127,830,926,38.5,85,-6,841,31,-78,-3.2,24017
55011,T001038,Total male and female,GM1641,Maasgouw,2013JJ00,2013,24017,526,187,7.8,226,9.4,-39,919,38.4,116,803,993,41.4,113,-2,880,-74,-110,-4.6,23907
55012,T001038,Total male and female,GM1641,Maasgouw,2014JJ00,2014,23907,523,146,6.1,252,10.6,-106,966,40.5,125,841,1002,42,132,-28,870,-36,-141,-5.9,23766
55013,T001038,Total male and female,GM1641,Maasgouw,2015JJ00,2015,23766,519,179,7.5,234,9.8,-55,967,40.7,114,853,922,38.8,93,-8,829,45,-9,-0.4,23757
55014,T001038,Total male and female,GM1641,Maasgouw,2016JJ00,2016,23757,520,174,7.3,262,11,-88,1119,47.1,109,1010,1013,42.6,87,-12,926,106,17,0.7,23774
55015,T001038,Total male and female,GM1641,Maasgouw,2017JJ00,2017,23774,520,177,7.5,267,11.2,-90,1234,52,138,1096,1221,51.4,117,-11,1104,13,-77,-3.2,23697
55016,T001038,Total male and female,GM1641,Maasgouw,2018JJ00,2018,23697,518,171,7.2,273,11.5,-102,1280,54,162,1118,1159,48.9,105,-17,1054,121,19,0.8,23716
55017,T001038,Total male and female,GM1641,Maasgouw,2019JJ00,2019,23716,519,142,6,274,11.5,-132,1500,62.9,208,1292,1116,46.8,96,-10,1020,384,249,10.5,23965
55018,T001038,Total male and female,GM1641,Maasgouw,2020JJ00,2020,23965,524,184,7.7,324,13.5,-140,1288,53.8,145,1143,1169,48.8,107,-5,1062,119,-18,-0.8,23947
55019,T001038,Total male and female,GM1641,Maasgouw,2021JJ00,2021,23947,524,203,8.5,362,15.1,-159,1267,52.8,134,1133,1026,42.8,119,-14,907,241,81,3.4,24028
55020,T001038,Total male and female,GM1641,Maasgouw,2022JJ00,2022,24028,526,170,7,330,13.7,-160,1644,68,303,1341,1206,49.9,191,-32,1015,438,277,11.5,24305
55021,T001038,Total male and female,GM1641,Maasgouw,2023JJ00,2023,24305,532,203,8.3,322,13.2,-119,1386,56.9,278,1108,1163,47.8,137,-18,1026,223,101,4.2,24406
55184,T001038,Total male and female,GM1991,Maashorst,2022JJ00,2022,58362,425,532,9.1,587,10,-55,2676,45.6,815,1861,2050,35,342,-76,1708,626,572,9.8,58934
55185,T001038,Total male and female,GM1991,Maashorst,2023JJ00,2023,58934,429,571,9.7,617,10.4,-46,2582,43.7,562,2020,2246,38,396,-78,1850,336,288,4.9,59222
55420,T001038,Total male and female,GM0556,Maassluis,2012JJ00,2012,31849,3751,306,9.6,282,8.8,24,1324,41.5,202,1122,1214,38,169,0,1045,110,136,4.3,31985
55421,T001038,Total male and female,GM0556,Maassluis,2013JJ00,2013,31985,3767,286,8.9,270,8.4,16,1401,43.7,254,1147,1324,41.3,208,-24,1116,77,95,3,32080
55422,T001038,Total male and female,GM0556,Maassluis,2014JJ00,2014,32080,3779,330,10.3,280,8.7,50,1402,43.6,257,1145,1336,41.6,236,-28,1100,66,121,3.8,32201
55423,T001038,Total male and female,GM0556,Maassluis,2015JJ00,2015,32201,3793,320,9.9,278,8.6,42,1400,43.4,232,1168,1359,42.1,258,-53,1101,41,91,2.8,32292
55424,T001038,Total male and female,GM0556,Maassluis,2016JJ00,2016,32292,3804,341,10.5,322,9.9,19,1466,45.3,208,1258,1328,41,185,-2,1143,138,158,4.9,32450
55425,T001038,Total male and female,GM0556,Maassluis,2017JJ00,2017,32450,3822,335,10.3,340,10.5,-5,1493,46,194,1299,1419,43.7,154,6,1265,74,68,2.1,32518
55426,T001038,Total male and female,GM0556,Maassluis,2018JJ00,2018,32518,3835,318,9.7,330,10.1,-12,1584,48.5,254,1330,1323,40.5,217,-9,1106,261,250,7.7,32768
55427,T001038,Total male and female,GM0556,Maassluis,2019JJ00,2019,32768,3864,352,10.7,329,10,23,1821,55.2,326,1495,1400,42.4,208,-22,1192,421,445,13.6,33213
55428,T001038,Total male and female,GM0556,Maassluis,2020JJ00,2020,33213,3917,360,10.8,363,10.9,-3,1746,52.3,220,1526,1387,41.5,161,-2,1226,359,354,10.7,33567
55429,T001038,Total male and female,GM0556,Maassluis,2021JJ00,2021,33567,3958,383,11.3,352,10.4,31,2026,59.8,231,1795,1478,43.7,206,-32,1272,548,581,17.3,34148
55430,T001038,Total male and female,GM0556,Maassluis,2022JJ00,2022,34148,4046,383,11,328,9.4,55,2443,70.4,414,2029,1342,38.6,218,-38,1124,1101,1155,33.8,35303
55431,T001038,Total male and female,GM0556,Maassluis,2023JJ00,2023,35303,4183,357,10,349,9.8,8,2018,56.7,354,1664,1496,42.1,296,-80,1200,522,529,15,35832
55502,T001038,Total male and female,GM0935,Maastricht,2012JJ00,2012,121050,2131,919,7.6,1240,10.2,-321,9501,78.2,4514,4987,8405,69.2,3035,-426,5370,1096,769,6.4,121819
55503,T001038,Total male and female,GM0935,Maastricht,2013JJ00,2013,121819,2152,911,7.5,1193,9.8,-282,9959,81.5,4617,5342,9007,73.7,3673,-287,5334,952,669,5.5,122488
55504,T001038,Total male and female,GM0935,Maastricht,2014JJ00,2014,122488,2163,869,7.1,1260,10.3,-391,9923,81,4588,5335,9608,78.5,4116,-266,5492,315,-91,-0.7,122397
55505,T001038,Total male and female,GM0935,Maastricht,2015JJ00,2015,122397,2158,927,7.6,1293,10.6,-366,10998,89.8,5984,5014,10496,85.7,4305,-178,6191,502,136,1.1,122533
55506,T001038,Total male and female,GM0935,Maastricht,2016JJ00,2016,122533,2175,897,7.3,1229,10,-332,11024,89.9,5637,5387,10457,85.3,4158,-93,6299,567,220,1.8,122753
55507,T001038,Total male and female,GM0935,Maastricht,2017JJ00,2017,122753,2179,863,7,1300,10.6,-437,11302,92.1,5934,5368,10894,88.8,4502,-66,6392,408,-30,-0.2,122723
55508,T001038,Total male and female,GM0935,Maastricht,2018JJ00,2018,122723,2192,801,6.6,1225,10,-424,10963,89.8,5938,5025,11697,95.8,5636,-97,6061,-734,-1158,-9.4,121565
55509,T001038,Total male and female,GM0935,Maastricht,2019JJ00,2019,121565,2171,856,7,1298,10.7,-442,11788,97,6681,5107,11320,93.1,5156,24,6164,468,10,0.1,121575
55510,T001038,Total male and female,GM0935,Maastricht,2020JJ00,2020,121575,2171,810,6.7,1482,12.3,-672,11909,98.5,5841,6068,12569,104,6223,7,6346,-660,-1348,-11.1,120227
55511,T001038,Total male and female,GM0935,Maastricht,2021JJ00,2021,120227,2147,868,7.2,1390,11.5,-522,13039,108,6800,6239,11580,95.9,5074,2,6506,1459,924,7.7,121151
55512,T001038,Total male and female,GM0935,Maastricht,2022JJ00,2022,121151,2172,815,6.7,1323,10.8,-508,13704,112.4,7704,6000,11601,95.1,5313,-14,6288,2103,1583,13.1,122734
55513,T001038,Total male and female,GM0935,Maastricht,2023JJ00,2023,122734,2200,816,6.6,1292,10.4,-476,14491,116.9,7508,6983,11461,92.4,5186,13,6275,3030,2551,20.8,125285
56076,T001038,Total male and female,GM1663,De Marne,2012JJ00,2012,10428,62,85,8.2,105,10.1,-20,338,32.6,46,292,410,39.5,30,-5,380,-72,-92,-8.8,10336
56077,T001038,Total male and female,GM1663,De Marne,2013JJ00,2013,10336,61,88,8.6,105,10.2,-17,358,34.9,34,324,468,45.6,30,-10,438,-110,-127,-12.3,10209
56078,T001038,Total male and female,GM1663,De Marne,2014JJ00,2014,10209,60,94,9.2,94,9.2,0,403,39.6,32,371,456,44.8,19,-3,437,-53,-52,-5.1,10157
56079,T001038,Total male and female,GM1663,De Marne,2015JJ00,2015,10157,60,73,7.2,103,10.2,-30,439,43.3,24,415,466,46,56,-14,410,-27,-56,-5.5,10101
56080,T001038,Total male and female,GM1663,De Marne,2016JJ00,2016,10101,59,109,10.8,100,9.9,9,425,42.1,37,388,452,44.8,37,-12,415,-27,-13,-1.3,10088
56081,T001038,Total male and female,GM1663,De Marne,2017JJ00,2017,10088,59,75,7.4,91,9,-16,454,45.1,25,429,467,46.4,25,-4,442,-13,-30,-3,10058
56082,T001038,Total male and female,GM1663,De Marne,2018JJ00,2018,10058,59,97,9.7,113,11.2,-16,480,47.8,34,446,481,47.9,21,-5,460,-1,-21,-2.1,10037
56158,T001038,Total male and female,GM0025,Marum,2012JJ00,2012,10413,161,101,9.7,80,7.7,21,369,35.5,43,326,421,40.5,25,2,396,-52,-31,-3,10382
56159,T001038,Total male and female,GM0025,Marum,2013JJ00,2013,10382,161,111,10.7,65,6.3,46,397,38.2,36,361,446,43,41,-16,405,-49,-4,-0.4,10378
56160,T001038,Total male and female,GM0025,Marum,2014JJ00,2014,10378,161,85,8.2,78,7.5,7,416,40.2,24,392,491,47.5,29,-2,462,-75,-67,-6.5,10311
56161,T001038,Total male and female,GM0025,Marum,2015JJ00,2015,10311,160,93,9,75,7.3,18,448,43.5,27,421,475,46.1,20,-2,455,-27,-6,-0.6,10305
56162,T001038,Total male and female,GM0025,Marum,2016JJ00,2016,10305,160,86,8.3,75,7.2,11,597,57.7,25,572,526,50.8,23,-2,503,71,83,8.1,10388
56163,T001038,Total male and female,GM0025,Marum,2017JJ00,2017,10388,161,84,8,85,8.1,-1,657,62.9,31,626,553,53,26,-4,527,104,100,9.6,10488
56164,T001038,Total male and female,GM0025,Marum,2018JJ00,2018,10488,163,108,10.3,101,9.6,7,586,55.9,39,547,593,56.6,21,2,572,-7,-4,-0.4,10484
56322,T001038,Total male and female,GM0420,Medemblik,2012JJ00,2012,43117,354,404,9.4,304,7,100,1520,35.2,229,1291,1495,34.6,167,-21,1328,25,131,3,43248
56323,T001038,Total male and female,GM0420,Medemblik,2013JJ00,2013,43248,356,395,9.1,325,7.5,70,1562,36.1,312,1250,1562,36.1,142,14,1420,0,72,1.7,43320
56324,T001038,Total male and female,GM0420,Medemblik,2014JJ00,2014,43320,357,399,9.2,367,8.4,32,1889,43.5,404,1485,1637,37.7,235,-4,1402,252,284,6.6,43604
56325,T001038,Total male and female,GM0420,Medemblik,2015JJ00,2015,43604,359,405,9.3,411,9.4,-6,2034,46.6,401,1633,1905,43.6,283,-11,1622,129,121,2.8,43725
56326,T001038,Total male and female,GM0420,Medemblik,2016JJ00,2016,43725,360,400,9.1,354,8.1,46,2111,48.1,337,1774,1822,41.5,240,-3,1582,289,333,7.6,44058
56327,T001038,Total male and female,GM0420,Medemblik,2017JJ00,2017,44058,363,422,9.5,413,9.3,9,2395,54.1,370,2025,1982,44.8,253,3,1729,413,422,9.6,44480
56328,T001038,Total male and female,GM0420,Medemblik,2018JJ00,2018,44480,366,425,9.5,365,8.2,60,2301,51.5,368,1933,2031,45.5,232,-17,1799,270,329,7.4,44809
56329,T001038,Total male and female,GM0420,Medemblik,2019JJ00,2019,44809,369,368,8.2,400,8.9,-32,2186,48.6,476,1710,1860,41.4,258,-17,1602,326,292,6.5,45101
56330,T001038,Total male and female,GM0420,Medemblik,2020JJ00,2020,45101,371,374,8.3,421,9.3,-47,2353,52.1,457,1896,2237,49.6,345,-102,1892,116,64,1.4,45165
56331,T001038,Total male and female,GM0420,Medemblik,2021JJ00,2021,45165,372,456,10.1,483,10.7,-27,2447,54,581,1866,2123,46.9,414,-62,1709,324,299,6.6,45464
56332,T001038,Total male and female,GM0420,Medemblik,2022JJ00,2022,45464,375,392,8.6,464,10.1,-72,2957,64.6,1066,1891,2321,50.7,585,-112,1736,636,567,12.5,46031
56333,T001038,Total male and female,GM0420,Medemblik,2023JJ00,2023,46031,380,362,7.9,438,9.5,-76,2423,52.7,557,1866,2373,51.6,500,-126,1873,50,-29,-0.6,46002
56732,T001038,Total male and female,GM0938,Meerssen,2012JJ00,2012,19430,716,118,6.1,183,9.4,-65,743,38.3,106,637,745,38.4,97,-14,648,-2,-68,-3.5,19362
56733,T001038,Total male and female,GM0938,Meerssen,2013JJ00,2013,19362,717,117,6.1,168,8.7,-51,778,40.3,107,671,835,43.2,121,3,714,-57,-108,-5.6,19254
56734,T001038,Total male and female,GM0938,Meerssen,2014JJ00,2014,19254,713,129,6.7,194,10.1,-65,760,39.7,75,685,886,46.2,92,2,794,-126,-191,-9.9,19063
56735,T001038,Total male and female,GM0938,Meerssen,2015JJ00,2015,19063,704,132,6.9,192,10.1,-60,868,45.6,89,779,831,43.6,98,-16,733,37,-23,-1.2,19040
56736,T001038,Total male and female,GM0938,Meerssen,2016JJ00,2016,19040,706,150,7.9,181,9.5,-31,910,47.8,101,809,847,44.4,90,-6,757,63,32,1.7,19072
56737,T001038,Total male and female,GM0938,Meerssen,2017JJ00,2017,19072,707,126,6.6,202,10.6,-76,931,48.9,98,833,889,46.7,90,-13,799,42,-33,-1.7,19039
56738,T001038,Total male and female,GM0938,Meerssen,2018JJ00,2018,19039,706,116,6.1,229,12.1,-113,923,48.6,121,802,926,48.8,95,-5,831,-3,-116,-6.1,18923
56739,T001038,Total male and female,GM0938,Meerssen,2019JJ00,2019,18923,702,101,5.4,217,11.5,-116,931,49.3,112,819,913,48.4,100,-12,813,18,-95,-5,18828
56740,T001038,Total male and female,GM0938,Meerssen,2020JJ00,2020,18828,698,143,7.6,264,14.1,-121,916,48.9,84,832,960,51.2,84,-5,876,-44,-167,-8.9,18661
56741,T001038,Total male and female,GM0938,Meerssen,2021JJ00,2021,18661,692,140,7.5,253,13.6,-113,918,49.3,116,802,885,47.5,115,-4,770,33,-80,-4.3,18581
56742,T001038,Total male and female,GM0938,Meerssen,2022JJ00,2022,18581,695,123,6.6,237,12.7,-114,1028,55.3,199,829,895,48.1,125,-3,770,133,19,1,18600
56743,T001038,Total male and female,GM0938,Meerssen,2023JJ00,2023,18600,696,127,6.8,250,13.4,-123,993,53.4,143,850,896,48.2,107,-6,789,97,-24,-1.3,18576
56901,T001038,Total male and female,GM1948,Meierijstad,2017JJ00,2017,79869,434,767,9.6,708,8.8,59,3236,40.4,558,2678,3017,37.7,515,-122,2502,219,279,3.5,80148
56902,T001038,Total male and female,GM1948,Meierijstad,2018JJ00,2018,80148,435,748,9.3,685,8.5,63,3453,42.9,654,2799,2850,35.4,426,-79,2424,603,667,8.3,80815
56903,T001038,Total male and female,GM1948,Meierijstad,2019JJ00,2019,80815,439,741,9.1,720,8.9,21,3232,39.9,717,2515,2869,35.4,460,-65,2409,363,379,4.7,81194
56904,T001038,Total male and female,GM1948,Meierijstad,2020JJ00,2020,81194,441,809,9.9,917,11.3,-108,3564,43.8,708,2856,3001,36.9,441,-88,2560,563,453,5.6,81647
56905,T001038,Total male and female,GM1948,Meierijstad,2021JJ00,2021,81647,444,824,10,761,9.3,63,3616,44,593,3023,2715,33.1,350,-64,2365,901,966,11.8,82613
56906,T001038,Total male and female,GM1948,Meierijstad,2022JJ00,2022,82613,449,799,9.6,778,9.4,21,3897,46.9,1320,2577,2817,33.9,632,-120,2185,1080,1102,13.3,83715
56907,T001038,Total male and female,GM1948,Meierijstad,2023JJ00,2023,83715,455,789,9.4,824,9.8,-35,3759,44.7,870,2889,3135,37.3,533,-81,2602,624,589,7,84304
57388,T001038,Total male and female,GM1908,Menameradiel,2012JJ00,2012,13773,200,124,9,101,7.3,23,455,33.1,46,409,523,38,22,5,501,-68,-46,-3.3,13727
57389,T001038,Total male and female,GM1908,Menameradiel,2013JJ00,2013,13727,199,134,9.8,100,7.3,34,450,32.8,32,418,538,39.3,23,4,515,-88,-54,-3.9,13673
57390,T001038,Total male and female,GM1908,Menameradiel,2014JJ00,2014,13673,199,127,9.3,99,7.3,28,498,36.5,45,453,586,43,33,0,553,-88,-61,-4.5,13612
57391,T001038,Total male and female,GM1908,Menameradiel,2015JJ00,2015,13612,198,117,8.6,114,8.4,3,531,39.1,47,484,603,44.4,30,-1,573,-72,-69,-5.1,13543
57392,T001038,Total male and female,GM1908,Menameradiel,2016JJ00,2016,13543,197,109,8.1,125,9.3,-16,622,46.1,42,580,696,51.6,51,-10,645,-74,-89,-6.6,13454
57393,T001038,Total male and female,GM1908,Menameradiel,2017JJ00,2017,13454,195,136,10.1,102,7.6,34,641,47.7,26,615,678,50.4,30,0,648,-37,-4,-0.3,13450
57470,T001038,Total male and female,GM1987,Menterwolde,2012JJ00,2012,12358,154,108,8.7,104,8.4,4,495,40,24,471,486,39.3,18,-2,468,9,12,1,12370
57471,T001038,Total male and female,GM1987,Menterwolde,2013JJ00,2013,12370,154,93,7.6,109,8.9,-16,432,35.1,25,407,528,42.9,11,3,517,-96,-112,-9.1,12258
57472,T001038,Total male and female,GM1987,Menterwolde,2014JJ00,2014,12258,153,95,7.8,107,8.8,-12,511,41.8,20,491,561,45.9,29,-1,532,-50,-61,-5,12197
57473,T001038,Total male and female,GM1987,Menterwolde,2015JJ00,2015,12197,152,104,8.5,108,8.8,-4,626,51.2,30,596,585,47.9,23,1,562,41,36,3,12233
57474,T001038,Total male and female,GM1987,Menterwolde,2016JJ00,2016,12233,152,89,7.3,107,8.8,-18,612,50.2,18,594,665,54.5,32,-11,633,-53,-71,-5.8,12162
57475,T001038,Total male and female,GM1987,Menterwolde,2017JJ00,2017,12162,152,96,7.9,111,9.2,-15,653,54,20,633,785,64.9,29,-4,756,-132,-149,-12.3,12013
57552,T001038,Total male and female,GM0119,Meppel,2012JJ00,2012,32573,585,325,10,310,9.5,15,1336,40.9,126,1210,1197,36.7,88,9,1109,139,153,4.7,32726
57553,T001038,Total male and female,GM0119,Meppel,2013JJ00,2013,32726,589,353,10.8,296,9,57,1224,37.3,117,1107,1140,34.8,83,5,1057,84,141,4.3,32867
57554,T001038,Total male and female,GM0119,Meppel,2014JJ00,2014,32867,592,349,10.6,292,8.9,57,1222,37.2,119,1103,1347,41,148,-28,1199,-125,-68,-2.1,32799
57555,T001038,Total male and female,GM0119,Meppel,2015JJ00,2015,32799,590,318,9.7,292,8.9,26,1380,42.1,140,1240,1411,43,136,-14,1275,-31,-5,-0.2,32794
57556,T001038,Total male and female,GM0119,Meppel,2016JJ00,2016,32794,590,296,9,318,9.7,-22,1720,52.3,124,1596,1465,44.5,103,-8,1362,255,231,7,33025
57557,T001038,Total male and female,GM0119,Meppel,2017JJ00,2017,33025,595,317,9.5,347,10.4,-30,1896,57.1,149,1747,1482,44.6,84,13,1398,414,385,11.7,33410
57558,T001038,Total male and female,GM0119,Meppel,2018JJ00,2018,33410,602,282,8.4,339,10.1,-57,1739,51.9,206,1533,1528,45.6,193,-40,1335,211,154,4.6,33564
57559,T001038,Total male and female,GM0119,Meppel,2019JJ00,2019,33564,604,311,9.2,333,9.9,-22,1883,55.8,212,1671,1503,44.5,126,-6,1377,380,356,10.6,33920
57560,T001038,Total male and female,GM0119,Meppel,2020JJ00,2020,33920,611,302,8.8,322,9.4,-20,1957,57.3,168,1789,1469,43,103,-15,1366,488,466,13.7,34386
57561,T001038,Total male and female,GM0119,Meppel,2021JJ00,2021,34386,619,363,10.5,389,11.3,-26,1930,55.8,237,1693,1528,44.2,131,-22,1397,402,375,10.9,34761
57562,T001038,Total male and female,GM0119,Meppel,2022JJ00,2022,34761,626,300,8.5,364,10.4,-64,2291,65.2,646,1645,1525,43.4,245,-68,1280,766,703,20.2,35464
57563,T001038,Total male and female,GM0119,Meppel,2023JJ00,2023,35464,639,336,9.4,375,10.5,-39,2167,60.8,369,1798,1779,49.9,291,-78,1488,388,346,9.8,35810
57880,T001038,Total male and female,GM0687,Middelburg (Z.),2012JJ00,2012,47768,984,487,10.2,436,9.2,51,2130,44.7,257,1873,2420,50.8,450,-233,1970,-290,-245,-5.1,47523
57881,T001038,Total male and female,GM0687,Middelburg (Z.),2013JJ00,2013,47523,980,467,9.8,400,8.4,67,2250,47.3,270,1980,2200,46.2,254,-44,1946,50,119,2.5,47642
57882,T001038,Total male and female,GM0687,Middelburg (Z.),2014JJ00,2014,47642,982,483,10.1,416,8.7,67,2189,46,308,1881,2289,48.1,282,-67,2007,-100,-29,-0.6,47613
57883,T001038,Total male and female,GM0687,Middelburg (Z.),2015JJ00,2015,47613,982,466,9.8,404,8.5,62,2636,55.2,496,2140,2435,51,270,-49,2165,201,260,5.5,47873
57884,T001038,Total male and female,GM0687,Middelburg (Z.),2016JJ00,2016,47873,988,466,9.7,441,9.2,25,2964,61.8,608,2356,2851,59.5,302,-57,2549,113,146,3,48019
57885,T001038,Total male and female,GM0687,Middelburg (Z.),2017JJ00,2017,48019,991,420,8.7,442,9.2,-22,3063,63.6,432,2631,2753,57.2,306,-52,2447,310,284,5.9,48303
57886,T001038,Total male and female,GM0687,Middelburg (Z.),2018JJ00,2018,48303,998,424,8.8,478,9.9,-54,3044,62.9,471,2573,2754,56.9,311,-54,2443,290,241,5,48544
57887,T001038,Total male and female,GM0687,Middelburg (Z.),2019JJ00,2019,48544,1003,485,10,492,10.1,-7,2841,58.4,491,2350,2561,52.6,338,-52,2223,280,278,5.7,48822
57888,T001038,Total male and female,GM0687,Middelburg (Z.),2020JJ00,2020,48822,1008,461,9.4,438,9,23,2897,59.3,489,2408,2778,56.8,317,-64,2461,119,142,2.9,48964
57889,T001038,Total male and female,GM0687,Middelburg (Z.),2021JJ00,2021,48964,1011,465,9.5,594,12.1,-129,3073,62.6,572,2501,2707,55.2,333,-66,2374,366,235,4.8,49199
57890,T001038,Total male and female,GM0687,Middelburg (Z.),2022JJ00,2022,49199,1017,457,9.2,501,10.1,-44,3664,73.9,1011,2653,2854,57.6,391,-37,2463,810,757,15.4,49956
57891,T001038,Total male and female,GM0687,Middelburg (Z.),2023JJ00,2023,49956,1033,447,8.9,488,9.8,-41,3335,66.7,701,2634,3247,65,533,-95,2714,88,48,1,50004
57962,T001038,Total male and female,GM0559,Middelharnis,2012JJ00,2012,18049,297,201,11.1,215,11.9,-14,560,31,58,502,520,28.8,34,4,486,40,21,1.2,18070
58208,T001038,Total male and female,GM1842,Midden-Delfland,2012JJ00,2012,18225,385,189,10.4,104,5.7,85,732,40.1,80,652,792,43.4,64,1,728,-60,26,1.4,18251
58209,T001038,Total male and female,GM1842,Midden-Delfland,2013JJ00,2013,18251,385,180,9.8,93,5.1,87,792,43.2,57,735,677,36.9,49,-3,628,115,205,11.2,18456
58210,T001038,Total male and female,GM1842,Midden-Delfland,2014JJ00,2014,18456,390,179,9.6,120,6.5,59,985,53,71,914,788,42.4,55,-3,733,197,253,13.7,18709
58211,T001038,Total male and female,GM1842,Midden-Delfland,2015JJ00,2015,18709,395,176,9.4,156,8.3,20,957,50.9,73,884,811,43.2,83,-2,728,146,164,8.8,18873
58212,T001038,Total male and female,GM1842,Midden-Delfland,2016JJ00,2016,18873,399,177,9.3,121,6.4,56,966,51,55,911,861,45.4,68,-10,793,105,161,8.5,19034
58213,T001038,Total male and female,GM1842,Midden-Delfland,2017JJ00,2017,19034,402,177,9.2,149,7.8,28,1192,62.1,67,1125,918,47.8,81,-13,837,274,304,16,19338
58214,T001038,Total male and female,GM1842,Midden-Delfland,2018JJ00,2018,19338,410,192,9.9,129,6.7,63,871,45,65,806,881,45.5,59,-12,822,-10,53,2.7,19391
58215,T001038,Total male and female,GM1842,Midden-Delfland,2019JJ00,2019,19391,411,172,8.9,139,7.2,33,817,42.2,62,755,900,46.5,69,-5,831,-83,-50,-2.6,19341
58216,T001038,Total male and female,GM1842,Midden-Delfland,2020JJ00,2020,19341,410,178,9.2,137,7.1,41,985,50.8,59,926,953,49.2,34,7,919,32,73,3.8,19414
58217,T001038,Total male and female,GM1842,Midden-Delfland,2021JJ00,2021,19414,411,183,9.4,144,7.4,39,903,46.4,72,831,873,44.9,62,1,811,30,70,3.6,19484
58218,T001038,Total male and female,GM1842,Midden-Delfland,2022JJ00,2022,19484,413,171,8.8,166,8.5,5,842,43.2,99,743,859,44.1,68,1,791,-17,-12,-0.6,19472
58219,T001038,Total male and female,GM1842,Midden-Delfland,2023JJ00,2023,19472,413,164,8.4,153,7.9,11,781,40.2,103,678,887,45.7,74,-2,813,-106,-95,-4.9,19377
58290,T001038,Total male and female,GM1731,Midden-Drenthe,2012JJ00,2012,33558,98,286,8.5,304,9.1,-18,1127,33.7,66,1061,1246,37.2,82,-3,1164,-119,-136,-4.1,33422
58291,T001038,Total male and female,GM1731,Midden-Drenthe,2013JJ00,2013,33422,98,271,8.1,350,10.5,-79,1237,37,69,1168,1215,36.4,65,9,1150,22,-56,-1.7,33366
58292,T001038,Total male and female,GM1731,Midden-Drenthe,2014JJ00,2014,33366,98,278,8.3,283,8.5,-5,1173,35.2,76,1097,1252,37.6,64,5,1188,-79,-82,-2.5,33284
58293,T001038,Total male and female,GM1731,Midden-Drenthe,2015JJ00,2015,33284,98,251,7.5,366,11,-115,2225,66.7,731,1494,1947,58.4,81,11,1866,278,166,5,33450
58294,T001038,Total male and female,GM1731,Midden-Drenthe,2016JJ00,2016,33450,98,277,8.3,360,10.8,-83,2352,70.4,628,1724,2335,69.9,92,6,2243,17,-51,-1.5,33399
58295,T001038,Total male and female,GM1731,Midden-Drenthe,2017JJ00,2017,33399,98,283,8.5,331,9.9,-48,1827,54.9,154,1673,2015,60.5,141,-49,1874,-188,-227,-6.8,33172
58296,T001038,Total male and female,GM1731,Midden-Drenthe,2018JJ00,2018,33172,97,275,8.3,339,10.2,-64,1688,50.9,121,1567,1621,48.9,83,-5,1538,67,6,0.2,33178
58297,T001038,Total male and female,GM1731,Midden-Drenthe,2019JJ00,2019,33178,97,248,7.5,367,11.1,-119,1587,47.8,133,1454,1461,44,69,-9,1392,126,7,0.2,33185
58298,T001038,Total male and female,GM1731,Midden-Drenthe,2020JJ00,2020,33185,97,246,7.4,371,11.1,-125,1796,54,122,1674,1476,44.3,64,-9,1412,320,196,5.9,33381
58299,T001038,Total male and female,GM1731,Midden-Drenthe,2021JJ00,2021,33381,98,320,9.5,380,11.3,-60,1746,52.1,64,1682,1380,41.2,78,-9,1302,366,308,9.2,33689
58300,T001038,Total male and female,GM1731,Midden-Drenthe,2022JJ00,2022,33689,99,258,7.6,400,11.8,-142,1894,56,398,1496,1455,43,190,-31,1265,439,298,8.8,33987
58301,T001038,Total male and female,GM1731,Midden-Drenthe,2023JJ00,2023,33987,100,296,8.7,351,10.3,-55,1635,48,216,1419,1472,43.2,142,-27,1330,163,105,3.1,34092
58378,T001038,Total male and female,GM1952,Midden-Groningen,2018JJ00,2018,60953,218,496,8.1,619,10.2,-123,2727,44.8,265,2462,2655,43.6,163,-34,2492,72,-54,-0.9,60899
58379,T001038,Total male and female,GM1952,Midden-Groningen,2019JJ00,2019,60899,217,514,8.4,580,9.5,-66,2603,42.8,282,2321,2634,43.3,171,0,2463,-31,-102,-1.7,60797
58380,T001038,Total male and female,GM1952,Midden-Groningen,2020JJ00,2020,60797,217,503,8.3,605,10,-102,2756,45.4,305,2451,2724,44.8,190,-32,2534,32,-71,-1.2,60726
58381,T001038,Total male and female,GM1952,Midden-Groningen,2021JJ00,2021,60726,217,491,8.1,660,10.9,-169,2973,48.9,354,2619,2630,43.2,287,-108,2343,343,172,2.8,60898
58382,T001038,Total male and female,GM1952,Midden-Groningen,2022JJ00,2022,60898,219,495,8.1,697,11.4,-202,3448,56.3,944,2504,2591,42.3,280,-29,2311,857,656,10.8,61554
58383,T001038,Total male and female,GM1952,Midden-Groningen,2023JJ00,2023,61554,221,541,8.8,701,11.4,-160,3092,50.3,586,2506,3050,49.6,509,-230,2541,42,-121,-2,61433
59028,T001038,Total male and female,GM0815,Mill en Sint Hubert,2012JJ00,2012,10926,209,69,6.3,78,7.1,-9,364,33.3,25,339,374,34.3,33,-9,341,-10,-20,-1.8,10906
59029,T001038,Total male and female,GM0815,Mill en Sint Hubert,2013JJ00,2013,10906,209,80,7.4,105,9.7,-25,323,29.7,26,297,354,32.5,20,-8,334,-31,-56,-5.1,10850
59030,T001038,Total male and female,GM0815,Mill en Sint Hubert,2014JJ00,2014,10850,208,83,7.7,93,8.6,-10,407,37.5,47,360,416,38.4,44,-10,372,-9,-19,-1.8,10831
59031,T001038,Total male and female,GM0815,Mill en Sint Hubert,2015JJ00,2015,10831,207,75,6.9,90,8.3,-15,393,36.3,23,370,408,37.7,42,-2,366,-15,-30,-2.8,10801
59032,T001038,Total male and female,GM0815,Mill en Sint Hubert,2016JJ00,2016,10801,207,71,6.6,123,11.4,-52,437,40.4,16,421,379,35.1,23,-5,356,58,6,0.6,10807
59033,T001038,Total male and female,GM0815,Mill en Sint Hubert,2017JJ00,2017,10807,207,85,7.9,109,10.1,-24,470,43.4,21,449,423,39.1,24,1,399,47,24,2.2,10831
59034,T001038,Total male and female,GM0815,Mill en Sint Hubert,2018JJ00,2018,10831,207,87,8,98,9,-11,513,47.2,38,475,442,40.7,45,-14,397,71,60,5.5,10891
59035,T001038,Total male and female,GM0815,Mill en Sint Hubert,2019JJ00,2019,10891,209,77,7.1,92,8.4,-15,524,48,43,481,461,42.2,35,-6,426,63,48,4.4,10939
59036,T001038,Total male and female,GM0815,Mill en Sint Hubert,2020JJ00,2020,10939,209,98,8.9,125,11.4,-27,517,47.1,38,479,425,38.7,36,-4,389,92,65,5.9,11004
59037,T001038,Total male and female,GM0815,Mill en Sint Hubert,2021JJ00,2021,11004,211,95,8.6,105,9.5,-10,497,45.1,43,454,429,38.9,32,-8,397,68,53,4.8,11057
59192,T001038,Total male and female,GM0265,Millingen aan de Rijn,2012JJ00,2012,5903,682,44,7.4,53,9,-9,198,33.5,21,177,169,28.6,10,-1,159,29,21,3.6,5924
59193,T001038,Total male and female,GM0265,Millingen aan de Rijn,2013JJ00,2013,5924,686,43,7.3,46,7.8,-3,188,31.9,21,167,233,39.5,16,3,217,-45,-48,-8.1,5876
59194,T001038,Total male and female,GM0265,Millingen aan de Rijn,2014JJ00,2014,5876,680,43,7.3,39,6.6,4,231,39.3,28,203,231,39.3,22,2,209,0,3,0.5,5879
59274,T001038,Total male and female,GM1709,Moerdijk,2012JJ00,2012,36522,229,349,9.5,336,9.2,13,1178,32.2,167,1011,1087,29.7,107,-2,980,91,103,2.8,36625
59275,T001038,Total male and female,GM1709,Moerdijk,2013JJ00,2013,36625,230,297,8.1,290,7.9,7,1245,33.9,123,1122,1151,31.4,130,-7,1021,94,104,2.8,36729
59276,T001038,Total male and female,GM1709,Moerdijk,2014JJ00,2014,36729,230,337,9.2,320,8.7,17,1341,36.5,155,1186,1273,34.6,135,-13,1138,68,87,2.4,36816
59277,T001038,Total male and female,GM1709,Moerdijk,2015JJ00,2015,36816,231,316,8.6,358,9.7,-42,1328,36.1,164,1164,1337,36.3,160,-32,1177,-9,-54,-1.5,36762
59278,T001038,Total male and female,GM1709,Moerdijk,2016JJ00,2016,36762,231,303,8.2,317,8.6,-14,1582,42.9,133,1449,1388,37.7,132,-4,1256,194,182,5,36944
59279,T001038,Total male and female,GM1709,Moerdijk,2017JJ00,2017,36944,232,298,8.1,347,9.4,-49,1595,43.2,174,1421,1525,41.3,162,-19,1363,70,23,0.6,36967
59280,T001038,Total male and female,GM1709,Moerdijk,2018JJ00,2018,36967,232,334,9,380,10.3,-46,1561,42.2,211,1350,1521,41.1,135,-12,1386,40,-6,-0.2,36961
59281,T001038,Total male and female,GM1709,Moerdijk,2019JJ00,2019,36961,232,286,7.7,370,10,-84,1732,46.8,285,1447,1482,40,154,-27,1328,250,168,4.5,37129
59282,T001038,Total male and female,GM1709,Moerdijk,2020JJ00,2020,37129,233,296,8,395,10.6,-99,1690,45.5,174,1516,1532,41.2,178,-59,1354,158,56,1.5,37185
59283,T001038,Total male and female,GM1709,Moerdijk,2021JJ00,2021,37185,234,331,8.9,437,11.7,-106,1737,46.6,185,1552,1504,40.4,168,-36,1336,233,128,3.4,37313
59284,T001038,Total male and female,GM1709,Moerdijk,2022JJ00,2022,37313,234,322,8.6,372,9.9,-50,1930,51.5,449,1481,1483,39.5,190,-14,1293,447,398,10.7,37711
59285,T001038,Total male and female,GM1709,Moerdijk,2023JJ00,2023,37711,237,337,8.9,356,9.4,-19,1919,50.6,337,1582,1520,40.1,278,-82,1242,399,380,10.1,38091
59691,T001038,Total male and female,GM1978,Molenlanden,2019JJ00,2019,43858,241,458,10.4,323,7.4,135,1486,33.9,171,1315,1563,35.6,126,-3,1437,-77,51,1.2,43909
59692,T001038,Total male and female,GM1978,Molenlanden,2020JJ00,2020,43909,242,459,10.4,305,6.9,154,1701,38.6,196,1505,1631,37.1,74,-6,1557,70,221,5,44130
59693,T001038,Total male and female,GM1978,Molenlanden,2021JJ00,2021,44130,243,513,11.6,373,8.4,140,1914,43.1,149,1765,1538,34.6,147,-13,1391,376,514,11.6,44644
59694,T001038,Total male and female,GM1978,Molenlanden,2022JJ00,2022,44644,246,477,10.6,336,7.5,141,2072,46.1,535,1537,1699,37.8,315,-36,1384,373,514,11.5,45158
59695,T001038,Total male and female,GM1978,Molenlanden,2023JJ00,2023,45158,249,490,10.8,335,7.4,155,1774,39.2,268,1506,1815,40.1,214,-18,1601,-41,113,2.5,45271
59767,T001038,Total male and female,GM1927,Molenwaard,2013JJ00,2013,29190,247,338,11.6,199,6.8,139,686,23.6,77,609,958,32.9,102,-21,856,-272,-158,-5.4,29032
59768,T001038,Total male and female,GM1927,Molenwaard,2014JJ00,2014,29032,245,355,12.2,193,6.7,162,811,28,74,737,1014,35,76,-12,938,-203,-39,-1.3,28993
59769,T001038,Total male and female,GM1927,Molenwaard,2015JJ00,2015,28993,245,323,11.1,189,6.5,134,915,31.5,68,847,979,33.7,73,-3,906,-64,74,2.6,29067
59770,T001038,Total male and female,GM1927,Molenwaard,2016JJ00,2016,29067,246,349,12,206,7.1,143,1011,34.7,100,911,1009,34.6,97,-17,912,2,145,5,29212
59771,T001038,Total male and female,GM1927,Molenwaard,2017JJ00,2017,29212,247,314,10.7,176,6,138,1108,37.9,87,1021,1161,39.7,92,-7,1069,-53,83,2.8,29295
59772,T001038,Total male and female,GM1927,Molenwaard,2018JJ00,2018,29295,248,332,11.3,203,6.9,129,1021,34.8,91,930,1126,38.4,97,-14,1029,-105,23,0.8,29318
60012,T001038,Total male and female,GM1955,Montferland,2012JJ00,2012,35043,332,252,7.2,303,8.7,-51,1132,32.4,117,1015,1292,37,122,-7,1170,-160,-209,-6,34834
60013,T001038,Total male and female,GM1955,Montferland,2013JJ00,2013,34834,330,264,7.6,301,8.6,-37,1403,40.2,164,1239,1214,34.8,123,-21,1091,189,153,4.4,34987
60014,T001038,Total male and female,GM1955,Montferland,2014JJ00,2014,34987,331,252,7.2,316,9,-64,1538,43.9,192,1346,1314,37.5,151,-21,1163,224,163,4.7,35150
60015,T001038,Total male and female,GM1955,Montferland,2015JJ00,2015,35150,333,279,7.9,348,9.9,-69,1437,40.9,164,1273,1343,38.2,132,-43,1211,94,23,0.7,35173
60016,T001038,Total male and female,GM1955,Montferland,2016JJ00,2016,35173,333,275,7.8,322,9.1,-47,1616,45.9,152,1464,1426,40.5,167,-31,1259,190,143,4.1,35316
60017,T001038,Total male and female,GM1955,Montferland,2017JJ00,2017,35316,334,306,8.6,369,10.4,-63,1911,53.9,242,1669,1538,43.4,141,-17,1397,373,311,8.8,35627
60018,T001038,Total male and female,GM1955,Montferland,2018JJ00,2018,35627,337,273,7.6,347,9.7,-74,1912,53.4,321,1591,1438,40.1,225,-36,1213,474,399,11.2,36026
60019,T001038,Total male and female,GM1955,Montferland,2019JJ00,2019,36026,341,315,8.7,399,11.1,-84,1790,49.7,232,1558,1722,47.8,200,-32,1522,68,-15,-0.4,36011
60020,T001038,Total male and female,GM1955,Montferland,2020JJ00,2020,36011,341,304,8.4,405,11.2,-101,1700,47.2,165,1535,1580,43.9,160,-52,1420,120,20,0.6,36031
60021,T001038,Total male and female,GM1955,Montferland,2021JJ00,2021,36031,341,316,8.7,434,12,-118,1903,52.6,194,1709,1457,40.3,124,-6,1333,446,328,9.1,36359
60022,T001038,Total male and female,GM1955,Montferland,2022JJ00,2022,36359,344,291,7.9,400,10.9,-109,2186,59.7,557,1629,1553,42.4,270,-49,1283,633,523,14.4,36882
60023,T001038,Total male and female,GM1955,Montferland,2023JJ00,2023,36882,349,294,8,435,11.8,-141,1693,45.9,289,1404,1562,42.4,278,-36,1284,131,-9,-0.2,36873
60094,T001038,Total male and female,GM0335,Montfoort,2012JJ00,2012,13601,361,146,10.7,75,5.5,71,366,26.9,35,331,416,30.6,34,-10,382,-50,20,1.5,13621
60095,T001038,Total male and female,GM0335,Montfoort,2013JJ00,2013,13621,361,148,10.9,70,5.1,78,449,32.9,38,411,509,37.3,52,-7,457,-60,18,1.3,13639
60096,T001038,Total male and female,GM0335,Montfoort,2014JJ00,2014,13639,362,152,11.1,61,4.5,91,449,32.9,47,402,507,37.1,42,-9,465,-58,33,2.4,13672
60097,T001038,Total male and female,GM0335,Montfoort,2015JJ00,2015,13672,363,142,10.3,55,4,87,516,37.6,44,472,492,35.8,37,-3,455,24,111,8.1,13783
60098,T001038,Total male and female,GM0335,Montfoort,2016JJ00,2016,13783,366,151,10.9,84,6.1,67,612,44.3,59,553,597,43.2,54,-12,543,15,83,6,13866
60099,T001038,Total male and female,GM0335,Montfoort,2017JJ00,2017,13866,368,129,9.3,90,6.5,39,589,42.5,43,546,616,44.4,18,10,598,-27,13,0.9,13879
60100,T001038,Total male and female,GM0335,Montfoort,2018JJ00,2018,13879,369,141,10.1,83,6,58,600,43,57,543,541,38.8,41,-5,500,59,117,8.4,13996
60101,T001038,Total male and female,GM0335,Montfoort,2019JJ00,2019,13996,373,139,10,90,6.4,49,395,28.3,74,321,525,37.6,44,-8,481,-130,-79,-5.6,13917
60102,T001038,Total male and female,GM0335,Montfoort,2020JJ00,2020,13917,370,129,9.3,89,6.4,40,524,37.7,67,457,583,41.9,58,-6,525,-59,-21,-1.5,13896
60103,T001038,Total male and female,GM0335,Montfoort,2021JJ00,2021,13896,370,131,9.5,74,5.3,57,506,36.5,32,474,642,46.3,41,-8,601,-136,-78,-5.6,13818
60104,T001038,Total male and female,GM0335,Montfoort,2022JJ00,2022,13818,368,109,7.9,84,6.1,25,655,47.2,178,477,569,41,53,3,516,86,111,8,13929
60105,T001038,Total male and female,GM0335,Montfoort,2023JJ00,2023,13929,371,116,8.3,93,6.7,23,550,39.6,72,478,634,45.6,72,-12,562,-84,-61,-4.4,13868
60258,T001038,Total male and female,GM0944,Mook en Middelaar,2012JJ00,2012,7874,453,36,4.6,50,6.4,-14,359,45.7,39,320,390,49.7,25,-2,365,-31,-47,-6,7827
60259,T001038,Total male and female,GM0944,Mook en Middelaar,2013JJ00,2013,7827,450,43,5.5,59,7.6,-16,343,43.9,28,315,359,46,22,5,337,-16,-31,-4,7796
60260,T001038,Total male and female,GM0944,Mook en Middelaar,2014JJ00,2014,7796,448,37,4.8,53,6.8,-16,391,50.3,46,345,409,52.6,34,-7,375,-18,-34,-4.4,7762
60261,T001038,Total male and female,GM0944,Mook en Middelaar,2015JJ00,2015,7762,446,47,6.1,54,7,-7,445,57.4,61,384,444,57.2,30,-5,414,1,-7,-0.9,7755
60262,T001038,Total male and female,GM0944,Mook en Middelaar,2016JJ00,2016,7755,446,52,6.7,49,6.3,3,490,63.1,48,442,469,60.4,41,-4,428,21,20,2.6,7775
60263,T001038,Total male and female,GM0944,Mook en Middelaar,2017JJ00,2017,7775,447,39,5,54,6.9,-15,518,66.7,48,470,510,65.6,34,-5,476,8,-7,-0.9,7768
60264,T001038,Total male and female,GM0944,Mook en Middelaar,2018JJ00,2018,7768,447,43,5.5,54,6.9,-11,493,63.3,42,451,444,57,28,-5,416,49,38,4.9,7806
60265,T001038,Total male and female,GM0944,Mook en Middelaar,2019JJ00,2019,7806,449,52,6.6,66,8.4,-14,478,61.1,72,406,421,53.8,24,-1,397,57,41,5.3,7847
60266,T001038,Total male and female,GM0944,Mook en Middelaar,2020JJ00,2020,7847,451,43,5.5,69,8.8,-26,546,69.3,50,496,458,58.1,27,-9,431,88,62,7.9,7909
60267,T001038,Total male and female,GM0944,Mook en Middelaar,2021JJ00,2021,7909,455,66,8.3,71,8.9,-5,447,56.2,48,399,361,45.4,15,-2,346,86,80,10.1,7989
60268,T001038,Total male and female,GM0944,Mook en Middelaar,2022JJ00,2022,7989,459,67,8.4,73,9.1,-6,482,60.1,74,408,421,52.5,39,0,382,61,54,6.8,8043
60269,T001038,Total male and female,GM0944,Mook en Middelaar,2023JJ00,2023,8043,463,51,6.3,78,9.6,-27,566,69.9,137,429,428,52.9,45,-2,383,138,110,13.7,8153
60422,T001038,Total male and female,GM0424,Muiden,2012JJ00,2012,6466,447,48,7.5,41,6.4,7,260,40.4,32,228,340,52.9,35,-1,305,-80,-73,-11.3,6393
60423,T001038,Total male and female,GM0424,Muiden,2013JJ00,2013,6393,442,42,6.6,52,8.2,-10,302,47.6,45,257,398,62.8,14,5,384,-96,-106,-16.6,6287
60424,T001038,Total male and female,GM0424,Muiden,2014JJ00,2014,6287,435,45,7.2,51,8.1,-6,316,50.4,35,281,347,55.4,26,5,321,-31,-38,-6,6249
60425,T001038,Total male and female,GM0424,Muiden,2015JJ00,2015,6249,432,50,8,44,7.1,6,332,53.3,41,291,381,61.2,56,-5,325,-49,-47,-7.5,6202
60750,T001038,Total male and female,GM0425,Naarden,2012JJ00,2012,17163,802,146,8.5,168,9.8,-22,974,56.6,96,878,852,49.5,54,3,798,122,100,5.8,17263
60751,T001038,Total male and female,GM0425,Naarden,2013JJ00,2013,17263,806,130,7.5,170,9.9,-40,1011,58.7,137,874,1034,60,147,-6,887,-23,-58,-3.4,17205
60752,T001038,Total male and female,GM0425,Naarden,2014JJ00,2014,17205,803,153,8.9,162,9.4,-9,1200,69.7,129,1071,1186,68.9,132,-4,1054,14,4,0.2,17209
60753,T001038,Total male and female,GM0425,Naarden,2015JJ00,2015,17209,803,136,7.9,185,10.7,-49,1353,78.2,180,1173,1109,64.1,93,-3,1016,244,188,10.9,17397
60832,T001038,Total male and female,GM1740,Neder-Betuwe,2012JJ00,2012,22614,373,260,11.5,165,7.3,95,803,35.5,56,747,921,40.7,74,-17,847,-118,-21,-0.9,22593
60833,T001038,Total male and female,GM1740,Neder-Betuwe,2013JJ00,2013,22593,372,313,13.9,159,7,154,668,29.6,54,614,840,37.2,30,-1,810,-172,-18,-0.8,22575
60834,T001038,Total male and female,GM1740,Neder-Betuwe,2014JJ00,2014,22555,376,282,12.5,185,8.2,97,780,34.5,85,695,705,31.1,37,2,668,75,173,7.7,22728
60835,T001038,Total male and female,GM1740,Neder-Betuwe,2015JJ00,2015,22728,379,317,13.8,137,6,180,932,40.7,87,845,793,34.6,71,-24,722,139,321,14.1,23049
60836,T001038,Total male and female,GM1740,Neder-Betuwe,2016JJ00,2016,23049,384,296,12.8,191,8.2,105,963,41.6,67,896,814,35.1,41,-3,773,149,254,11,23303
60837,T001038,Total male and female,GM1740,Neder-Betuwe,2017JJ00,2017,23303,388,336,14.3,168,7.2,168,1121,47.8,71,1050,976,41.6,56,-21,920,145,312,13.4,23615
60838,T001038,Total male and female,GM1740,Neder-Betuwe,2018JJ00,2018,23615,394,346,14.5,182,7.6,164,1134,47.6,268,866,878,36.9,45,-17,833,256,419,17.7,24034
60839,T001038,Total male and female,GM1740,Neder-Betuwe,2019JJ00,2019,24034,401,344,14.2,184,7.6,160,1100,45.5,213,887,954,39.4,89,-37,865,146,305,12.7,24339
60840,T001038,Total male and female,GM1740,Neder-Betuwe,2020JJ00,2020,24339,406,349,14.2,210,8.6,139,1086,44.3,166,920,915,37.4,109,-29,806,171,309,12.7,24648
60841,T001038,Total male and female,GM1740,Neder-Betuwe,2021JJ00,2021,24648,411,370,14.9,210,8.5,160,1269,51.1,318,951,1047,42.1,138,-72,909,222,384,15.6,25032
60842,T001038,Total male and female,GM1740,Neder-Betuwe,2022JJ00,2022,25032,417,347,13.7,198,7.8,149,1476,58.5,590,886,1208,47.9,308,-52,900,268,416,16.6,25448
60843,T001038,Total male and female,GM1740,Neder-Betuwe,2023JJ00,2023,25448,424,357,14,192,7.5,165,1301,50.9,317,984,1205,47.1,267,-127,938,96,260,10.2,25708
61078,T001038,Total male and female,GM0643,Nederlek,2012JJ00,2012,13992,503,149,10.6,130,9.2,19,516,36.7,53,463,396,28.2,30,-4,366,120,139,9.9,14131
61079,T001038,Total male and female,GM0643,Nederlek,2013JJ00,2013,14131,509,102,7.2,130,9.2,-28,432,30.6,45,387,460,32.6,46,-7,414,-28,-56,-4,14075
61080,T001038,Total male and female,GM0643,Nederlek,2014JJ00,2014,14075,507,103,7.3,142,10.1,-39,578,41,48,530,458,32.5,35,4,423,120,68,4.8,14143
61160,T001038,Total male and female,GM0946,Nederweert,2012JJ00,2012,16771,167,154,9.2,134,8,20,558,33.3,98,460,565,33.7,50,-3,515,-7,14,0.8,16785
61161,T001038,Total male and female,GM0946,Nederweert,2013JJ00,2013,16785,168,123,7.3,127,7.6,-4,551,32.9,78,473,581,34.6,82,-10,499,-30,-34,-2,16751
61162,T001038,Total male and female,GM0946,Nederweert,2014JJ00,2014,16751,168,134,8,115,6.9,19,597,35.6,90,507,591,35.3,63,-19,528,6,25,1.5,16776
61163,T001038,Total male and female,GM0946,Nederweert,2015JJ00,2015,16776,168,127,7.6,147,8.8,-20,653,38.9,81,572,615,36.6,56,-4,559,38,17,1,16793
61164,T001038,Total male and female,GM0946,Nederweert,2016JJ00,2016,16793,168,145,8.6,148,8.8,-3,805,47.8,91,714,731,43.4,83,-25,648,74,71,4.2,16864
61165,T001038,Total male and female,GM0946,Nederweert,2017JJ00,2017,16864,169,132,7.8,125,7.4,7,869,51.3,98,771,702,41.4,67,-14,635,167,174,10.3,17038
61166,T001038,Total male and female,GM0946,Nederweert,2018JJ00,2018,17038,170,142,8.3,146,8.6,-4,677,39.8,98,579,709,41.7,91,-13,618,-32,-37,-2.2,17001
61167,T001038,Total male and female,GM0946,Nederweert,2019JJ00,2019,17001,170,141,8.3,125,7.3,16,682,40.1,124,558,680,40,71,-5,609,2,18,1.1,17019
61168,T001038,Total male and female,GM0946,Nederweert,2020JJ00,2020,17019,170,147,8.6,172,10.1,-25,848,49.6,153,695,672,39.3,56,-7,616,176,152,8.9,17171
61169,T001038,Total male and female,GM0946,Nederweert,2021JJ00,2021,17171,172,180,10.4,170,9.9,10,896,52,148,748,755,43.8,117,-34,638,141,152,8.9,17323
61170,T001038,Total male and female,GM0946,Nederweert,2022JJ00,2022,17323,173,149,8.6,170,9.8,-21,881,50.6,278,603,685,39.3,145,-21,540,196,176,10.2,17499
61171,T001038,Total male and female,GM0946,Nederweert,2023JJ00,2023,17499,175,161,9.2,175,10,-14,787,45,249,538,780,44.6,136,-40,644,7,-7,-0.4,17492
61406,T001038,Total male and female,GM0304,Neerijnen,2012JJ00,2012,11930,181,134,11.2,76,6.3,58,418,34.9,47,371,384,32.1,19,-3,365,34,92,7.7,12022
61407,T001038,Total male and female,GM0304,Neerijnen,2013JJ00,2013,12022,182,133,11.1,104,8.7,29,393,32.7,54,339,424,35.3,40,-1,384,-31,-2,-0.2,12020
61408,T001038,Total male and female,GM0304,Neerijnen,2014JJ00,2014,12020,182,137,11.4,80,6.7,57,421,35,36,385,460,38.2,20,-2,440,-39,18,1.5,12038
61409,T001038,Total male and female,GM0304,Neerijnen,2015JJ00,2015,12038,182,134,11.1,82,6.8,52,536,44.4,73,463,504,41.7,19,1,485,32,84,7,12122
61410,T001038,Total male and female,GM0304,Neerijnen,2016JJ00,2016,12122,184,152,12.4,78,6.4,74,653,53.4,59,594,504,41.2,50,-5,454,149,222,18.3,12344
61411,T001038,Total male and female,GM0304,Neerijnen,2017JJ00,2017,12344,187,132,10.7,92,7.4,40,596,48.2,50,546,583,47.1,44,-1,539,13,53,4.3,12397
61412,T001038,Total male and female,GM0304,Neerijnen,2018JJ00,2018,12397,188,133,10.7,98,7.9,35,680,54.7,69,611,633,50.9,26,5,607,47,71,5.7,12468
62062,T001038,Total male and female,GM0356,Nieuwegein,2012JJ00,2012,60720,2566,642,10.6,401,6.6,241,3023,49.7,308,2715,3091,50.8,293,-21,2798,-68,175,2.9,60895
62063,T001038,Total male and female,GM0356,Nieuwegein,2013JJ00,2013,60895,2576,656,10.8,395,6.5,261,2946,48.3,373,2573,3059,50.2,279,25,2780,-113,143,2.3,61038
62064,T001038,Total male and female,GM0356,Nieuwegein,2014JJ00,2014,61038,2582,703,11.5,451,7.4,252,3282,53.7,378,2904,3317,54.2,287,23,3030,-35,226,3.7,61264
62065,T001038,Total male and female,GM0356,Nieuwegein,2015JJ00,2015,61264,2592,636,10.3,401,6.5,235,3693,60,406,3287,3441,55.9,342,-5,3099,252,485,7.9,61749
62066,T001038,Total male and female,GM0356,Nieuwegein,2016JJ00,2016,61749,2620,636,10.3,379,6.1,257,3446,55.8,384,3062,3581,57.9,260,36,3321,-135,119,1.9,61868
62067,T001038,Total male and female,GM0356,Nieuwegein,2017JJ00,2017,61868,2625,663,10.7,411,6.6,252,4069,65.5,385,3684,3752,60.4,323,-21,3429,317,558,9,62426
62068,T001038,Total male and female,GM0356,Nieuwegein,2018JJ00,2018,62426,2655,613,9.8,454,7.2,159,4021,64.1,496,3525,3565,56.8,232,40,3333,456,610,9.8,63036
62069,T001038,Total male and female,GM0356,Nieuwegein,2019JJ00,2019,63036,2681,741,11.7,434,6.9,307,3857,61,533,3324,3740,59.1,255,23,3485,117,426,6.8,63462
62070,T001038,Total male and female,GM0356,Nieuwegein,2020JJ00,2020,63462,2699,664,10.4,454,7.1,210,4109,64.5,445,3664,3912,61.4,288,-9,3624,197,404,6.4,63866
62071,T001038,Total male and female,GM0356,Nieuwegein,2021JJ00,2021,63866,2717,696,10.8,477,7.4,219,4334,67.5,421,3913,3862,60.1,262,-15,3600,472,688,10.8,64554
62072,T001038,Total male and female,GM0356,Nieuwegein,2022JJ00,2022,64554,2756,642,9.9,516,7.9,126,4657,71.7,778,3879,3905,60.1,372,-31,3533,752,872,13.5,65426
62073,T001038,Total male and female,GM0356,Nieuwegein,2023JJ00,2023,65426,2794,692,10.5,567,8.6,125,4337,66,691,3646,3918,59.6,407,-40,3511,419,545,8.3,65971
62882,T001038,Total male and female,GM0569,Nieuwkoop,2012JJ00,2012,26974,342,220,8.1,176,6.5,44,835,30.9,141,694,773,28.6,86,-7,687,62,108,4,27082
62883,T001038,Total male and female,GM0569,Nieuwkoop,2013JJ00,2013,27082,344,230,8.5,174,6.4,56,767,28.3,97,670,800,29.5,56,-2,744,-33,22,0.8,27104
62884,T001038,Total male and female,GM0569,Nieuwkoop,2014JJ00,2014,27104,344,267,9.8,189,7,78,821,30.3,97,724,890,32.8,104,-27,786,-69,10,0.4,27114
62885,T001038,Total male and female,GM0569,Nieuwkoop,2015JJ00,2015,27114,344,237,8.7,218,8,19,1224,44.9,110,1114,925,33.9,97,-20,828,299,319,11.8,27433
62886,T001038,Total male and female,GM0569,Nieuwkoop,2016JJ00,2016,27433,350,267,9.6,222,8,45,1420,51.3,166,1254,983,35.5,80,-4,903,437,481,17.5,27914
62887,T001038,Total male and female,GM0569,Nieuwkoop,2017JJ00,2017,27914,357,275,9.8,172,6.1,103,1344,47.8,114,1230,1091,38.8,104,-37,987,253,355,12.7,28269
62888,T001038,Total male and female,GM0569,Nieuwkoop,2018JJ00,2018,28269,362,287,10.1,220,7.7,67,1314,46.2,181,1133,1021,35.9,110,-24,911,293,359,12.7,28628
62889,T001038,Total male and female,GM0569,Nieuwkoop,2019JJ00,2019,28628,367,284,9.9,202,7,82,1267,44.1,149,1118,1166,40.6,116,-16,1050,101,183,6.4,28811
62890,T001038,Total male and female,GM0569,Nieuwkoop,2020JJ00,2020,28811,369,327,11.3,264,9.1,63,1437,49.6,153,1284,1160,40,122,-10,1038,277,340,11.8,29151
62891,T001038,Total male and female,GM0569,Nieuwkoop,2021JJ00,2021,29151,373,313,10.7,220,7.5,93,1184,40.5,143,1041,1126,38.5,123,-27,1003,58,153,5.2,29304
62892,T001038,Total male and female,GM0569,Nieuwkoop,2022JJ00,2022,29304,373,297,10.1,262,8.9,35,1273,43.3,288,985,1147,39,172,-31,975,126,159,5.4,29463
62893,T001038,Total male and female,GM0569,Nieuwkoop,2023JJ00,2023,29463,376,262,8.9,251,8.5,11,1243,42.2,233,1010,1215,41.2,155,-16,1060,28,38,1.3,29501
63046,T001038,Total male and female,GM0571,Nieuw-Lekkerland,2012JJ00,2012,9520,916,128,13.4,62,6.5,66,245,25.7,17,228,350,36.8,23,-14,327,-105,6,0.6,9526
63948,T001038,Total male and female,GM0267,Nijkerk,2012JJ00,2012,40126,578,447,11.1,277,6.9,170,1329,33,143,1186,1267,31.5,122,-24,1145,62,229,5.7,40355
63949,T001038,Total male and female,GM0267,Nijkerk,2013JJ00,2013,40355,582,480,11.9,278,6.9,202,1378,34,289,1089,1290,31.9,112,-17,1178,88,294,7.3,40649
63950,T001038,Total male and female,GM0267,Nijkerk,2014JJ00,2014,40638,585,477,11.7,271,6.6,206,1488,36.5,208,1280,1459,35.8,195,-43,1264,29,232,5.7,40870
63951,T001038,Total male and female,GM0267,Nijkerk,2015JJ00,2015,40870,589,455,11.1,269,6.6,186,1684,41,262,1422,1545,37.7,179,-19,1366,139,329,8,41199
63952,T001038,Total male and female,GM0267,Nijkerk,2016JJ00,2016,41199,593,455,11,290,7,165,1917,46.2,214,1703,1506,36.3,203,-27,1303,411,576,14,41775
63953,T001038,Total male and female,GM0267,Nijkerk,2017JJ00,2017,41775,602,437,10.4,286,6.8,151,2114,50.3,212,1902,1730,41.2,206,-16,1524,384,532,12.7,42307
63954,T001038,Total male and female,GM0267,Nijkerk,2018JJ00,2018,42307,610,463,10.9,284,6.7,179,2062,48.4,268,1794,1608,37.7,183,-18,1425,454,636,15,42943
63955,T001038,Total male and female,GM0267,Nijkerk,2019JJ00,2019,42943,619,451,10.5,314,7.3,137,1904,44.2,241,1663,1814,42.1,212,-18,1602,90,228,5.3,43171
63956,T001038,Total male and female,GM0267,Nijkerk,2020JJ00,2020,43171,623,456,10.5,299,6.9,157,1943,44.8,216,1727,1671,38.5,142,-7,1529,272,429,9.9,43600
63957,T001038,Total male and female,GM0267,Nijkerk,2021JJ00,2021,43600,629,476,10.8,366,8.3,110,2345,53.3,216,2129,1743,39.7,177,-4,1566,602,711,16.3,44311
63958,T001038,Total male and female,GM0267,Nijkerk,2022JJ00,2022,44311,639,452,10.1,359,8,93,2191,49.1,434,1757,1618,36.2,203,-27,1415,573,664,15,44975
63959,T001038,Total male and female,GM0267,Nijkerk,2023JJ00,2023,44975,649,432,9.6,374,8.3,58,2124,47,355,1769,1796,39.8,257,-69,1539,328,386,8.6,45361
64030,T001038,Total male and female,GM0268,Nijmegen,2012JJ00,2012,165182,3081,1731,10.4,1299,7.8,432,12002,72.4,2194,9808,11222,67.7,2195,-612,9027,780,1200,7.3,166382
64031,T001038,Total male and female,GM0268,Nijmegen,2013JJ00,2013,166382,3104,1747,10.4,1310,7.8,437,12550,75,2377,10173,11058,66.1,2349,-688,8709,1492,1910,11.5,168292
64032,T001038,Total male and female,GM0268,Nijmegen,2014JJ00,2014,168292,3139,1783,10.5,1219,7.2,564,13293,78.4,2585,10708,11451,67.6,2193,-477,9258,1842,2389,14.2,170681
64033,T001038,Total male and female,GM0268,Nijmegen,2015JJ00,2015,170681,3184,1798,10.5,1350,7.9,448,13006,75.9,2865,10141,12066,70.4,2243,-517,9823,940,1383,8.1,172064
64034,T001038,Total male and female,GM0268,Nijmegen,2016JJ00,2016,172064,3210,1706,9.9,1298,7.5,408,14224,82.3,3340,10884,13108,75.9,2470,-549,10638,1116,1492,8.7,173556
64035,T001038,Total male and female,GM0268,Nijmegen,2017JJ00,2017,173556,3237,1809,10.4,1438,8.2,371,15363,87.9,3209,12154,13319,76.2,2460,-556,10859,2044,2392,13.8,175948
64036,T001038,Total male and female,GM0268,Nijmegen,2018JJ00,2018,175948,3316,1709,9.7,1392,7.9,317,13506,76.6,3280,10226,13016,73.8,2671,-709,10345,490,808,4.6,176756
64037,T001038,Total male and female,GM0268,Nijmegen,2019JJ00,2019,176731,3329,1738,9.8,1352,7.6,386,13385,75.5,3360,10025,12861,72.6,2914,-942,9947,524,928,5.3,177659
64038,T001038,Total male and female,GM0268,Nijmegen,2020JJ00,2020,177659,3346,1823,10.3,1555,8.8,268,12123,68.3,2630,9493,12678,71.4,2319,-490,10359,-555,-300,-1.7,177359
64039,T001038,Total male and female,GM0268,Nijmegen,2021JJ00,2021,177359,3341,1819,10.2,1564,8.8,255,12658,71,2721,9937,11158,62.6,1732,-517,9426,1500,1741,9.8,179100
64040,T001038,Total male and female,GM0268,Nijmegen,2022JJ00,2022,179100,3391,1687,9.3,1558,8.6,129,14547,80.5,4372,10175,11278,62.4,2042,-399,9236,3269,3380,18.9,182480
64041,T001038,Total male and female,GM0268,Nijmegen,2023JJ00,2023,182480,3455,1690,9.1,1511,8.2,179,16554,89.6,3548,13006,12124,65.6,2512,-544,9612,4430,4569,25,187049
64197,T001038,Total male and female,GM1930,Nissewaard,2015JJ00,2015,85121,1020,824,9.7,590,6.9,234,3069,36,415,2654,3058,35.9,379,-48,2679,11,172,2,85293
64198,T001038,Total male and female,GM1930,Nissewaard,2016JJ00,2016,85293,1025,847,9.9,670,7.9,177,3190,37.4,358,2832,3259,38.2,327,-75,2932,-69,108,1.3,85401
64199,T001038,Total male and female,GM1930,Nissewaard,2017JJ00,2017,85401,1026,757,8.8,685,8,72,3763,44,366,3397,3433,40.1,402,-60,3031,330,400,4.7,85801
64200,T001038,Total male and female,GM1930,Nissewaard,2018JJ00,2018,84593,1150,792,9.4,662,7.8,130,3547,41.9,352,3195,3470,41,300,-33,3170,77,204,2.4,84797
64201,T001038,Total male and female,GM1930,Nissewaard,2019JJ00,2019,84797,1152,858,10.1,710,8.4,148,3756,44.2,431,3325,3485,41,305,-46,3180,271,422,5,85219
64202,T001038,Total male and female,GM1930,Nissewaard,2020JJ00,2020,85219,1158,814,9.5,784,9.2,30,3725,43.7,399,3326,3532,41.4,252,-34,3280,193,221,2.6,85440
64203,T001038,Total male and female,GM1930,Nissewaard,2021JJ00,2021,85440,1161,913,10.6,765,8.9,148,4315,50.2,396,3919,3567,41.5,279,6,3288,748,892,10.4,86332
64204,T001038,Total male and female,GM1930,Nissewaard,2022JJ00,2022,86332,1178,878,10.1,808,9.3,70,4103,47.4,728,3375,3668,42.4,422,-25,3246,435,501,5.8,86833
64205,T001038,Total male and female,GM1930,Nissewaard,2023JJ00,2023,86833,1184,842,9.7,803,9.2,39,4446,51,677,3769,3678,42.2,322,-17,3356,768,806,9.3,87639
64365,T001038,Total male and female,GM1970,Noardeast-Fryslân,2019JJ00,2019,45181,120,424,9.4,415,9.2,9,1644,36.4,139,1505,1607,35.5,100,-23,1507,37,47,1,45228
64366,T001038,Total male and female,GM1970,Noardeast-Fryslân,2020JJ00,2020,45228,120,430,9.5,485,10.7,-55,1825,40.2,134,1691,1516,33.4,77,-6,1439,309,253,5.6,45481
64367,T001038,Total male and female,GM1970,Noardeast-Fryslân,2021JJ00,2021,45481,120,453,9.9,514,11.3,-61,1694,37.2,112,1582,1520,33.4,78,-2,1442,174,112,2.5,45593
64368,T001038,Total male and female,GM1970,Noardeast-Fryslân,2022JJ00,2022,45593,120,413,9,497,10.9,-84,1809,39.6,296,1513,1506,33,154,-14,1352,303,219,4.8,45812
64369,T001038,Total male and female,GM1970,Noardeast-Fryslân,2023JJ00,2023,45812,121,417,9.1,504,11,-87,1698,37,195,1503,1557,34,167,-20,1390,141,54,1.2,45866
64522,T001038,Total male and female,GM1695,Noord-Beveland,2012JJ00,2012,7522,88,67,8.9,69,9.2,-2,473,62.9,58,415,482,64.1,24,-3,458,-9,-13,-1.7,7509
64523,T001038,Total male and female,GM1695,Noord-Beveland,2013JJ00,2013,7509,87,74,9.8,86,11.4,-12,487,64.8,41,446,453,60.2,15,2,438,34,21,2.8,7530
64524,T001038,Total male and female,GM1695,Noord-Beveland,2014JJ00,2014,7530,88,65,8.7,86,11.5,-21,423,56.5,72,351,498,66.6,48,-17,450,-75,-97,-12.9,7433
64525,T001038,Total male and female,GM1695,Noord-Beveland,2015JJ00,2015,7433,87,66,8.9,88,11.8,-22,435,58.6,52,383,426,57.4,38,-8,388,9,-12,-1.6,7421
64526,T001038,Total male and female,GM1695,Noord-Beveland,2016JJ00,2016,7421,86,55,7.4,111,15,-56,468,63.2,57,411,451,60.9,37,-10,414,17,-39,-5.3,7382
64527,T001038,Total male and female,GM1695,Noord-Beveland,2017JJ00,2017,7382,86,53,7.2,101,13.7,-48,529,72,52,477,549,74.7,69,-12,480,-20,-68,-9.2,7314
64528,T001038,Total male and female,GM1695,Noord-Beveland,2018JJ00,2018,7314,85,49,6.7,81,11.1,-32,493,67.4,52,441,467,63.9,43,-7,424,26,-6,-0.8,7308
64529,T001038,Total male and female,GM1695,Noord-Beveland,2019JJ00,2019,7308,85,44,6,83,11.3,-39,587,79.9,89,498,464,63.1,31,-9,433,123,84,11.5,7392
64530,T001038,Total male and female,GM1695,Noord-Beveland,2020JJ00,2020,7392,86,39,5.2,86,11.5,-47,678,90.6,73,605,441,58.9,54,-19,387,237,189,25.6,7581
64531,T001038,Total male and female,GM1695,Noord-Beveland,2021JJ00,2021,7581,88,63,8.3,120,15.7,-57,578,75.8,72,506,429,56.3,43,-11,386,149,87,11.5,7668
64532,T001038,Total male and female,GM1695,Noord-Beveland,2022JJ00,2022,7668,89,50,6.4,93,12,-43,682,87.9,185,497,449,57.8,81,-14,368,233,189,24.6,7857
64533,T001038,Total male and female,GM1695,Noord-Beveland,2023JJ00,2023,7857,91,48,6.1,98,12.4,-50,557,70.5,93,464,423,53.5,67,-8,356,134,86,10.9,7943
64850,T001038,Total male and female,GM1699,Noordenveld,2012JJ00,2012,30955,154,208,6.7,283,9.1,-75,1358,43.8,75,1283,1215,39.2,19,22,1196,143,69,2.2,31024
64851,T001038,Total male and female,GM1699,Noordenveld,2013JJ00,2013,31024,154,225,7.2,294,9.5,-69,1370,44.1,75,1295,1242,40,38,34,1204,128,63,2,31087
64852,T001038,Total male and female,GM1699,Noordenveld,2014JJ00,2014,31087,155,221,7.1,294,9.4,-73,1498,48.1,84,1414,1375,44.2,22,39,1353,123,50,1.6,31137
64853,T001038,Total male and female,GM1699,Noordenveld,2015JJ00,2015,31137,155,231,7.4,320,10.3,-89,1586,51,92,1494,1597,51.4,73,-3,1524,-11,-98,-3.1,31039
64854,T001038,Total male and female,GM1699,Noordenveld,2016JJ00,2016,31039,155,237,7.4,284,8.9,-47,10405,325.1,8835,1570,8421,263.1,55,7,8366,1984,1942,62.6,32981
64855,T001038,Total male and female,GM1699,Noordenveld,2017JJ00,2017,32981,165,259,7.9,291,8.9,-32,18731,573.2,17188,1543,19293,590.4,67,1,19226,-562,-611,-18.5,32370
64856,T001038,Total male and female,GM1699,Noordenveld,2018JJ00,2018,32370,162,238,7.5,331,10.4,-93,1658,52.1,99,1559,2630,82.6,61,-4,2569,-972,-1080,-33.4,31290
64857,T001038,Total male and female,GM1699,Noordenveld,2019JJ00,2019,31290,157,212,6.8,318,10.2,-106,1583,50.6,83,1500,1518,48.5,44,28,1474,65,-37,-1.2,31253
64858,T001038,Total male and female,GM1699,Noordenveld,2020JJ00,2020,31253,157,255,8.2,369,11.8,-114,1588,50.8,94,1494,1511,48.4,23,31,1488,77,-39,-1.2,31214
64859,T001038,Total male and female,GM1699,Noordenveld,2021JJ00,2021,31214,157,238,7.6,388,12.4,-150,1674,53.6,49,1625,1495,47.9,18,33,1477,179,24,0.8,31238
64860,T001038,Total male and female,GM1699,Noordenveld,2022JJ00,2022,31238,157,236,7.5,329,10.5,-93,1915,61,323,1592,1466,46.7,81,16,1385,449,353,11.3,31591
64861,T001038,Total male and female,GM1699,Noordenveld,2023JJ00,2023,31591,159,229,7.2,385,12.2,-156,1762,55.7,172,1590,1510,47.7,109,-11,1401,252,95,3,31686
65178,T001038,Total male and female,GM0171,Noordoostpolder,2012JJ00,2012,46342,101,556,12,338,7.3,218,1781,38.5,587,1194,2067,44.6,349,-196,1718,-286,-58,-1.3,46284
65179,T001038,Total male and female,GM0171,Noordoostpolder,2013JJ00,2013,46284,101,541,11.7,351,7.6,190,1968,42.5,823,1145,2089,45.1,221,-53,1868,-121,72,1.6,46356
65180,T001038,Total male and female,GM0171,Noordoostpolder,2014JJ00,2014,46356,101,557,12,344,7.4,213,2477,53.4,1226,1251,2572,55.4,236,-84,2336,-95,123,2.7,46479
65181,T001038,Total male and female,GM0171,Noordoostpolder,2015JJ00,2015,46479,101,546,11.8,359,7.7,187,3174,68.3,1791,1383,3402,73.2,315,-86,3087,-228,-40,-0.9,46439
65182,T001038,Total male and female,GM0171,Noordoostpolder,2016JJ00,2016,46439,101,547,11.8,364,7.8,183,3126,67.2,1141,1985,3221,69.3,255,-84,2966,-95,105,2.3,46544
65183,T001038,Total male and female,GM0171,Noordoostpolder,2017JJ00,2017,46544,101,507,10.9,347,7.4,160,2489,53.4,494,1995,2565,55.1,308,-143,2257,-76,81,1.7,46625
65184,T001038,Total male and female,GM0171,Noordoostpolder,2018JJ00,2018,46625,101,595,12.7,353,7.6,242,2376,50.8,548,1828,2385,51,328,-136,2057,-9,237,5.1,46862
65185,T001038,Total male and female,GM0171,Noordoostpolder,2019JJ00,2019,46849,102,556,11.8,355,7.5,201,2510,53.3,631,1879,2274,48.3,324,-126,1950,236,442,9.4,47291
65186,T001038,Total male and female,GM0171,Noordoostpolder,2020JJ00,2020,47291,103,516,10.9,393,8.3,123,2484,52.4,434,2050,2315,48.8,259,-83,2056,169,292,6.2,47583
65187,T001038,Total male and female,GM0171,Noordoostpolder,2021JJ00,2021,47583,104,576,12,433,9.1,143,2966,62,383,2583,2644,55.3,382,-195,2262,322,465,9.8,48048
65188,T001038,Total male and female,GM0171,Noordoostpolder,2022JJ00,2022,48048,105,568,11.6,409,8.4,159,4497,92,2145,2352,2976,60.9,902,-128,2074,1521,1681,35,49729
65189,T001038,Total male and female,GM0171,Noordoostpolder,2023JJ00,2023,49729,109,542,10.9,419,8.4,123,3633,72.8,1240,2393,3449,69.1,1307,-149,2142,184,306,6.2,50035
65342,T001038,Total male and female,GM0575,Noordwijk,2012JJ00,2012,25517,719,227,8.9,238,9.3,-11,1383,54,319,1064,1220,47.7,197,-27,1023,163,154,6,25671
65343,T001038,Total male and female,GM0575,Noordwijk,2013JJ00,2013,25671,723,212,8.3,246,9.6,-34,1332,51.9,284,1048,1283,50,208,-37,1075,49,20,0.8,25691
65344,T001038,Total male and female,GM0575,Noordwijk,2014JJ00,2014,25691,724,208,8.1,238,9.3,-30,1312,51.2,300,1012,1367,53.3,207,-34,1160,-55,-87,-3.4,25604
65345,T001038,Total male and female,GM0575,Noordwijk,2015JJ00,2015,25604,721,205,8,253,9.9,-48,1570,61.1,301,1269,1367,53.2,210,-22,1157,203,156,6.1,25760
65346,T001038,Total male and female,GM0575,Noordwijk,2016JJ00,2016,25760,720,214,8.3,204,7.9,10,1542,59.7,304,1238,1447,56.1,183,-32,1264,95,107,4.2,25867
65347,T001038,Total male and female,GM0575,Noordwijk,2017JJ00,2017,25867,723,228,8.8,263,10.1,-35,1642,63.2,282,1360,1417,54.6,167,-21,1250,225,189,7.3,26056
65348,T001038,Total male and female,GM0575,Noordwijk,2018JJ00,2018,26056,728,217,8.3,282,10.8,-65,1585,60.7,347,1238,1407,53.9,192,-6,1215,178,118,4.5,26174
65349,T001038,Total male and female,GM0575,Noordwijk,2019JJ00,2019,42859,734,347,8,385,8.9,-38,2631,60.9,676,1955,1940,44.9,360,-36,1580,691,649,15.1,43508
65350,T001038,Total male and female,GM0575,Noordwijk,2020JJ00,2020,43508,745,381,8.7,415,9.5,-34,2653,60.6,462,2191,2064,47.1,404,-114,1660,589,554,12.7,44062
65351,T001038,Total male and female,GM0575,Noordwijk,2021JJ00,2021,44062,755,400,9,447,10.1,-47,2373,53.7,474,1899,2019,45.7,307,-29,1712,354,303,6.9,44365
65352,T001038,Total male and female,GM0575,Noordwijk,2022JJ00,2022,44365,760,386,8.6,425,9.5,-39,3019,67.4,1067,1952,2165,48.4,451,-70,1714,854,814,18.3,45179
65353,T001038,Total male and female,GM0575,Noordwijk,2023JJ00,2023,45179,774,371,8.2,441,9.7,-70,2818,62,771,2047,2193,48.2,463,-54,1730,625,555,12.3,45734
65424,T001038,Total male and female,GM0576,Noordwijkerhout,2012JJ00,2012,15648,692,129,8.2,135,8.6,-6,789,50.3,120,669,689,43.9,94,-3,595,100,92,5.9,15740
65425,T001038,Total male and female,GM0576,Noordwijkerhout,2013JJ00,2013,15740,697,134,8.5,130,8.2,4,936,59.1,154,782,717,45.2,96,-22,621,219,216,13.7,15956
65426,T001038,Total male and female,GM0576,Noordwijkerhout,2014JJ00,2014,15956,706,155,9.7,137,8.6,18,818,51.1,169,649,731,45.7,116,-19,615,87,107,6.7,16063
65427,T001038,Total male and female,GM0576,Noordwijkerhout,2015JJ00,2015,16063,711,144,8.9,121,7.5,23,885,55,144,741,834,51.8,83,-8,751,51,77,4.8,16140
65428,T001038,Total male and female,GM0576,Noordwijkerhout,2016JJ00,2016,16140,714,136,8.4,128,7.9,8,1084,66.8,335,749,908,55.9,163,-9,745,176,178,11,16318
65429,T001038,Total male and female,GM0576,Noordwijkerhout,2017JJ00,2017,16318,722,154,9.4,144,8.7,10,1425,86.6,506,919,1147,69.7,363,-19,784,278,287,17.6,16605
65430,T001038,Total male and female,GM0576,Noordwijkerhout,2018JJ00,2018,16605,735,168,10.1,140,8.4,28,1113,66.9,370,743,1060,63.7,337,-7,723,53,80,4.8,16685
65670,T001038,Total male and female,GM0820,"Nuenen, Gerwen en Nederwetten",2012JJ00,2012,22548,669,158,7,161,7.1,-3,874,38.7,85,789,773,34.2,76,1,697,101,97,4.3,22645
65671,T001038,Total male and female,GM0820,"Nuenen, Gerwen en Nederwetten",2013JJ00,2013,22645,672,150,6.6,179,7.9,-29,889,39.3,116,773,885,39.1,99,4,786,4,-25,-1.1,22620
65672,T001038,Total male and female,GM0820,"Nuenen, Gerwen en Nederwetten",2014JJ00,2014,22620,671,181,8,164,7.3,17,892,39.4,84,808,908,40.1,66,-7,842,-16,0,0,22620
65673,T001038,Total male and female,GM0820,"Nuenen, Gerwen en Nederwetten",2015JJ00,2015,22620,671,173,7.6,217,9.6,-44,1066,47,98,968,878,38.7,81,2,797,188,143,6.3,22763
65674,T001038,Total male and female,GM0820,"Nuenen, Gerwen en Nederwetten",2016JJ00,2016,22763,675,219,9.6,180,7.9,39,1114,48.8,103,1011,1052,46.1,61,4,991,62,103,4.5,22866
65675,T001038,Total male and female,GM0820,"Nuenen, Gerwen en Nederwetten",2017JJ00,2017,22866,678,182,7.9,194,8.5,-12,1243,54.2,115,1128,1080,47.1,87,2,993,163,153,6.7,23019
65676,T001038,Total male and female,GM0820,"Nuenen, Gerwen en Nederwetten",2018JJ00,2018,23019,683,200,8.7,228,9.9,-28,1265,54.8,138,1127,1069,46.3,73,0,996,196,167,7.3,23186
65677,T001038,Total male and female,GM0820,"Nuenen, Gerwen en Nederwetten",2019JJ00,2019,23186,688,206,8.8,189,8.1,17,1175,50.5,126,1049,995,42.7,89,-5,906,180,197,8.5,23383
65678,T001038,Total male and female,GM0820,"Nuenen, Gerwen en Nederwetten",2020JJ00,2020,23383,694,222,9.4,211,9,11,1361,57.8,94,1267,1051,44.6,48,-4,1003,310,319,13.6,23702
65679,T001038,Total male and female,GM0820,"Nuenen, Gerwen en Nederwetten",2021JJ00,2021,23702,703,201,8.5,210,8.8,-9,1229,51.7,127,1102,1096,46.1,62,-5,1034,133,124,5.2,23826
65680,T001038,Total male and female,GM0820,"Nuenen, Gerwen en Nederwetten",2022JJ00,2022,23826,708,210,8.8,240,10,-30,1312,54.8,209,1103,1093,45.7,128,-11,965,219,189,7.9,24015
65681,T001038,Total male and female,GM0820,"Nuenen, Gerwen en Nederwetten",2023JJ00,2023,24015,714,215,8.9,230,9.5,-15,1299,53.8,209,1090,1068,44.3,118,-3,950,231,216,9,24231
65998,T001038,Total male and female,GM0302,Nunspeet,2012JJ00,2012,26609,207,307,11.5,236,8.9,71,823,30.9,72,751,877,32.9,62,-8,815,-54,19,0.7,26628
65999,T001038,Total male and female,GM0302,Nunspeet,2013JJ00,2013,26628,207,305,11.4,207,7.8,98,821,30.8,86,735,863,32.4,71,-18,792,-42,52,2,26680
66000,T001038,Total male and female,GM0302,Nunspeet,2014JJ00,2014,26680,207,326,12.2,225,8.4,101,893,33.4,111,782,931,34.9,44,8,887,-38,64,2.4,26744
66001,T001038,Total male and female,GM0302,Nunspeet,2015JJ00,2015,26744,208,310,11.6,247,9.2,63,1018,38,129,889,991,37,79,-12,912,27,91,3.4,26835
66002,T001038,Total male and female,GM0302,Nunspeet,2016JJ00,2016,26835,208,271,10.1,256,9.5,15,1110,41.3,88,1022,1067,39.7,65,-4,1002,43,57,2.1,26892
66003,T001038,Total male and female,GM0302,Nunspeet,2017JJ00,2017,26892,209,342,12.7,258,9.6,84,1202,44.5,53,1149,1064,39.4,45,-7,1019,138,222,8.3,27114
66004,T001038,Total male and female,GM0302,Nunspeet,2018JJ00,2018,27114,211,315,11.5,256,9.4,59,1309,48,91,1218,1001,36.7,103,-27,898,308,367,13.5,27481
66005,T001038,Total male and female,GM0302,Nunspeet,2019JJ00,2019,27481,213,329,11.9,246,8.9,83,1262,45.6,126,1136,980,35.4,67,-1,913,282,370,13.5,27851
66006,T001038,Total male and female,GM0302,Nunspeet,2020JJ00,2020,27851,216,334,12,345,12.3,-11,1268,45.4,95,1173,1084,38.8,48,1,1036,184,170,6.1,28021
66007,T001038,Total male and female,GM0302,Nunspeet,2021JJ00,2021,28021,218,368,13.1,278,9.9,90,1135,40.4,58,1077,1023,36.4,62,-17,961,112,202,7.2,28223
66008,T001038,Total male and female,GM0302,Nunspeet,2022JJ00,2022,28223,219,321,11.3,301,10.6,20,1438,50.5,320,1118,949,33.3,114,-1,835,489,508,18,28731
66009,T001038,Total male and female,GM0302,Nunspeet,2023JJ00,2023,28731,223,330,11.4,283,9.8,47,1320,45.7,131,1189,1024,35.4,134,-27,890,296,341,11.9,29072
66080,T001038,Total male and female,GM0951,Nuth,2012JJ00,2012,15644,473,127,8.2,147,9.4,-20,632,40.6,62,570,763,49,79,-7,684,-131,-150,-9.6,15494
66081,T001038,Total male and female,GM0951,Nuth,2013JJ00,2013,15494,468,109,7,138,8.9,-29,731,47,63,668,613,39.5,43,1,570,118,89,5.7,15583
66082,T001038,Total male and female,GM0951,Nuth,2014JJ00,2014,15583,471,119,7.7,150,9.7,-31,677,43.6,78,599,734,47.2,81,-16,653,-57,-88,-5.6,15495
66083,T001038,Total male and female,GM0951,Nuth,2015JJ00,2015,15495,468,112,7.2,145,9.4,-33,668,43.2,75,593,705,45.6,72,-6,633,-37,-70,-4.5,15425
66084,T001038,Total male and female,GM0951,Nuth,2016JJ00,2016,15425,466,84,5.5,177,11.5,-93,773,50.3,77,696,799,52,78,-17,721,-26,-120,-7.8,15305
66085,T001038,Total male and female,GM0951,Nuth,2017JJ00,2017,15305,462,109,7.1,167,10.9,-58,788,51.7,72,716,825,54.1,58,5,767,-37,-104,-6.8,15201
66086,T001038,Total male and female,GM0951,Nuth,2018JJ00,2018,15201,459,102,6.7,163,10.7,-61,807,53.1,59,748,754,49.6,65,-12,689,53,-14,-0.9,15187
66572,T001038,Total male and female,GM0579,Oegstgeest,2012JJ00,2012,22788,3122,224,9.8,222,9.7,2,1814,79,393,1421,1452,63.2,257,-27,1195,362,365,16,23153
66573,T001038,Total male and female,GM0579,Oegstgeest,2013JJ00,2013,23153,3172,184,8,204,8.9,-20,1588,68.9,388,1200,1809,78.5,317,-53,1492,-221,-243,-10.5,22910
66574,T001038,Total male and female,GM0579,Oegstgeest,2014JJ00,2014,22910,3138,225,9.8,220,9.6,5,1721,75,260,1461,1639,71.4,262,-60,1377,82,87,3.8,22997
66575,T001038,Total male and female,GM0579,Oegstgeest,2015JJ00,2015,22997,3150,217,9.4,224,9.7,-7,1828,79.1,294,1534,1609,69.6,224,-22,1385,219,212,9.2,23209
66576,T001038,Total male and female,GM0579,Oegstgeest,2016JJ00,2016,23209,3179,212,9.1,224,9.6,-12,2113,90.3,290,1823,1703,72.8,230,-11,1473,410,399,17.2,23608
66577,T001038,Total male and female,GM0579,Oegstgeest,2017JJ00,2017,23608,3234,222,9.3,231,9.7,-9,1908,80.3,315,1593,1619,68.2,197,-5,1422,289,279,11.8,23887
66578,T001038,Total male and female,GM0579,Oegstgeest,2018JJ00,2018,23887,3268,245,10.1,242,10,3,2102,87,288,1814,1566,64.8,197,-1,1369,536,539,22.6,24426
66579,T001038,Total male and female,GM0579,Oegstgeest,2019JJ00,2019,24426,3341,248,10.1,205,8.3,43,2014,81.8,324,1690,1641,66.6,216,6,1425,373,414,16.9,24840
66580,T001038,Total male and female,GM0579,Oegstgeest,2020JJ00,2020,24840,3398,232,9.3,266,10.7,-34,2024,81.1,276,1748,1763,70.7,198,-10,1565,261,224,9,25064
66581,T001038,Total male and female,GM0579,Oegstgeest,2021JJ00,2021,25064,3429,227,9,210,8.3,17,2080,82.3,290,1790,1662,65.7,203,-4,1459,418,435,17.4,25499
66582,T001038,Total male and female,GM0579,Oegstgeest,2022JJ00,2022,25499,3498,210,8.2,234,9.1,-24,2274,88.8,545,1729,2005,78.3,296,-6,1709,269,247,9.7,25746
66583,T001038,Total male and female,GM0579,Oegstgeest,2023JJ00,2023,25746,3532,243,9.4,218,8.4,25,2298,88.9,374,1924,2120,82,247,-12,1873,178,202,7.8,25948
66818,T001038,Total male and female,GM0823,Oirschot,2012JJ00,2012,17861,175,149,8.3,153,8.6,-4,519,29,66,453,450,25.1,45,3,405,69,65,3.6,17926
66819,T001038,Total male and female,GM0823,Oirschot,2013JJ00,2013,17926,176,145,8.1,171,9.5,-26,555,30.9,69,486,476,26.5,53,-1,423,79,54,3,17980
66820,T001038,Total male and female,GM0823,Oirschot,2014JJ00,2014,17980,177,151,8.4,168,9.3,-17,635,35.2,73,562,515,28.6,58,-11,457,120,99,5.5,18079
66821,T001038,Total male and female,GM0823,Oirschot,2015JJ00,2015,18079,178,150,8.3,158,8.7,-8,712,39.3,66,646,583,32.1,54,-6,529,129,120,6.6,18199
66822,T001038,Total male and female,GM0823,Oirschot,2016JJ00,2016,18199,179,166,9,163,8.9,3,1080,58.9,141,939,782,42.6,32,-9,750,298,300,16.5,18499
66823,T001038,Total male and female,GM0823,Oirschot,2017JJ00,2017,18499,182,135,7.3,169,9.1,-34,837,45.2,83,754,743,40.1,61,0,682,94,59,3.2,18558
66824,T001038,Total male and female,GM0823,Oirschot,2018JJ00,2018,18558,182,161,8.7,179,9.6,-18,778,41.8,99,679,693,37.3,69,-4,624,85,65,3.5,18623
66825,T001038,Total male and female,GM0823,Oirschot,2019JJ00,2019,18623,183,151,8.1,187,10,-36,812,43.5,112,700,684,36.6,75,-5,609,128,91,4.9,18714
66826,T001038,Total male and female,GM0823,Oirschot,2020JJ00,2020,18714,184,146,7.8,225,12,-79,955,50.9,126,829,745,39.7,68,-10,677,210,128,6.8,18842
66827,T001038,Total male and female,GM0823,Oirschot,2021JJ00,2021,18842,185,170,9,178,9.4,-8,891,47,104,787,664,35,65,0,599,227,219,11.6,19061
66828,T001038,Total male and female,GM0823,Oirschot,2022JJ00,2022,19061,187,176,9.2,210,11,-34,974,50.9,193,781,784,41,67,-15,717,190,156,8.2,19217
66829,T001038,Total male and female,GM0823,Oirschot,2023JJ00,2023,19217,189,173,9,217,11.3,-44,1143,59.4,161,982,1037,53.9,157,-29,880,106,63,3.3,19280
66900,T001038,Total male and female,GM0824,Oisterwijk,2012JJ00,2012,25775,403,199,7.7,244,9.5,-45,1225,47.5,224,1001,1188,46.1,90,-22,1098,37,-5,-0.2,25770
66901,T001038,Total male and female,GM0824,Oisterwijk,2013JJ00,2013,25770,403,202,7.8,229,8.9,-27,1182,45.8,252,930,1124,43.6,103,-42,1021,58,32,1.2,25802
66902,T001038,Total male and female,GM0824,Oisterwijk,2014JJ00,2014,25802,404,191,7.4,258,10,-67,1372,53.2,371,1001,1376,53.4,99,-23,1277,-4,-70,-2.7,25732
66903,T001038,Total male and female,GM0824,Oisterwijk,2015JJ00,2015,25732,403,203,7.9,295,11.4,-92,1645,63.8,544,1101,1459,56.6,109,-28,1350,186,103,4,25835
66904,T001038,Total male and female,GM0824,Oisterwijk,2016JJ00,2016,25835,405,210,8.1,267,10.3,-57,1865,72,458,1407,1708,66,116,-33,1592,157,101,3.9,25936
66905,T001038,Total male and female,GM0824,Oisterwijk,2017JJ00,2017,25936,406,212,8.1,277,10.6,-65,1960,75.3,192,1768,1698,65.2,113,-34,1585,262,196,7.6,26132
66906,T001038,Total male and female,GM0824,Oisterwijk,2018JJ00,2018,26132,409,192,7.3,285,10.9,-93,1760,67.3,190,1570,1659,63.5,142,-31,1517,101,8,0.3,26140
66907,T001038,Total male and female,GM0824,Oisterwijk,2019JJ00,2019,26140,409,200,7.6,293,11.2,-93,1679,64.1,200,1479,1483,56.6,169,-69,1314,196,105,4,26245
66908,T001038,Total male and female,GM0824,Oisterwijk,2020JJ00,2020,26245,411,206,7.8,284,10.8,-78,1795,68,148,1647,1413,53.5,76,-16,1337,382,304,11.6,26549
66909,T001038,Total male and female,GM0824,Oisterwijk,2021JJ00,2021,32373,404,348,10.7,387,11.9,-39,2051,63.2,195,1856,1881,58,163,-26,1718,170,130,4,32503
66910,T001038,Total male and female,GM0824,Oisterwijk,2022JJ00,2022,32503,406,287,8.8,360,11,-73,2540,77.6,562,1978,2028,62,174,1,1854,512,438,13.5,32941
66911,T001038,Total male and female,GM0824,Oisterwijk,2023JJ00,2023,32941,411,301,9.1,385,11.7,-84,2607,79.1,417,2190,2512,76.2,285,-43,2227,95,11,0.3,32952
66982,T001038,Total male and female,GM1895,Oldambt,2012JJ00,2012,39095,172,320,8.2,448,11.5,-128,1300,33.4,126,1174,1513,38.9,181,-56,1332,-213,-347,-8.9,38748
66983,T001038,Total male and female,GM1895,Oldambt,2013JJ00,2013,38748,171,344,8.9,456,11.8,-112,1460,37.8,135,1325,1535,39.7,157,-30,1378,-75,-188,-4.9,38560
66984,T001038,Total male and female,GM1895,Oldambt,2014JJ00,2014,38560,170,300,7.8,459,11.9,-159,1440,37.4,175,1265,1417,36.8,116,-20,1301,23,-140,-3.6,38420
66985,T001038,Total male and female,GM1895,Oldambt,2015JJ00,2015,38420,169,273,7.1,447,11.7,-174,1498,39.1,137,1361,1515,39.5,123,-18,1392,-17,-192,-5,38228
66986,T001038,Total male and female,GM1895,Oldambt,2016JJ00,2016,38228,169,320,8.4,488,12.8,-168,1839,48.2,264,1575,1788,46.8,132,-13,1656,51,-120,-3.1,38108
66987,T001038,Total male and female,GM1895,Oldambt,2017JJ00,2017,38108,168,278,7.3,456,12,-178,1626,42.7,147,1479,1481,38.9,85,6,1396,145,-33,-0.9,38075
66988,T001038,Total male and female,GM1895,Oldambt,2018JJ00,2018,38075,168,272,7.1,527,13.8,-255,1756,46.1,169,1587,1448,38,85,8,1363,308,54,1.4,38129
66989,T001038,Total male and female,GM1895,Oldambt,2019JJ00,2019,38129,168,308,8.1,456,11.9,-148,1808,47.4,156,1652,1576,41.3,90,7,1486,232,80,2.1,38209
66990,T001038,Total male and female,GM1895,Oldambt,2020JJ00,2020,38209,169,291,7.6,495,12.9,-204,1845,48.2,143,1702,1570,41.1,93,-11,1477,275,68,1.8,38277
66991,T001038,Total male and female,GM1895,Oldambt,2021JJ00,2021,38277,169,299,7.8,564,14.7,-265,2046,53.3,180,1866,1536,40,81,27,1455,510,244,6.4,38521
66992,T001038,Total male and female,GM1895,Oldambt,2022JJ00,2022,38521,170,316,8.1,535,13.8,-219,2399,61.9,429,1970,1650,42.5,205,-35,1445,749,523,13.6,39044
66993,T001038,Total male and female,GM1895,Oldambt,2023JJ00,2023,39044,172,305,7.8,538,13.7,-233,2361,60.2,334,2027,1762,44.9,179,-50,1583,599,361,9.2,39405
67064,T001038,Total male and female,GM0269,Oldebroek,2012JJ00,2012,22716,233,240,10.6,151,6.6,89,777,34.2,52,725,808,35.5,61,-17,747,-31,58,2.6,22774
67065,T001038,Total male and female,GM0269,Oldebroek,2013JJ00,2013,22774,233,242,10.6,146,6.4,96,715,31.4,52,663,752,33,36,-3,716,-37,61,2.7,22835
67066,T001038,Total male and female,GM0269,Oldebroek,2014JJ00,2014,22835,234,252,11,151,6.6,101,886,38.7,127,759,821,35.8,46,2,775,65,166,7.3,23001
67067,T001038,Total male and female,GM0269,Oldebroek,2015JJ00,2015,23001,236,241,10.5,158,6.9,83,934,40.5,120,814,914,39.6,87,-31,827,20,103,4.5,23104
67068,T001038,Total male and female,GM0269,Oldebroek,2016JJ00,2016,23104,237,245,10.6,186,8,59,1000,43.1,122,878,906,39.1,87,-41,819,94,152,6.6,23256
67069,T001038,Total male and female,GM0269,Oldebroek,2017JJ00,2017,23256,238,283,12.1,188,8,95,1082,46.3,117,965,928,39.7,119,-25,809,154,248,10.7,23504
67070,T001038,Total male and female,GM0269,Oldebroek,2018JJ00,2018,23504,241,250,10.6,196,8.3,54,1142,48.5,156,986,1103,46.8,150,-15,953,39,94,4,23598
67071,T001038,Total male and female,GM0269,Oldebroek,2019JJ00,2019,23598,242,284,12,173,7.3,111,989,41.9,123,866,1050,44.5,95,-12,955,-61,48,2,23646
67072,T001038,Total male and female,GM0269,Oldebroek,2020JJ00,2020,23646,242,239,10.1,244,10.3,-5,1099,46.4,117,982,977,41.2,67,-8,910,122,114,4.8,23760
67073,T001038,Total male and female,GM0269,Oldebroek,2021JJ00,2021,23760,243,263,11,200,8.4,63,1097,46,92,1005,990,41.5,83,-13,907,107,170,7.2,23930
67074,T001038,Total male and female,GM0269,Oldebroek,2022JJ00,2022,23930,245,256,10.6,205,8.5,51,1352,56.1,460,892,1069,44.4,162,-46,907,283,334,14,24264
67075,T001038,Total male and female,GM0269,Oldebroek,2023JJ00,2023,24264,248,210,8.7,187,7.7,23,1030,42.4,128,902,1036,42.7,116,-16,920,-6,17,0.7,24281
67392,T001038,Total male and female,GM0173,Oldenzaal,2012JJ00,2012,32176,1493,352,10.9,292,9.1,60,946,29.4,120,826,981,30.5,101,-2,880,-35,24,0.7,32200
67393,T001038,Total male and female,GM0173,Oldenzaal,2013JJ00,2013,32200,1494,295,9.2,299,9.3,-4,914,28.4,128,786,975,30.3,111,1,864,-61,-63,-2,32137
67394,T001038,Total male and female,GM0173,Oldenzaal,2014JJ00,2014,32137,1491,301,9.4,279,8.7,22,993,30.9,107,886,1033,32.2,139,-9,894,-40,-17,-0.5,32120
67395,T001038,Total male and female,GM0173,Oldenzaal,2015JJ00,2015,32120,1490,304,9.5,313,9.7,-9,985,30.7,127,858,985,30.7,139,-12,846,0,-10,-0.3,32110
67396,T001038,Total male and female,GM0173,Oldenzaal,2016JJ00,2016,32110,1490,278,8.7,313,9.8,-35,969,30.2,116,853,1035,32.3,120,-15,915,-66,-104,-3.2,32006
67397,T001038,Total male and female,GM0173,Oldenzaal,2017JJ00,2017,32006,1485,264,8.3,342,10.7,-78,1084,33.9,123,961,1099,34.4,108,-2,991,-15,-91,-2.8,31915
67398,T001038,Total male and female,GM0173,Oldenzaal,2018JJ00,2018,31915,1481,254,8,294,9.2,-40,1044,32.8,121,923,1077,33.8,111,-10,966,-33,-75,-2.3,31840
67399,T001038,Total male and female,GM0173,Oldenzaal,2019JJ00,2019,31840,1477,261,8.2,347,10.9,-86,1163,36.5,137,1026,1080,33.9,97,-9,983,83,-4,-0.1,31836
67400,T001038,Total male and female,GM0173,Oldenzaal,2020JJ00,2020,31836,1477,224,7.1,350,11,-126,1006,31.7,109,897,1015,31.9,71,3,944,-9,-135,-4.2,31701
67401,T001038,Total male and female,GM0173,Oldenzaal,2021JJ00,2021,31701,1471,278,8.8,386,12.2,-108,1081,34.1,98,983,935,29.5,100,-2,835,146,40,1.3,31741
67402,T001038,Total male and female,GM0173,Oldenzaal,2022JJ00,2022,31741,1473,266,8.4,364,11.4,-98,1229,38.6,281,948,945,29.7,121,-20,824,284,184,5.8,31925
67403,T001038,Total male and female,GM0173,Oldenzaal,2023JJ00,2023,31925,1481,240,7.5,374,11.7,-134,1081,33.9,127,954,1079,33.9,127,-12,952,2,-131,-4.1,31794
67556,T001038,Total male and female,GM1773,Olst-Wijhe,2012JJ00,2012,17659,155,157,8.9,131,7.4,26,711,40.2,54,657,646,36.5,39,-7,607,65,92,5.2,17751
67557,T001038,Total male and female,GM1773,Olst-Wijhe,2013JJ00,2013,17751,156,149,8.4,154,8.7,-5,652,36.7,47,605,628,35.4,25,3,603,24,19,1.1,17770
67558,T001038,Total male and female,GM1773,Olst-Wijhe,2014JJ00,2014,17770,156,140,7.9,162,9.1,-22,709,39.8,46,663,618,34.7,35,-7,583,91,69,3.9,17839
67559,T001038,Total male and female,GM1773,Olst-Wijhe,2015JJ00,2015,17839,156,159,8.9,184,10.3,-25,735,41.1,46,689,663,37.1,26,2,637,72,47,2.6,17886
67560,T001038,Total male and female,GM1773,Olst-Wijhe,2016JJ00,2016,17886,157,160,8.9,174,9.7,-14,822,45.9,31,791,737,41.1,39,4,698,85,71,4,17957
67561,T001038,Total male and female,GM1773,Olst-Wijhe,2017JJ00,2017,17957,158,138,7.7,186,10.3,-48,972,54,64,908,857,47.6,62,-3,795,115,66,3.7,18023
67562,T001038,Total male and female,GM1773,Olst-Wijhe,2018JJ00,2018,18023,158,163,9,169,9.4,-6,852,47.2,43,809,798,44.2,46,0,752,54,48,2.7,18071
67563,T001038,Total male and female,GM1773,Olst-Wijhe,2019JJ00,2019,18071,159,162,8.9,174,9.6,-12,954,52.5,57,897,761,41.9,48,-3,713,193,181,10,18252
67564,T001038,Total male and female,GM1773,Olst-Wijhe,2020JJ00,2020,18252,160,172,9.4,199,10.9,-27,925,50.5,51,874,789,43.1,37,-5,752,136,109,6,18361
67565,T001038,Total male and female,GM1773,Olst-Wijhe,2021JJ00,2021,18361,161,157,8.5,208,11.3,-51,903,49,43,860,718,39,42,-2,676,185,135,7.4,18496
67566,T001038,Total male and female,GM1773,Olst-Wijhe,2022JJ00,2022,18496,163,166,8.9,197,10.6,-31,928,49.9,100,828,711,38.2,60,0,651,217,186,10.1,18682
67567,T001038,Total male and female,GM1773,Olst-Wijhe,2023JJ00,2023,18682,164,154,8.2,227,12.1,-73,957,51,137,820,733,39.1,90,-21,643,224,153,8.2,18835
67638,T001038,Total male and female,GM0175,Ommen,2012JJ00,2012,17380,97,182,10.5,155,8.9,27,753,43.4,140,613,845,48.7,69,-3,776,-92,-66,-3.8,17314
67639,T001038,Total male and female,GM0175,Ommen,2013JJ00,2013,17314,96,178,10.3,111,6.4,67,704,40.6,136,568,726,41.9,46,11,680,-22,47,2.7,17361
67640,T001038,Total male and female,GM0175,Ommen,2014JJ00,2014,17361,96,196,11.3,168,9.7,28,790,45.5,167,623,850,49,100,-17,750,-60,-20,-1.2,17341
67641,T001038,Total male and female,GM0175,Ommen,2015JJ00,2015,17341,96,173,9.9,161,9.2,12,1497,85.5,654,843,1159,66.2,92,-10,1067,338,355,20.5,17696
67642,T001038,Total male and female,GM0175,Ommen,2016JJ00,2016,17696,98,181,10.3,173,9.8,8,990,56.2,209,781,1162,66,93,-2,1069,-172,-165,-9.3,17531
67643,T001038,Total male and female,GM0175,Ommen,2017JJ00,2017,17531,97,152,8.6,179,10.2,-27,1034,58.8,158,876,909,51.7,121,-37,788,125,99,5.6,17630
67644,T001038,Total male and female,GM0175,Ommen,2018JJ00,2018,17630,98,164,9.3,160,9,4,1098,62,150,948,920,51.9,115,-32,805,178,183,10.4,17813
67645,T001038,Total male and female,GM0175,Ommen,2019JJ00,2019,17813,99,171,9.5,139,7.8,32,1009,56.3,189,820,843,47.1,103,-17,740,166,196,11,18009
67646,T001038,Total male and female,GM0175,Ommen,2020JJ00,2020,18009,100,166,9.1,181,10,-15,1158,63.8,263,895,856,47.2,78,-19,778,302,286,15.9,18295
67647,T001038,Total male and female,GM0175,Ommen,2021JJ00,2021,18295,102,171,9.3,175,9.5,-4,958,52.1,149,809,791,43,165,-53,626,167,162,8.9,18457
67648,T001038,Total male and female,GM0175,Ommen,2022JJ00,2022,18457,103,166,8.9,201,10.7,-35,1386,74.1,472,914,852,45.5,143,-26,709,534,498,27,18955
67649,T001038,Total male and female,GM0175,Ommen,2023JJ00,2023,18955,105,160,8.4,212,11.2,-52,1094,57.6,249,845,967,50.9,147,-26,820,127,76,4,19031
67720,T001038,Total male and female,GM0881,Onderbanken,2012JJ00,2012,7966,376,51,6.4,68,8.6,-17,355,44.7,41,314,401,50.5,41,0,360,-46,-61,-7.7,7905
67721,T001038,Total male and female,GM0881,Onderbanken,2013JJ00,2013,7905,374,48,6.1,71,9,-23,356,45.1,49,307,358,45.4,42,7,316,-2,-24,-3,7881
67722,T001038,Total male and female,GM0881,Onderbanken,2014JJ00,2014,7881,372,63,8,61,7.7,2,370,47,44,326,385,48.9,29,4,356,-15,-15,-1.9,7866
67723,T001038,Total male and female,GM0881,Onderbanken,2015JJ00,2015,7866,372,48,6.1,86,10.9,-38,383,48.7,30,353,342,43.5,21,1,321,41,3,0.4,7869
67724,T001038,Total male and female,GM0881,Onderbanken,2016JJ00,2016,7869,372,58,7.4,68,8.6,-10,412,52.4,33,379,406,51.6,60,-5,346,6,-4,-0.5,7865
67725,T001038,Total male and female,GM0881,Onderbanken,2017JJ00,2017,7865,372,51,6.5,88,11.2,-37,462,58.8,44,418,431,54.8,37,-6,394,31,-8,-1,7857
67726,T001038,Total male and female,GM0881,Onderbanken,2018JJ00,2018,7857,372,46,5.9,79,10.1,-33,473,60.5,45,428,523,66.9,35,-12,488,-50,-75,-9.5,7782
67966,T001038,Total male and female,GM1586,Oost Gelre,2012JJ00,2012,30005,274,258,8.6,267,8.9,-9,937,31.3,59,878,1059,35.4,48,-10,1011,-122,-132,-4.4,29873
67967,T001038,Total male and female,GM1586,Oost Gelre,2013JJ00,2013,29873,272,272,9.1,283,9.5,-11,895,30,57,838,1060,35.6,89,1,971,-165,-173,-5.8,29700
67968,T001038,Total male and female,GM1586,Oost Gelre,2014JJ00,2014,29700,271,231,7.8,289,9.8,-58,950,32.1,54,896,1059,35.8,85,-13,974,-109,-167,-5.6,29533
67969,T001038,Total male and female,GM1586,Oost Gelre,2015JJ00,2015,29533,269,255,8.6,291,9.9,-36,1025,34.7,80,945,986,33.4,46,2,940,39,4,0.1,29537
67970,T001038,Total male and female,GM1586,Oost Gelre,2016JJ00,2016,29537,269,254,8.6,297,10,-43,1145,38.7,91,1054,1006,34,55,-9,951,139,97,3.3,29634
67971,T001038,Total male and female,GM1586,Oost Gelre,2017JJ00,2017,29634,270,274,9.2,297,10,-23,1193,40.2,76,1117,1130,38.1,55,-4,1075,63,38,1.3,29672
67972,T001038,Total male and female,GM1586,Oost Gelre,2018JJ00,2018,29672,270,262,8.8,268,9,-6,1141,38.4,79,1062,1106,37.3,57,-4,1049,35,32,1.1,29704
67973,T001038,Total male and female,GM1586,Oost Gelre,2019JJ00,2019,29704,270,253,8.5,294,9.9,-41,1051,35.4,76,975,1087,36.6,53,-8,1034,-36,-77,-2.6,29627
67974,T001038,Total male and female,GM1586,Oost Gelre,2020JJ00,2020,29627,270,282,9.5,316,10.7,-34,1017,34.4,59,958,1036,35,58,-18,978,-19,-53,-1.8,29574
67975,T001038,Total male and female,GM1586,Oost Gelre,2021JJ00,2021,29574,269,276,9.3,320,10.8,-44,1038,35.1,76,962,964,32.6,45,-5,919,74,29,1,29603
67976,T001038,Total male and female,GM1586,Oost Gelre,2022JJ00,2022,29603,269,252,8.5,307,10.3,-55,1248,42,240,1008,949,31.9,100,-6,849,299,243,8.2,29846
67977,T001038,Total male and female,GM1586,Oost Gelre,2023JJ00,2023,29846,272,302,10.1,333,11.1,-31,1230,41.1,134,1096,1075,35.9,72,-15,1003,155,123,4.1,29969
68540,T001038,Total male and female,GM0826,Oosterhout,2012JJ00,2012,54006,756,445,8.3,482,9,-37,1749,32.5,238,1511,2035,37.8,231,-31,1804,-286,-320,-5.9,53686
68541,T001038,Total male and female,GM0826,Oosterhout,2013JJ00,2013,53686,751,459,8.5,435,8.1,24,2048,38.1,259,1789,2043,38,273,-43,1770,5,31,0.6,53717
68542,T001038,Total male and female,GM0826,Oosterhout,2014JJ00,2014,53717,751,483,9,486,9,-3,2105,39.2,247,1858,2023,37.6,275,-75,1748,82,76,1.4,53793
68543,T001038,Total male and female,GM0826,Oosterhout,2015JJ00,2015,53793,753,476,8.8,490,9.1,-14,2394,44.4,288,2106,2155,40,246,-44,1909,239,225,4.2,54018
68544,T001038,Total male and female,GM0826,Oosterhout,2016JJ00,2016,54018,756,477,8.8,484,8.9,-7,2851,52.5,309,2542,2259,41.6,261,-64,1998,592,586,10.8,54604
68545,T001038,Total male and female,GM0826,Oosterhout,2017JJ00,2017,54604,764,529,9.6,538,9.8,-9,2923,53.3,297,2626,2368,43.2,254,-53,2114,555,543,9.9,55147
68546,T001038,Total male and female,GM0826,Oosterhout,2018JJ00,2018,55147,772,516,9.3,531,9.6,-15,2883,52.1,379,2504,2397,43.3,262,-63,2135,486,469,8.5,55616
68547,T001038,Total male and female,GM0826,Oosterhout,2019JJ00,2019,55616,778,493,8.8,500,9,-7,2689,48.2,423,2266,2314,41.5,263,-66,2051,375,366,6.6,55982
68548,T001038,Total male and female,GM0826,Oosterhout,2020JJ00,2020,55982,783,546,9.7,582,10.4,-36,2654,47.3,364,2290,2394,42.7,260,-58,2134,260,224,4,56206
68549,T001038,Total male and female,GM0826,Oosterhout,2021JJ00,2021,56206,786,548,9.7,577,10.2,-29,2648,47,395,2253,2290,40.6,225,-41,2065,358,329,5.9,56535
68550,T001038,Total male and female,GM0826,Oosterhout,2022JJ00,2022,56535,791,514,9,631,11.1,-117,3240,56.9,755,2485,2234,39.2,384,-48,1850,1006,890,15.7,57425
68551,T001038,Total male and female,GM0826,Oosterhout,2023JJ00,2023,57425,804,538,9.3,547,9.5,-9,2847,49.4,409,2438,2335,40.5,383,-87,1952,512,499,8.7,57924
68704,T001038,Total male and female,GM0580,Oostflakkee,2012JJ00,2012,10407,139,80,7.7,76,7.3,4,264,25.5,40,224,337,32.5,15,4,322,-73,-73,-7,10334
68950,T001038,Total male and female,GM0085,Ooststellingwerf,2012JJ00,2012,25858,115,215,8.3,262,10.1,-47,921,35.6,63,858,900,34.8,59,-14,841,21,-22,-0.9,25836
68951,T001038,Total male and female,GM0085,Ooststellingwerf,2013JJ00,2013,25836,115,232,9,274,10.6,-42,887,34.4,57,830,1007,39.1,67,-7,940,-120,-164,-6.3,25672
68952,T001038,Total male and female,GM0085,Ooststellingwerf,2014JJ00,2014,25672,115,226,8.8,277,10.8,-51,1078,42,58,1020,1080,42.1,68,-9,1012,-2,-55,-2.1,25617
68953,T001038,Total male and female,GM0085,Ooststellingwerf,2015JJ00,2015,25617,114,213,8.3,325,12.7,-112,1055,41.2,61,994,990,38.7,63,9,927,65,-46,-1.8,25571
68954,T001038,Total male and female,GM0085,Ooststellingwerf,2016JJ00,2016,25571,114,207,8.1,309,12.1,-102,1245,48.7,65,1180,1173,45.9,77,-6,1096,72,-31,-1.2,25540
68955,T001038,Total male and female,GM0085,Ooststellingwerf,2017JJ00,2017,25540,114,212,8.3,324,12.7,-112,1244,48.8,71,1173,1213,47.6,55,-3,1158,31,-81,-3.2,25459
68956,T001038,Total male and female,GM0085,Ooststellingwerf,2018JJ00,2018,25459,114,186,7.3,296,11.6,-110,1247,48.9,76,1171,1098,43.1,59,-4,1039,149,38,1.5,25497
68957,T001038,Total male and female,GM0085,Ooststellingwerf,2019JJ00,2019,25497,114,210,8.2,280,11,-70,1133,44.5,70,1063,1091,42.8,54,-5,1037,42,-28,-1.1,25469
68958,T001038,Total male and female,GM0085,Ooststellingwerf,2020JJ00,2020,25469,114,188,7.4,276,10.8,-88,1225,48.1,81,1144,1143,44.9,40,-2,1103,82,-5,-0.2,25464
68959,T001038,Total male and female,GM0085,Ooststellingwerf,2021JJ00,2021,25464,114,204,8,313,12.2,-109,1333,52.1,71,1262,1007,39.4,44,-3,963,326,216,8.5,25680
68960,T001038,Total male and female,GM0085,Ooststellingwerf,2022JJ00,2022,25680,115,200,7.8,353,13.7,-153,1380,53.6,253,1127,1067,41.4,125,-38,942,313,157,6.1,25837
68961,T001038,Total male and female,GM0085,Ooststellingwerf,2023JJ00,2023,25837,116,188,7.3,339,13.1,-151,1281,49.6,192,1089,1143,44.3,132,-42,1011,138,-13,-0.5,25824
69114,T001038,Total male and female,GM0431,Oostzaan,2012JJ00,2012,9097,789,65,7.1,58,6.4,7,323,35.4,25,298,286,31.4,14,10,272,37,44,4.8,9141
69115,T001038,Total male and female,GM0431,Oostzaan,2013JJ00,2013,9141,792,65,7.1,60,6.6,5,255,27.9,25,230,262,28.7,26,-4,236,-7,-2,-0.2,9139
69116,T001038,Total male and female,GM0431,Oostzaan,2014JJ00,2014,9139,792,72,7.9,64,7,8,377,41.1,25,352,337,36.8,32,-8,305,40,48,5.3,9187
69117,T001038,Total male and female,GM0431,Oostzaan,2015JJ00,2015,9187,796,70,7.5,70,7.5,0,588,62.9,26,562,270,28.9,34,-10,236,318,317,34.5,9504
69118,T001038,Total male and female,GM0431,Oostzaan,2016JJ00,2016,9504,824,101,10.5,63,6.6,38,495,51.7,28,467,383,40,26,-2,357,112,148,15.6,9652
69119,T001038,Total male and female,GM0431,Oostzaan,2017JJ00,2017,9652,837,88,9.1,81,8.4,7,456,47,29,427,381,39.3,30,4,351,75,83,8.6,9735
69120,T001038,Total male and female,GM0431,Oostzaan,2018JJ00,2018,9735,844,94,9.6,75,7.7,19,437,44.8,35,402,434,44.5,21,-1,413,3,22,2.3,9757
69121,T001038,Total male and female,GM0431,Oostzaan,2019JJ00,2019,9757,846,90,9.2,76,7.8,14,406,41.7,28,378,441,45.2,18,1,423,-35,-22,-2.3,9735
69122,T001038,Total male and female,GM0431,Oostzaan,2020JJ00,2020,9735,844,78,8,91,9.4,-13,416,42.8,37,379,449,46.2,26,0,423,-33,-46,-4.7,9689
69123,T001038,Total male and female,GM0431,Oostzaan,2021JJ00,2021,9689,840,83,8.6,93,9.6,-10,388,40.1,31,357,426,44.1,34,-11,392,-38,-50,-5.2,9639
69124,T001038,Total male and female,GM0431,Oostzaan,2022JJ00,2022,9639,834,90,9.3,89,9.2,1,477,49.3,79,398,401,41.4,44,-10,357,76,81,8.4,9720
69125,T001038,Total male and female,GM0431,Oostzaan,2023JJ00,2023,9720,841,72,7.4,100,10.3,-28,498,51.3,107,391,497,51.2,44,1,453,1,-26,-2.7,9694
69524,T001038,Total male and female,GM0432,Opmeer,2012JJ00,2012,11393,274,99,8.7,81,7.1,18,348,30.6,46,302,380,33.4,20,10,360,-32,-14,-1.2,11379
69525,T001038,Total male and female,GM0432,Opmeer,2013JJ00,2013,11379,274,90,7.9,88,7.7,2,384,33.8,47,337,397,34.9,32,-1,365,-13,-11,-1,11368
69526,T001038,Total male and female,GM0432,Opmeer,2014JJ00,2014,11368,274,95,8.4,92,8.1,3,356,31.4,38,318,426,37.6,36,-9,390,-70,-67,-5.9,11301
69527,T001038,Total male and female,GM0432,Opmeer,2015JJ00,2015,11301,272,88,7.8,96,8.5,-8,494,43.6,61,433,453,40,24,-5,429,41,35,3.1,11336
69528,T001038,Total male and female,GM0432,Opmeer,2016JJ00,2016,11336,273,108,9.5,89,7.8,19,487,42.8,38,449,422,37.1,36,-8,386,65,84,7.4,11420
69529,T001038,Total male and female,GM0432,Opmeer,2017JJ00,2017,11420,275,111,9.7,112,9.8,-1,571,49.8,81,490,464,40.4,42,-5,422,107,106,9.3,11526
69530,T001038,Total male and female,GM0432,Opmeer,2018JJ00,2018,11526,278,105,9,91,7.8,14,739,63.4,194,545,495,42.5,50,-11,445,244,253,22,11779
69531,T001038,Total male and female,GM0432,Opmeer,2019JJ00,2019,11779,284,104,8.8,90,7.6,14,630,53.4,181,449,587,49.7,122,-39,465,43,57,4.8,11836
69532,T001038,Total male and female,GM0432,Opmeer,2020JJ00,2020,11836,285,115,9.6,97,8.1,18,722,60.6,133,589,568,47.6,119,-27,449,154,173,14.6,12009
69533,T001038,Total male and female,GM0432,Opmeer,2021JJ00,2021,12009,289,111,9.2,95,7.9,16,664,55.1,109,555,614,51,123,-37,491,50,65,5.4,12074
69534,T001038,Total male and female,GM0432,Opmeer,2022JJ00,2022,12074,291,140,11.5,127,10.5,13,745,61.4,229,516,652,53.8,165,-22,487,93,106,8.8,12180
69535,T001038,Total male and female,GM0432,Opmeer,2023JJ00,2023,12180,294,127,10.4,110,9,17,697,57.2,206,491,695,57,204,-13,491,2,19,1.6,12199
69688,T001038,Total male and female,GM0086,Opsterland,2012JJ00,2012,29952,133,278,9.3,264,8.8,14,1140,38.1,69,1071,1208,40.4,77,-24,1131,-68,-56,-1.9,29896
69689,T001038,Total male and female,GM0086,Opsterland,2013JJ00,2013,29896,133,242,8.1,258,8.6,-16,1203,40.3,84,1119,1220,40.8,68,-23,1152,-17,-33,-1.1,29863
69690,T001038,Total male and female,GM0086,Opsterland,2014JJ00,2014,29863,133,273,9.1,253,8.5,20,1217,40.8,78,1139,1241,41.6,54,-13,1187,-24,-4,-0.1,29859
69691,T001038,Total male and female,GM0086,Opsterland,2015JJ00,2015,29859,133,268,9,265,8.9,3,1280,42.9,82,1198,1309,43.9,82,-16,1227,-29,-29,-1,29830
69692,T001038,Total male and female,GM0086,Opsterland,2016JJ00,2016,29830,133,232,7.8,263,8.8,-31,1390,46.7,81,1309,1470,49.4,82,-24,1388,-80,-112,-3.8,29718
69693,T001038,Total male and female,GM0086,Opsterland,2017JJ00,2017,29718,132,242,8.1,268,9,-26,1552,52.2,82,1470,1490,50.1,84,-22,1406,62,35,1.2,29753
69694,T001038,Total male and female,GM0086,Opsterland,2018JJ00,2018,29753,133,255,8.6,275,9.2,-20,1491,50.1,67,1424,1501,50.5,80,-7,1421,-10,-30,-1,29723
69695,T001038,Total male and female,GM0086,Opsterland,2019JJ00,2019,29723,132,274,9.2,274,9.2,0,1490,50.1,93,1397,1479,49.8,60,-6,1419,11,10,0.3,29733
69696,T001038,Total male and female,GM0086,Opsterland,2020JJ00,2020,29733,133,258,8.7,290,9.7,-32,1478,49.6,80,1398,1364,45.8,41,-4,1323,114,79,2.7,29812
69697,T001038,Total male and female,GM0086,Opsterland,2021JJ00,2021,29812,133,282,9.5,297,10,-15,1400,47,69,1331,1408,47.2,84,-10,1324,-8,-21,-0.7,29791
69698,T001038,Total male and female,GM0086,Opsterland,2022JJ00,2022,29791,133,277,9.3,300,10,-23,1589,53.1,264,1325,1303,43.5,120,-24,1183,286,263,8.8,30054
69699,T001038,Total male and female,GM0086,Opsterland,2023JJ00,2023,30054,134,240,8,286,9.5,-46,1351,44.9,89,1262,1296,43.1,79,-15,1217,55,5,0.2,30059
69770,T001038,Total male and female,GM0828,Oss,2012JJ00,2012,84639,555,837,9.9,643,7.6,194,2610,30.8,533,2077,2582,30.5,411,-59,2171,28,222,2.6,84861
69771,T001038,Total male and female,GM0828,Oss,2013JJ00,2013,84861,557,772,9.1,665,7.8,107,2622,30.9,546,2076,2632,31,479,-76,2153,-10,93,1.1,84954
69772,T001038,Total male and female,GM0828,Oss,2014JJ00,2014,84954,558,841,9.9,622,7.3,219,2841,33.4,591,2250,2847,33.5,464,-86,2383,-6,216,2.5,85170
69773,T001038,Total male and female,GM0828,Oss,2015JJ00,2015,89799,550,909,10.1,746,8.3,163,3009,33.5,558,2451,2969,33,484,-138,2485,40,204,2.3,90003
69774,T001038,Total male and female,GM0828,Oss,2016JJ00,2016,90003,552,836,9.3,779,8.6,57,3537,39.2,895,2642,3216,35.7,445,-66,2771,321,373,4.1,90376
69775,T001038,Total male and female,GM0828,Oss,2017JJ00,2017,90376,554,904,10,705,7.8,199,3607,39.8,762,2845,3233,35.7,459,-124,2774,374,575,6.4,90951
69776,T001038,Total male and female,GM0828,Oss,2018JJ00,2018,90951,557,874,9.6,781,8.6,93,3548,38.9,827,2721,3138,34.4,458,-131,2680,410,500,5.5,91451
69777,T001038,Total male and female,GM0828,Oss,2019JJ00,2019,91451,560,878,9.6,758,8.3,120,3792,41.4,1093,2699,3442,37.5,536,-152,2906,350,464,5.1,91915
69778,T001038,Total male and female,GM0828,Oss,2020JJ00,2020,91915,563,840,9.1,924,10,-84,3934,42.7,986,2948,3236,35.1,459,-82,2777,698,611,6.6,92526
69779,T001038,Total male and female,GM0828,Oss,2021JJ00,2021,92526,567,894,9.6,876,9.4,18,4257,45.8,1072,3185,3487,37.5,655,-124,2832,770,781,8.4,93307
69780,T001038,Total male and female,GM0828,Oss,2022JJ00,2022,93307,576,847,9,854,9.1,-7,4418,47.1,1411,3007,3272,34.9,597,-100,2675,1146,1130,12.1,94437
69781,T001038,Total male and female,GM0828,Oss,2023JJ00,2023,94437,583,836,8.8,847,9,-11,4171,44.1,1101,3070,3959,41.9,870,-289,3089,212,197,2.1,94634
70344,T001038,Total male and female,GM0584,Oud-Beijerland,2012JJ00,2012,23415,1249,225,9.6,176,7.5,49,804,34.3,53,751,827,35.3,62,-8,765,-23,26,1.1,23441
70345,T001038,Total male and female,GM0584,Oud-Beijerland,2013JJ00,2013,23441,1252,240,10.2,180,7.6,60,950,40.3,73,877,737,31.3,38,7,699,213,274,11.7,23715
70346,T001038,Total male and female,GM0584,Oud-Beijerland,2014JJ00,2014,23715,1266,224,9.4,186,7.8,38,792,33.4,59,733,843,35.6,67,3,776,-51,-13,-0.5,23702
70347,T001038,Total male and female,GM0584,Oud-Beijerland,2015JJ00,2015,23702,1265,236,9.9,201,8.5,35,1022,43,65,957,909,38.2,68,-15,841,113,149,6.3,23851
70348,T001038,Total male and female,GM0584,Oud-Beijerland,2016JJ00,2016,23851,1273,209,8.7,201,8.4,8,1096,45.8,71,1025,940,39.3,57,-5,883,156,164,6.9,24015
70349,T001038,Total male and female,GM0584,Oud-Beijerland,2017JJ00,2017,24015,1282,234,9.7,186,7.7,48,1160,48,92,1068,922,38.2,43,-2,879,238,286,11.9,24301
70350,T001038,Total male and female,GM0584,Oud-Beijerland,2018JJ00,2018,24301,1297,200,8.2,209,8.6,-9,993,40.8,77,916,930,38.2,54,-9,876,63,102,4.2,24403
70508,T001038,Total male and female,GM1509,Oude IJsselstreek,2012JJ00,2012,39839,292,327,8.2,439,11,-112,1321,33.2,104,1217,1271,31.9,119,-12,1152,50,-60,-1.5,39779
70509,T001038,Total male and female,GM1509,Oude IJsselstreek,2013JJ00,2013,39779,292,329,8.3,451,11.4,-122,1271,32,112,1159,1333,33.6,123,-12,1210,-62,-184,-4.6,39595
70510,T001038,Total male and female,GM1509,Oude IJsselstreek,2014JJ00,2014,39595,290,343,8.7,414,10.5,-71,1321,33.4,129,1192,1286,32.5,121,-1,1165,35,-37,-0.9,39558
70511,T001038,Total male and female,GM1509,Oude IJsselstreek,2015JJ00,2015,39558,290,297,7.5,421,10.6,-124,1519,38.4,146,1373,1296,32.7,153,-40,1143,223,99,2.5,39657
70512,T001038,Total male and female,GM1509,Oude IJsselstreek,2016JJ00,2016,39657,291,300,7.6,450,11.4,-150,1451,36.6,164,1287,1389,35.1,128,-9,1261,62,-89,-2.2,39568
70513,T001038,Total male and female,GM1509,Oude IJsselstreek,2017JJ00,2017,39568,290,288,7.3,430,10.9,-142,1636,41.4,132,1504,1538,38.9,142,-12,1396,98,-48,-1.2,39520
70514,T001038,Total male and female,GM1509,Oude IJsselstreek,2018JJ00,2018,39520,290,287,7.3,492,12.5,-205,1590,40.3,178,1412,1433,36.3,133,-20,1300,157,-47,-1.2,39473
70515,T001038,Total male and female,GM1509,Oude IJsselstreek,2019JJ00,2019,39473,290,295,7.5,468,11.9,-173,1552,39.4,159,1393,1465,37.2,110,-25,1355,87,-85,-2.2,39388
70516,T001038,Total male and female,GM1509,Oude IJsselstreek,2020JJ00,2020,39388,289,317,8.1,524,13.3,-207,1552,39.4,151,1401,1391,35.3,121,-12,1270,161,-42,-1.1,39346
70517,T001038,Total male and female,GM1509,Oude IJsselstreek,2021JJ00,2021,39346,289,283,7.2,509,12.9,-226,1593,40.5,125,1468,1326,33.7,111,-4,1215,267,41,1,39387
70518,T001038,Total male and female,GM1509,Oude IJsselstreek,2022JJ00,2022,39387,289,296,7.5,527,13.3,-231,1748,44.3,323,1425,1294,32.8,156,-28,1138,454,226,5.7,39613
70519,T001038,Total male and female,GM1509,Oude IJsselstreek,2023JJ00,2023,39613,291,281,7.1,501,12.7,-220,1641,41.5,269,1372,1631,41.3,181,-27,1450,10,-211,-5.3,39402
71164,T001038,Total male and female,GM0437,Ouder-Amstel,2012JJ00,2012,13232,548,108,8.2,137,10.3,-29,682,51.5,81,601,635,48,93,-11,542,47,17,1.3,13249
71165,T001038,Total male and female,GM0437,Ouder-Amstel,2013JJ00,2013,13249,549,132,10,124,9.4,8,715,53.9,103,612,699,52.7,100,-15,599,16,22,1.7,13271
71166,T001038,Total male and female,GM0437,Ouder-Amstel,2014JJ00,2014,13271,550,110,8.3,139,10.5,-29,804,60.5,94,710,755,56.9,89,-4,666,49,18,1.4,13289
71167,T001038,Total male and female,GM0437,Ouder-Amstel,2015JJ00,2015,13289,551,122,9.1,127,9.5,-5,929,69.6,124,805,802,60.1,121,-12,681,127,122,9.2,13411
71168,T001038,Total male and female,GM0437,Ouder-Amstel,2016JJ00,2016,13411,557,120,8.9,120,8.9,0,914,68.1,126,788,904,67.4,114,-15,790,10,8,0.6,13419
71169,T001038,Total male and female,GM0437,Ouder-Amstel,2017JJ00,2017,13419,557,100,7.4,90,6.7,10,934,69.4,132,802,869,64.6,110,-7,759,65,77,5.7,13496
71170,T001038,Total male and female,GM0437,Ouder-Amstel,2018JJ00,2018,13496,560,120,8.8,113,8.2,7,1255,91.6,146,1109,839,61.2,111,-8,728,416,420,31.1,13916
71171,T001038,Total male and female,GM0437,Ouder-Amstel,2019JJ00,2019,13916,578,147,10.5,97,6.9,50,998,71.4,155,843,938,67.1,137,0,801,60,110,7.9,14026
71172,T001038,Total male and female,GM0437,Ouder-Amstel,2020JJ00,2020,14026,582,130,9.2,92,6.5,38,1101,78.2,150,951,1040,73.9,116,-5,924,61,99,7.1,14125
71173,T001038,Total male and female,GM0437,Ouder-Amstel,2021JJ00,2021,14125,587,159,11.2,121,8.5,38,1113,78.6,124,989,1063,75,119,-9,944,50,87,6.2,14212
71174,T001038,Total male and female,GM0437,Ouder-Amstel,2022JJ00,2022,14212,593,124,8.7,145,10.2,-21,1124,78.9,286,838,1039,72.9,164,-3,875,85,64,4.5,14276
71175,T001038,Total male and female,GM0437,Ouder-Amstel,2023JJ00,2023,14276,596,111,7.7,138,9.6,-27,1401,97.6,322,1079,1201,83.6,160,-16,1041,200,171,12,14447
71246,T001038,Total male and female,GM0644,Ouderkerk,2012JJ00,2012,8049,297,92,11.4,50,6.2,42,381,47,19,362,326,40.3,20,-2,306,55,98,12.2,8147
71247,T001038,Total male and female,GM0644,Ouderkerk,2013JJ00,2013,8147,301,92,11.2,46,5.6,46,293,35.8,18,275,275,33.6,11,0,264,18,64,7.9,8211
71248,T001038,Total male and female,GM0644,Ouderkerk,2014JJ00,2014,8211,303,80,9.7,59,7.2,21,318,38.7,16,302,302,36.7,14,2,288,16,30,3.7,8241
71492,T001038,Total male and female,GM0589,Oudewater,2012JJ00,2012,9850,252,109,11.1,98,9.9,11,319,32.3,31,288,310,31.4,41,-13,269,9,22,2.2,9872
71493,T001038,Total male and female,GM0589,Oudewater,2013JJ00,2013,9872,253,94,9.5,92,9.3,2,265,26.8,27,238,266,26.9,25,-8,241,-1,1,0.1,9873
71494,T001038,Total male and female,GM0589,Oudewater,2014JJ00,2014,9873,253,91,9.2,71,7.2,20,349,35.3,45,304,318,32.1,39,-4,279,31,51,5.2,9924
71495,T001038,Total male and female,GM0589,Oudewater,2015JJ00,2015,9924,254,97,9.7,109,10.9,-12,470,47.1,47,423,331,33.1,41,-3,290,139,125,12.6,10049
71496,T001038,Total male and female,GM0589,Oudewater,2016JJ00,2016,10049,257,120,11.9,94,9.3,26,485,47.9,53,432,372,36.8,31,-6,341,113,138,13.7,10187
71497,T001038,Total male and female,GM0589,Oudewater,2017JJ00,2017,10187,261,102,10,87,8.5,15,417,40.9,57,360,442,43.4,54,-18,388,-25,-7,-0.7,10180
71498,T001038,Total male and female,GM0589,Oudewater,2018JJ00,2018,10180,262,102,10,92,9,10,415,40.7,68,347,404,39.6,45,-2,359,11,21,2.1,10201
71499,T001038,Total male and female,GM0589,Oudewater,2019JJ00,2019,10201,262,118,11.6,82,8,36,341,33.4,52,289,348,34.1,42,-11,306,-7,29,2.8,10230
71500,T001038,Total male and female,GM0589,Oudewater,2020JJ00,2020,10230,263,83,8.2,86,8.4,-3,311,30.5,37,274,400,39.3,26,-7,374,-89,-92,-9,10138
71501,T001038,Total male and female,GM0589,Oudewater,2021JJ00,2021,10138,261,92,9.1,83,8.2,9,378,37.2,39,339,366,36.1,25,-6,341,12,21,2.1,10159
71502,T001038,Total male and female,GM0589,Oudewater,2022JJ00,2022,10159,261,87,8.5,87,8.5,0,456,44.7,124,332,384,37.7,31,1,353,72,73,7.2,10232
71503,T001038,Total male and female,GM0589,Oudewater,2023JJ00,2023,10232,263,92,9,121,11.8,-29,418,40.9,76,342,400,39.1,44,-8,356,18,-9,-0.9,10223
71902,T001038,Total male and female,GM1734,Overbetuwe,2012JJ00,2012,46269,423,491,10.6,300,6.5,191,2007,43.3,140,1867,1938,41.8,145,-15,1793,69,262,5.7,46531
71903,T001038,Total male and female,GM1734,Overbetuwe,2013JJ00,2013,46531,426,455,9.8,306,6.6,149,1896,40.7,146,1750,1919,41.2,168,-39,1751,-23,134,2.9,46665
71904,T001038,Total male and female,GM1734,Overbetuwe,2014JJ00,2014,46665,427,500,10.7,296,6.3,204,1907,40.8,127,1780,1945,41.6,148,-9,1797,-38,168,3.6,46833
71905,T001038,Total male and female,GM1734,Overbetuwe,2015JJ00,2015,46833,429,471,10,313,6.7,158,2172,46.3,153,2019,2165,46.1,156,1,2009,7,169,3.6,47002
71906,T001038,Total male and female,GM1734,Overbetuwe,2016JJ00,2016,47002,430,472,10,342,7.2,130,2493,52.8,154,2339,2234,47.3,123,10,2111,259,392,8.3,47394
71907,T001038,Total male and female,GM1734,Overbetuwe,2017JJ00,2017,47394,434,506,10.7,316,6.7,190,2411,50.8,162,2249,2513,53,140,-10,2373,-102,87,1.8,47481
71908,T001038,Total male and female,GM1734,Overbetuwe,2018JJ00,2018,47481,435,442,9.3,345,7.3,97,2269,47.8,190,2079,2310,48.6,146,-24,2164,-41,62,1.3,47543
71909,T001038,Total male and female,GM1734,Overbetuwe,2019JJ00,2019,47543,435,470,9.8,364,7.6,106,2491,52.2,231,2260,2233,46.8,140,-10,2093,258,363,7.6,47906
71910,T001038,Total male and female,GM1734,Overbetuwe,2020JJ00,2020,47906,439,468,9.7,404,8.4,64,2517,52.4,158,2359,2273,47.3,120,10,2153,244,308,6.4,48214
71911,T001038,Total male and female,GM1734,Overbetuwe,2021JJ00,2021,48214,442,461,9.6,386,8,75,2191,45.4,154,2037,2213,45.9,125,-6,2088,-22,52,1.1,48266
71912,T001038,Total male and female,GM1734,Overbetuwe,2022JJ00,2022,48266,443,463,9.5,387,8,76,2632,54.3,412,2220,2266,46.7,228,-13,2038,366,441,9.1,48707
71913,T001038,Total male and female,GM1734,Overbetuwe,2023JJ00,2023,48707,447,424,8.7,344,7,80,2327,47.7,225,2102,2194,44.9,174,-21,2020,133,212,4.4,48919
72312,T001038,Total male and female,GM0590,Papendrecht,2012JJ00,2012,32032,3379,347,10.8,251,7.8,96,1192,37.2,114,1078,1233,38.5,117,-21,1116,-41,50,1.6,32082
72313,T001038,Total male and female,GM0590,Papendrecht,2013JJ00,2013,32082,3413,306,9.5,220,6.9,86,1017,31.7,92,925,1076,33.5,111,-15,965,-59,35,1.1,32117
72314,T001038,Total male and female,GM0590,Papendrecht,2014JJ00,2014,32117,3417,350,10.9,235,7.3,115,1076,33.5,111,965,1121,34.9,101,-12,1020,-45,71,2.2,32188
72315,T001038,Total male and female,GM0590,Papendrecht,2015JJ00,2015,32188,3424,300,9.3,270,8.4,30,1209,37.5,117,1092,1180,36.6,82,10,1098,29,60,1.9,32248
72316,T001038,Total male and female,GM0590,Papendrecht,2016JJ00,2016,32248,3427,302,9.4,242,7.5,60,1257,39,104,1153,1272,39.4,133,-47,1139,-15,44,1.4,32292
72317,T001038,Total male and female,GM0590,Papendrecht,2017JJ00,2017,32292,3432,280,8.7,276,8.6,4,1444,44.7,99,1345,1476,45.7,97,-25,1379,-32,-28,-0.9,32264
72318,T001038,Total male and female,GM0590,Papendrecht,2018JJ00,2018,32264,3429,284,8.8,292,9,-8,1443,44.7,157,1286,1409,43.7,115,-44,1294,34,26,0.8,32290
72319,T001038,Total male and female,GM0590,Papendrecht,2019JJ00,2019,32290,3431,300,9.3,265,8.2,35,1309,40.6,141,1168,1497,46.5,128,-27,1369,-188,-154,-4.8,32136
72320,T001038,Total male and female,GM0590,Papendrecht,2020JJ00,2020,32136,3415,272,8.5,321,10,-49,1558,48.5,112,1446,1474,45.8,97,-13,1377,84,35,1.1,32171
72321,T001038,Total male and female,GM0590,Papendrecht,2021JJ00,2021,32171,3419,331,10.3,288,8.9,43,1510,46.9,114,1396,1516,47.1,92,-15,1424,-6,37,1.2,32208
72322,T001038,Total male and female,GM0590,Papendrecht,2022JJ00,2022,32208,3423,253,7.8,319,9.9,-66,1509,46.8,235,1274,1374,42.6,162,-12,1212,135,69,2.1,32277
72323,T001038,Total male and female,GM0590,Papendrecht,2023JJ00,2023,32277,3430,301,9.3,316,9.8,-15,1396,43.3,157,1239,1476,45.8,120,-19,1356,-80,-99,-3.1,32178
72394,T001038,Total male and female,GM1894,Peel en Maas,2012JJ00,2012,43271,271,394,9.1,305,7,89,1050,24.3,218,832,1110,25.6,141,-5,969,-60,31,0.7,43302
72395,T001038,Total male and female,GM1894,Peel en Maas,2013JJ00,2013,43302,272,337,7.8,345,8,-8,1188,27.4,322,866,1172,27.1,169,-23,1003,16,12,0.3,43314
72396,T001038,Total male and female,GM1894,Peel en Maas,2014JJ00,2014,43314,272,358,8.3,338,7.8,20,1447,33.4,407,1040,1331,30.7,203,-15,1128,116,134,3.1,43448
72397,T001038,Total male and female,GM1894,Peel en Maas,2015JJ00,2015,43448,273,340,7.8,350,8.1,-10,1410,32.5,411,999,1529,35.2,335,-35,1194,-119,-132,-3,43316
72398,T001038,Total male and female,GM1894,Peel en Maas,2016JJ00,2016,43316,272,386,8.9,365,8.4,21,1381,31.9,290,1091,1370,31.6,293,-52,1077,11,31,0.7,43347
72399,T001038,Total male and female,GM1894,Peel en Maas,2017JJ00,2017,43347,272,330,7.6,370,8.5,-40,1428,33,262,1166,1419,32.7,202,-29,1217,9,-35,-0.8,43312
72400,T001038,Total male and female,GM1894,Peel en Maas,2018JJ00,2018,43312,272,378,8.7,377,8.7,1,1363,31.5,276,1087,1365,31.5,235,-51,1130,-2,-1,0,43311
72401,T001038,Total male and female,GM1894,Peel en Maas,2019JJ00,2019,43311,272,347,8,402,9.3,-55,1539,35.5,361,1178,1370,31.6,200,-3,1170,169,114,2.6,43425
72402,T001038,Total male and female,GM1894,Peel en Maas,2020JJ00,2020,43425,272,362,8.3,505,11.6,-143,1949,44.8,640,1309,1570,36.1,456,-28,1114,379,235,5.4,43660
72403,T001038,Total male and female,GM1894,Peel en Maas,2021JJ00,2021,43660,274,418,9.5,406,9.2,12,2112,48,784,1328,1508,34.3,402,-67,1106,604,618,14.2,44278
72404,T001038,Total male and female,GM1894,Peel en Maas,2022JJ00,2022,44278,278,401,9,407,9.1,-6,2715,60.6,1437,1278,1710,38.2,600,-171,1110,1005,998,22.5,45276
72405,T001038,Total male and female,GM1894,Peel en Maas,2023JJ00,2023,45276,284,390,8.6,462,10.2,-72,2488,54.8,1208,1280,2159,47.5,718,-192,1441,329,258,5.7,45534
72558,T001038,Total male and female,GM0765,Pekela,2012JJ00,2012,12868,262,130,10.1,149,11.6,-19,659,51.3,112,547,707,55.1,34,-8,673,-48,-64,-5,12804
72559,T001038,Total male and female,GM0765,Pekela,2013JJ00,2013,12804,261,123,9.6,165,12.9,-42,730,57.2,278,452,790,61.9,35,-8,755,-60,-98,-7.7,12706
72560,T001038,Total male and female,GM0765,Pekela,2014JJ00,2014,12706,259,128,10.1,131,10.3,-3,914,72,360,554,944,74.4,32,-3,912,-30,-28,-2.2,12678
72561,T001038,Total male and female,GM0765,Pekela,2015JJ00,2015,12678,258,123,9.7,137,10.8,-14,1000,79,370,630,1026,81,44,-23,982,-26,-37,-2.9,12641
72562,T001038,Total male and female,GM0765,Pekela,2016JJ00,2016,12641,258,137,10.9,140,11.1,-3,975,77.5,246,729,1094,87,26,7,1068,-119,-124,-9.8,12517
72563,T001038,Total male and female,GM0765,Pekela,2017JJ00,2017,12517,255,113,9.1,132,10.7,-19,810,65.4,95,715,1063,85.9,147,-126,916,-253,-272,-21.7,12245
72564,T001038,Total male and female,GM0765,Pekela,2018JJ00,2018,12245,250,101,8.3,116,9.5,-15,595,48.7,28,567,612,50,12,2,600,-17,-31,-2.5,12214
72565,T001038,Total male and female,GM0765,Pekela,2019JJ00,2019,12214,249,105,8.6,117,9.6,-12,680,55.7,46,634,685,56.1,31,-3,654,-5,-18,-1.5,12196
72566,T001038,Total male and female,GM0765,Pekela,2020JJ00,2020,12196,249,106,8.7,111,9.1,-5,677,55.6,47,630,692,56.8,48,-10,644,-15,-20,-1.6,12176
72567,T001038,Total male and female,GM0765,Pekela,2021JJ00,2021,12176,248,109,8.9,170,14,-61,755,62,21,734,674,55.3,27,-6,647,81,20,1.6,12196
72568,T001038,Total male and female,GM0765,Pekela,2022JJ00,2022,12196,249,101,8.2,165,13.4,-64,988,80.3,329,659,716,58.2,50,-27,666,272,208,17.1,12404
72569,T001038,Total male and female,GM0765,Pekela,2023JJ00,2023,12404,253,105,8.4,153,12.3,-48,928,74.5,333,595,766,61.5,130,-35,636,162,113,9.1,12517
72968,T001038,Total male and female,GM1926,Pijnacker-Nootdorp,2012JJ00,2012,50103,1341,597,11.9,262,5.2,335,2162,43,247,1915,2145,42.7,249,-1,1896,17,351,7,50454
72969,T001038,Total male and female,GM1926,Pijnacker-Nootdorp,2013JJ00,2013,50454,1350,551,10.9,266,5.2,285,2462,48.5,212,2250,2131,42,274,-14,1857,331,617,12.2,51071
72970,T001038,Total male and female,GM1926,Pijnacker-Nootdorp,2014JJ00,2014,51071,1367,526,10.3,287,5.6,239,2312,45.2,219,2093,2425,47.4,252,-37,2173,-113,132,2.6,51203
72971,T001038,Total male and female,GM1926,Pijnacker-Nootdorp,2015JJ00,2015,51203,1371,522,10.1,277,5.4,245,2922,56.7,256,2666,2482,48.1,241,-5,2241,440,691,13.5,51894
72972,T001038,Total male and female,GM1926,Pijnacker-Nootdorp,2016JJ00,2016,51894,1391,526,10.1,319,6.1,207,3057,58.5,302,2755,2497,47.8,247,-22,2250,560,762,14.7,52656
72973,T001038,Total male and female,GM1926,Pijnacker-Nootdorp,2017JJ00,2017,52656,1411,530,10,294,5.5,236,3375,63.5,252,3123,2633,49.5,196,0,2437,742,978,18.6,53634
72974,T001038,Total male and female,GM1926,Pijnacker-Nootdorp,2018JJ00,2018,53634,1446,495,9.2,298,5.5,197,3041,56.3,278,2763,2541,47.1,261,-20,2280,500,697,13,54331
72975,T001038,Total male and female,GM1926,Pijnacker-Nootdorp,2019JJ00,2019,54331,1465,543,9.9,316,5.8,227,3231,58.9,326,2905,2476,45.2,219,5,2257,755,977,18,55308
72976,T001038,Total male and female,GM1926,Pijnacker-Nootdorp,2020JJ00,2020,55308,1492,541,9.7,323,5.8,218,2903,52.3,245,2658,2753,49.6,216,-32,2537,150,366,6.6,55674
72977,T001038,Total male and female,GM1926,Pijnacker-Nootdorp,2021JJ00,2021,55674,1501,596,10.6,370,6.6,226,3420,60.9,276,3144,2752,49,240,-5,2512,668,898,16.1,56572
72978,T001038,Total male and female,GM1926,Pijnacker-Nootdorp,2022JJ00,2022,56572,1534,506,8.9,344,6,162,3620,63.4,665,2955,2678,46.9,303,-7,2375,942,1100,19.4,57672
72979,T001038,Total male and female,GM1926,Pijnacker-Nootdorp,2023JJ00,2023,57672,1564,559,9.7,337,5.8,222,2867,49.6,437,2430,2830,49,382,-34,2448,37,260,4.5,57932
73542,T001038,Total male and female,GM0439,Purmerend,2012JJ00,2012,79266,3389,738,9.3,729,9.2,9,2739,34.5,397,2342,2534,31.9,372,-77,2162,205,216,2.7,79482
73543,T001038,Total male and female,GM0439,Purmerend,2013JJ00,2013,79482,3423,706,8.9,675,8.5,31,2646,33.3,377,2269,2584,32.5,361,-42,2223,62,94,1.2,79576
73544,T001038,Total male and female,GM0439,Purmerend,2014JJ00,2014,79576,3427,700,8.8,683,8.6,17,2758,34.7,365,2393,2742,34.5,404,-73,2338,16,35,0.4,79611
73545,T001038,Total male and female,GM0439,Purmerend,2015JJ00,2015,79611,3429,693,8.7,673,8.4,20,3135,39.3,394,2741,2875,36.1,416,-106,2459,260,278,3.5,79889
73546,T001038,Total male and female,GM0439,Purmerend,2016JJ00,2016,79889,3445,737,9.2,726,9.1,11,3167,39.6,426,2741,3131,39.2,347,-73,2784,36,39,0.5,79928
73547,T001038,Total male and female,GM0439,Purmerend,2017JJ00,2017,79928,3447,706,8.8,737,9.2,-31,3242,40.5,469,2773,3149,39.4,344,-66,2805,93,55,0.7,79983
73548,T001038,Total male and female,GM0439,Purmerend,2018JJ00,2018,79983,3455,704,8.8,774,9.7,-70,3424,42.8,520,2904,3221,40.2,403,-71,2818,203,134,1.7,80117
73549,T001038,Total male and female,GM0439,Purmerend,2019JJ00,2019,80117,3461,722,8.9,773,9.6,-51,4245,52.6,545,3700,3064,38,305,-28,2759,1181,1132,14.1,81249
73550,T001038,Total male and female,GM0439,Purmerend,2020JJ00,2020,81249,3510,761,9.3,803,9.9,-42,3811,46.8,458,3353,3334,40.9,342,-86,2992,477,434,5.3,81683
73551,T001038,Total male and female,GM0439,Purmerend,2021JJ00,2021,81683,3528,766,9.4,936,11.5,-170,3719,45.6,409,3310,3705,45.4,335,-48,3370,14,-146,-1.8,81537
73552,T001038,Total male and female,GM0439,Purmerend,2022JJ00,2022,92240,985,892,9.6,880,9.5,12,5165,55.5,1168,3997,3419,36.7,508,-53,2911,1746,1752,19,93992
73553,T001038,Total male and female,GM0439,Purmerend,2023JJ00,2023,93992,1004,844,8.9,842,8.9,2,4743,50.1,912,3831,3566,37.7,607,-121,2959,1177,1176,12.5,95168
73706,T001038,Total male and female,GM0273,Putten,2012JJ00,2012,23860,280,252,10.5,177,7.4,75,805,33.7,138,667,772,32.3,76,-4,696,33,111,4.7,23971
73707,T001038,Total male and female,GM0273,Putten,2013JJ00,2013,23971,281,259,10.8,182,7.6,77,782,32.7,123,659,954,39.9,131,-6,823,-172,-99,-4.1,23872
73708,T001038,Total male and female,GM0273,Putten,2014JJ00,2014,23872,280,254,10.5,148,6.1,106,1364,56.5,498,866,965,40,156,4,809,399,505,21.2,24377
73709,T001038,Total male and female,GM0273,Putten,2015JJ00,2015,24377,286,245,10,215,8.8,30,1233,50.4,316,917,1115,45.6,187,-56,928,118,139,5.7,24516
73710,T001038,Total male and female,GM0273,Putten,2016JJ00,2016,24516,288,276,11.3,219,8.9,57,1002,40.9,177,825,1146,46.8,261,-92,885,-144,-88,-3.6,24428
73711,T001038,Total male and female,GM0273,Putten,2017JJ00,2017,24428,287,231,9.5,227,9.3,4,978,40.1,159,819,1097,45,182,-46,915,-119,-115,-4.7,24313
73712,T001038,Total male and female,GM0273,Putten,2018JJ00,2018,24313,285,251,10.3,216,8.9,35,821,33.8,123,698,971,40,137,-40,834,-150,-115,-4.7,24198
73713,T001038,Total male and female,GM0273,Putten,2019JJ00,2019,24198,284,231,9.6,204,8.4,27,896,37.1,145,751,1014,42,122,-13,892,-118,-86,-3.6,24112
73714,T001038,Total male and female,GM0273,Putten,2020JJ00,2020,24112,283,254,10.5,225,9.3,29,1129,46.6,117,1012,906,37.4,98,-16,808,223,253,10.5,24365
73715,T001038,Total male and female,GM0273,Putten,2021JJ00,2021,24365,286,240,9.8,246,10,-6,1068,43.6,117,951,829,33.9,93,-21,736,239,233,9.6,24598
73716,T001038,Total male and female,GM0273,Putten,2022JJ00,2022,24598,289,256,10.3,286,11.6,-30,1116,45.1,245,871,781,31.6,108,-23,673,335,306,12.4,24904
73717,T001038,Total male and female,GM0273,Putten,2023JJ00,2023,24904,292,253,10.1,234,9.4,19,970,38.9,165,805,916,36.7,155,-29,761,54,74,3,24978
73870,T001038,Total male and female,GM0177,Raalte,2012JJ00,2012,36603,214,328,9,316,8.6,12,970,26.5,87,883,1098,30,78,-10,1020,-128,-117,-3.2,36486
73871,T001038,Total male and female,GM0177,Raalte,2013JJ00,2013,36486,213,326,8.9,323,8.8,3,1070,29.3,71,999,1039,28.5,96,-17,943,31,33,0.9,36519
73872,T001038,Total male and female,GM0177,Raalte,2014JJ00,2014,36519,213,358,9.8,313,8.6,45,1088,29.8,108,980,1049,28.7,70,-6,979,39,84,2.3,36603
73873,T001038,Total male and female,GM0177,Raalte,2015JJ00,2015,36603,214,301,8.2,288,7.9,13,1209,33,67,1142,1125,30.7,86,2,1039,84,97,2.7,36700
73874,T001038,Total male and female,GM0177,Raalte,2016JJ00,2016,36700,215,348,9.5,327,8.9,21,1313,35.7,91,1222,1126,30.6,65,2,1061,187,207,5.6,36907
73875,T001038,Total male and female,GM0177,Raalte,2017JJ00,2017,36907,216,357,9.6,344,9.3,13,1405,37.9,66,1339,1164,31.4,83,-10,1081,241,251,6.8,37158
73876,T001038,Total male and female,GM0177,Raalte,2018JJ00,2018,37158,217,344,9.2,389,10.4,-45,1528,40.9,123,1405,1131,30.3,71,-5,1060,397,353,9.5,37511
73877,T001038,Total male and female,GM0177,Raalte,2019JJ00,2019,37511,219,345,9.2,362,9.6,-17,1319,35.1,144,1175,1100,29.2,60,-13,1040,219,201,5.4,37712
73878,T001038,Total male and female,GM0177,Raalte,2020JJ00,2020,37712,221,352,9.3,395,10.4,-43,1416,37.4,109,1307,1175,31.1,55,-4,1120,241,199,5.3,37911
73879,T001038,Total male and female,GM0177,Raalte,2021JJ00,2021,37911,222,363,9.5,418,11,-55,1384,36.4,113,1271,1100,28.9,86,-7,1014,284,229,6,38140
73880,T001038,Total male and female,GM0177,Raalte,2022JJ00,2022,38140,223,341,8.9,379,9.9,-38,1449,37.8,329,1120,1048,27.3,105,-1,943,401,360,9.4,38500
73881,T001038,Total male and female,GM0177,Raalte,2023JJ00,2023,38500,225,303,7.9,396,10.3,-93,1251,32.6,187,1064,1293,33.6,155,-10,1138,-42,-136,-3.5,38364
74444,T001038,Total male and female,GM0703,Reimerswaal,2012JJ00,2012,21704,213,329,15.1,156,7.2,173,788,36.2,239,549,819,37.6,116,-48,703,-31,155,7.1,21859
74445,T001038,Total male and female,GM0703,Reimerswaal,2013JJ00,2013,21859,214,286,13.1,167,7.6,119,785,35.9,273,512,837,38.2,163,-49,674,-52,68,3.1,21927
74446,T001038,Total male and female,GM0703,Reimerswaal,2014JJ00,2014,21927,215,308,14,164,7.5,144,797,36.2,237,560,807,36.7,136,-10,671,-10,131,6,22058
74447,T001038,Total male and female,GM0703,Reimerswaal,2015JJ00,2015,22058,216,340,15.3,161,7.3,179,834,37.6,219,615,807,36.4,135,4,672,27,207,9.4,22265
74448,T001038,Total male and female,GM0703,Reimerswaal,2016JJ00,2016,22265,219,308,13.8,183,8.2,125,964,43.2,279,685,998,44.7,207,-58,791,-34,91,4.1,22356
74449,T001038,Total male and female,GM0703,Reimerswaal,2017JJ00,2017,22356,220,319,14.2,162,7.2,157,1072,47.7,354,718,1028,45.8,177,-28,851,44,199,8.9,22555
74450,T001038,Total male and female,GM0703,Reimerswaal,2018JJ00,2018,22555,222,301,13.3,183,8.1,118,1066,47.1,417,649,1065,47.1,238,-44,827,1,123,5.5,22678
74451,T001038,Total male and female,GM0703,Reimerswaal,2019JJ00,2019,22678,223,291,12.8,157,6.9,134,1079,47.5,308,771,1162,51.2,334,-31,828,-83,52,2.3,22730
74452,T001038,Total male and female,GM0703,Reimerswaal,2020JJ00,2020,22730,223,311,13.6,177,7.8,134,1092,47.9,297,795,1060,46.5,222,-31,838,32,166,7.3,22896
74453,T001038,Total male and female,GM0703,Reimerswaal,2021JJ00,2021,22896,225,277,12.1,191,8.3,86,981,42.8,287,694,1042,45.5,219,-21,823,-61,24,1,22920
74454,T001038,Total male and female,GM0703,Reimerswaal,2022JJ00,2022,22920,225,301,13,180,7.8,121,1317,57,534,783,1102,47.7,291,-29,811,215,335,14.6,23255
74455,T001038,Total male and female,GM0703,Reimerswaal,2023JJ00,2023,23255,229,276,11.9,171,7.3,105,1075,46.2,308,767,1109,47.6,267,-41,842,-34,70,3,23325
74608,T001038,Total male and female,GM0274,Renkum,2012JJ00,2012,31630,687,219,6.9,410,13,-191,1930,61.1,126,1804,1803,57.1,154,-8,1649,127,-65,-2.1,31565
74609,T001038,Total male and female,GM0274,Renkum,2013JJ00,2013,31565,687,248,7.9,400,12.7,-152,1995,63.2,174,1821,1830,58,130,-6,1700,165,15,0.5,31580
74610,T001038,Total male and female,GM0274,Renkum,2014JJ00,2014,31580,687,236,7.5,415,13.2,-179,2119,67.3,171,1948,2114,67.1,179,-17,1935,5,-172,-5.4,31408
74611,T001038,Total male and female,GM0274,Renkum,2015JJ00,2015,31408,683,213,6.8,411,13.1,-198,2075,66.2,196,1879,2036,65,98,37,1938,39,-154,-4.9,31254
74612,T001038,Total male and female,GM0274,Renkum,2016JJ00,2016,31254,680,236,7.5,398,12.7,-162,2343,74.8,161,2182,2043,65.2,122,9,1921,300,137,4.4,31391
74613,T001038,Total male and female,GM0274,Renkum,2017JJ00,2017,31391,683,214,6.8,389,12.4,-175,2296,73.2,173,2123,2177,69.4,104,7,2073,119,-53,-1.7,31338
74614,T001038,Total male and female,GM0274,Renkum,2018JJ00,2018,31338,682,209,6.7,393,12.5,-184,2075,66.3,162,1913,1927,61.5,111,-1,1816,148,-36,-1.1,31302
74615,T001038,Total male and female,GM0274,Renkum,2019JJ00,2019,31302,681,196,6.2,375,12,-179,2143,68.3,179,1964,1850,59,121,7,1729,293,117,3.7,31419
74616,T001038,Total male and female,GM0274,Renkum,2020JJ00,2020,31419,684,211,6.7,461,14.7,-250,2095,66.7,164,1931,1848,58.8,117,-7,1731,247,-2,-0.1,31417
74617,T001038,Total male and female,GM0274,Renkum,2021JJ00,2021,31417,684,169,5.4,405,12.9,-236,2007,63.9,156,1851,1829,58.3,94,-5,1735,178,-59,-1.9,31358
74618,T001038,Total male and female,GM0274,Renkum,2022JJ00,2022,31358,682,210,6.7,482,15.3,-272,2016,64.2,341,1675,1643,52.3,137,-2,1506,373,103,3.3,31461
74619,T001038,Total male and female,GM0274,Renkum,2023JJ00,2023,31461,685,173,5.5,423,13.5,-250,2058,65.5,219,1839,1852,58.9,127,-6,1725,206,-42,-1.3,31419
74690,T001038,Total male and female,GM0339,Renswoude,2012JJ00,2012,4822,262,72,14.8,23,4.7,49,218,44.9,11,207,196,40.3,4,-2,192,22,71,14.7,4893
74691,T001038,Total male and female,GM0339,Renswoude,2013JJ00,2013,4893,266,88,17.9,16,3.3,72,177,36.1,13,164,218,44.4,21,-4,197,-41,31,6.3,4924
74692,T001038,Total male and female,GM0339,Renswoude,2014JJ00,2014,4924,267,94,19,23,4.6,71,204,41.2,28,176,229,46.3,26,-4,203,-25,52,10.6,4976
74693,T001038,Total male and female,GM0339,Renswoude,2015JJ00,2015,4976,270,62,12.4,31,6.2,31,263,52.5,32,231,219,43.7,12,0,207,44,75,15.1,5051
74694,T001038,Total male and female,GM0339,Renswoude,2016JJ00,2016,5051,274,79,15.6,32,6.3,47,263,51.8,20,243,260,51.2,9,-4,251,3,50,9.9,5101
74695,T001038,Total male and female,GM0339,Renswoude,2017JJ00,2017,5101,277,72,14,32,6.2,40,352,68.5,34,318,318,61.9,17,-11,301,34,74,14.5,5175
74696,T001038,Total male and female,GM0339,Renswoude,2018JJ00,2018,5175,281,84,16.1,20,3.8,64,305,58.5,14,291,285,54.6,15,-3,270,20,84,16.2,5259
74697,T001038,Total male and female,GM0339,Renswoude,2019JJ00,2019,5259,286,81,15.1,30,5.6,51,445,83.2,28,417,313,58.5,22,-7,291,132,185,35.2,5444
74698,T001038,Total male and female,GM0339,Renswoude,2020JJ00,2020,5444,296,85,15.5,34,6.2,51,371,67.5,35,336,310,56.4,16,-2,294,61,112,20.6,5556
74699,T001038,Total male and female,GM0339,Renswoude,2021JJ00,2021,5556,302,92,16.4,21,3.7,71,380,67.8,28,352,356,63.5,19,-4,337,24,95,17.1,5651
74700,T001038,Total male and female,GM0339,Renswoude,2022JJ00,2022,5651,307,80,14,30,5.3,50,547,96,367,180,502,88.1,74,-44,428,45,96,17,5747
74701,T001038,Total male and female,GM0339,Renswoude,2023JJ00,2023,5747,313,84,14.6,37,6.4,47,303,52.7,50,253,342,59.5,69,-35,273,-39,6,1,5753
74936,T001038,Total male and female,GM1667,Reusel-De Mierden,2012JJ00,2012,12654,162,138,10.9,90,7.1,48,371,29.3,64,307,402,31.7,68,-13,334,-31,16,1.3,12670
74937,T001038,Total male and female,GM1667,Reusel-De Mierden,2013JJ00,2013,12670,163,138,10.9,93,7.3,45,445,35.1,105,340,448,35.3,53,-3,395,-3,43,3.4,12713
74938,T001038,Total male and female,GM1667,Reusel-De Mierden,2014JJ00,2014,12713,163,134,10.5,74,5.8,60,420,33,99,321,419,32.9,60,-21,359,1,61,4.8,12774
74939,T001038,Total male and female,GM1667,Reusel-De Mierden,2015JJ00,2015,12774,164,139,10.9,76,5.9,63,452,35.3,74,378,480,37.5,76,-5,404,-28,37,2.9,12811
74940,T001038,Total male and female,GM1667,Reusel-De Mierden,2016JJ00,2016,12811,164,127,9.9,102,7.9,25,518,40.3,87,431,447,34.8,54,-8,393,71,97,7.6,12908
74941,T001038,Total male and female,GM1667,Reusel-De Mierden,2017JJ00,2017,12908,166,138,10.6,87,6.7,51,611,47.1,108,503,528,40.7,61,-6,467,83,132,10.2,13040
74942,T001038,Total male and female,GM1667,Reusel-De Mierden,2018JJ00,2018,13040,167,140,10.7,99,7.6,41,506,38.8,86,420,526,40.3,68,-5,458,-20,20,1.5,13060
74943,T001038,Total male and female,GM1667,Reusel-De Mierden,2019JJ00,2019,13060,168,141,10.8,77,5.9,64,499,38.1,94,405,511,39,66,-4,445,-12,52,4,13112
74944,T001038,Total male and female,GM1667,Reusel-De Mierden,2020JJ00,2020,13112,168,129,9.8,109,8.3,20,524,39.9,79,445,529,40.3,75,-5,454,-5,15,1.1,13127
74945,T001038,Total male and female,GM1667,Reusel-De Mierden,2021JJ00,2021,13127,169,144,10.9,106,8,38,594,45,82,512,488,37,62,-5,426,106,144,11,13271
74946,T001038,Total male and female,GM1667,Reusel-De Mierden,2022JJ00,2022,13271,171,145,10.8,101,7.5,44,662,49.4,163,499,434,32.4,77,-24,357,228,271,20.4,13542
74947,T001038,Total male and female,GM1667,Reusel-De Mierden,2023JJ00,2023,13542,174,133,9.8,110,8.1,23,511,37.7,94,417,499,36.8,98,-7,401,12,35,2.6,13577
75018,T001038,Total male and female,GM0275,Rheden,2012JJ00,2012,43612,533,350,8,579,13.3,-229,2527,57.9,225,2302,2229,51.1,258,-95,1971,298,67,1.5,43679
75019,T001038,Total male and female,GM0275,Rheden,2013JJ00,2013,43679,534,338,7.7,569,13,-231,2517,57.7,180,2337,2318,53.1,142,-13,2176,199,-39,-0.9,43640
75020,T001038,Total male and female,GM0275,Rheden,2014JJ00,2014,43640,534,337,7.7,533,12.2,-196,2621,60.1,247,2374,2443,56,236,-53,2207,178,-15,-0.3,43625
75021,T001038,Total male and female,GM0275,Rheden,2015JJ00,2015,43625,534,344,7.9,554,12.7,-210,3040,69.5,607,2433,2635,60.3,152,22,2483,405,199,4.6,43824
75022,T001038,Total male and female,GM0275,Rheden,2016JJ00,2016,43824,536,334,7.6,560,12.8,-226,3077,70.4,413,2664,3029,69.3,259,-25,2770,48,-179,-4.1,43645
75023,T001038,Total male and female,GM0275,Rheden,2017JJ00,2017,43645,534,390,8.9,610,14,-220,3076,70.6,372,2704,2967,68.1,246,-92,2721,109,-118,-2.7,43527
75024,T001038,Total male and female,GM0275,Rheden,2018JJ00,2018,43527,533,336,7.7,610,14,-274,2985,68.5,291,2694,2594,59.5,279,-78,2315,391,113,2.6,43640
75025,T001038,Total male and female,GM0275,Rheden,2019JJ00,2019,43640,534,312,7.1,609,13.9,-297,2995,68.5,538,2457,2580,59,279,-56,2301,415,121,2.8,43761
75026,T001038,Total male and female,GM0275,Rheden,2020JJ00,2020,43761,535,362,8.3,639,14.6,-277,2789,63.9,297,2492,2748,63,347,-171,2401,41,-236,-5.4,43525
75027,T001038,Total male and female,GM0275,Rheden,2021JJ00,2021,43525,532,329,7.6,628,14.4,-299,2710,62.3,346,2364,2500,57.5,237,-86,2263,210,-90,-2.1,43435
75028,T001038,Total male and female,GM0275,Rheden,2022JJ00,2022,43435,531,320,7.4,622,14.3,-302,3162,72.7,482,2680,2723,62.6,286,-48,2437,439,135,3.1,43570
75029,T001038,Total male and female,GM0275,Rheden,2023JJ00,2023,43570,533,320,7.3,712,16.3,-392,3323,76.2,585,2738,2835,65,306,-80,2529,488,91,2.1,43661
75100,T001038,Total male and female,GM0340,Rhenen,2012JJ00,2012,19064,453,206,10.8,140,7.3,66,838,44,55,783,873,45.8,51,-2,822,-35,-17,-0.9,19047
75101,T001038,Total male and female,GM0340,Rhenen,2013JJ00,2013,19047,453,207,10.8,125,6.6,82,787,41.2,36,751,800,41.9,66,-6,734,-13,69,3.6,19116
75102,T001038,Total male and female,GM0340,Rhenen,2014JJ00,2014,19116,454,199,10.4,153,8,46,1046,54.4,57,989,902,46.9,47,-5,855,144,192,10,19308
75103,T001038,Total male and female,GM0340,Rhenen,2015JJ00,2015,19308,459,197,10.2,151,7.8,46,1000,51.7,87,913,949,49,60,-13,889,51,92,4.8,19400
75104,T001038,Total male and female,GM0340,Rhenen,2016JJ00,2016,19400,461,192,9.8,156,8,36,1181,60.6,82,1099,1022,52.4,58,-8,964,159,197,10.2,19597
75105,T001038,Total male and female,GM0340,Rhenen,2017JJ00,2017,19597,466,221,11.2,163,8.3,58,1199,60.8,83,1116,1037,52.6,61,-6,976,162,219,11.2,19816
75106,T001038,Total male and female,GM0340,Rhenen,2018JJ00,2018,19816,471,214,10.7,181,9.1,33,1183,59.4,118,1065,1028,51.6,65,-19,963,155,188,9.5,20004
75107,T001038,Total male and female,GM0340,Rhenen,2019JJ00,2019,20004,475,216,10.8,161,8,55,1172,58.4,102,1070,1112,55.4,47,1,1065,60,115,5.7,20119
75108,T001038,Total male and female,GM0340,Rhenen,2020JJ00,2020,20119,478,220,10.9,195,9.7,25,1178,58.4,106,1072,1119,55.5,73,-5,1046,59,84,4.2,20203
75109,T001038,Total male and female,GM0340,Rhenen,2021JJ00,2021,20203,480,236,11.7,226,11.2,10,1032,51,71,961,980,48.4,60,0,920,52,62,3.1,20265
75110,T001038,Total male and female,GM0340,Rhenen,2022JJ00,2022,20265,482,211,10.4,185,9.1,26,1039,51.2,188,851,1000,49.3,69,-23,931,39,64,3.2,20329
75111,T001038,Total male and female,GM0340,Rhenen,2023JJ00,2023,20329,484,180,8.9,201,9.9,-21,1052,51.9,101,951,1124,55.4,83,-15,1041,-72,-94,-4.6,20235
75264,T001038,Total male and female,GM0597,Ridderkerk,2012JJ00,2012,45208,1904,445,9.8,446,9.9,-1,1525,33.7,121,1404,1400,30.9,136,-23,1264,125,122,2.7,45330
75265,T001038,Total male and female,GM0597,Ridderkerk,2013JJ00,2013,45330,1912,399,8.8,419,9.3,-20,1436,31.7,150,1286,1495,33,134,-14,1361,-59,-77,-1.7,45253
75266,T001038,Total male and female,GM0597,Ridderkerk,2014JJ00,2014,45253,1909,417,9.2,400,8.8,17,1446,32,132,1314,1566,34.6,117,-4,1449,-120,-104,-2.3,45149
75267,T001038,Total male and female,GM0597,Ridderkerk,2015JJ00,2015,45149,1904,392,8.7,466,10.3,-74,1716,38,151,1565,1692,37.5,153,-21,1539,24,-52,-1.2,45097
75268,T001038,Total male and female,GM0597,Ridderkerk,2016JJ00,2016,45097,1901,428,9.5,436,9.6,-8,2062,45.6,121,1941,1743,38.5,163,-33,1580,319,311,6.9,45408
75269,T001038,Total male and female,GM0597,Ridderkerk,2017JJ00,2017,45408,1914,410,9,513,11.3,-103,2284,50.1,188,2096,1802,39.5,132,-26,1670,482,381,8.4,45789
75270,T001038,Total male and female,GM0597,Ridderkerk,2018JJ00,2018,45789,1930,464,10.1,498,10.8,-34,2480,53.9,208,2272,1996,43.4,148,-25,1848,484,452,9.9,46241
75271,T001038,Total male and female,GM0597,Ridderkerk,2019JJ00,2019,46241,1949,451,9.8,488,10.6,-37,1915,41.4,182,1733,1930,41.8,156,-53,1774,-15,-52,-1.1,46189
75272,T001038,Total male and female,GM0597,Ridderkerk,2020JJ00,2020,46189,1947,450,9.7,632,13.6,-182,2588,55.7,178,2410,1928,41.5,132,-21,1796,660,482,10.4,46671
75273,T001038,Total male and female,GM0597,Ridderkerk,2021JJ00,2021,46671,1968,475,10.1,573,12.2,-98,2503,53.4,210,2293,1976,42.1,114,-20,1862,527,428,9.2,47099
75274,T001038,Total male and female,GM0597,Ridderkerk,2022JJ00,2022,47099,2006,468,9.9,557,11.8,-89,2536,53.6,352,2184,2069,43.8,167,-17,1902,467,378,8,47477
75275,T001038,Total male and female,GM0597,Ridderkerk,2023JJ00,2023,47477,2022,409,8.6,537,11.3,-128,2311,48.6,221,2090,1939,40.7,148,-3,1791,372,244,5.1,47721
75838,T001038,Total male and female,GM0196,Rijnwaarden,2012JJ00,2012,11008,276,81,7.4,111,10.1,-30,411,37.4,52,359,421,38.3,27,-2,394,-10,-40,-3.6,10968
75839,T001038,Total male and female,GM0196,Rijnwaarden,2013JJ00,2013,10968,277,94,8.6,114,10.4,-20,373,34.1,45,328,404,36.9,50,-1,354,-31,-51,-4.6,10917
75840,T001038,Total male and female,GM0196,Rijnwaarden,2014JJ00,2014,10917,275,96,8.8,116,10.6,-20,434,39.8,50,384,422,38.7,28,9,394,12,-5,-0.5,10912
75841,T001038,Total male and female,GM0196,Rijnwaarden,2015JJ00,2015,10912,275,101,9.3,113,10.4,-12,376,34.5,40,336,414,38,44,-10,370,-38,-46,-4.2,10866
75842,T001038,Total male and female,GM0196,Rijnwaarden,2016JJ00,2016,10866,274,82,7.6,93,8.6,-11,424,39,50,374,426,39.2,48,-1,378,-2,-14,-1.3,10852
75843,T001038,Total male and female,GM0196,Rijnwaarden,2017JJ00,2017,10852,274,88,8.1,101,9.3,-13,521,48.1,44,477,533,49.2,34,-5,499,-12,-42,-3.9,10810
75920,T001038,Total male and female,GM1672,Rijnwoude,2012JJ00,2012,18618,328,195,10.5,105,5.6,90,512,27.5,50,462,644,34.6,47,-7,597,-132,-41,-2.2,18577
75921,T001038,Total male and female,GM1672,Rijnwoude,2013JJ00,2013,18577,328,158,8.5,110,5.9,48,509,27.5,65,444,641,34.6,51,-7,590,-132,-93,-5,18484
76248,T001038,Total male and female,GM1742,Rijssen-Holten,2012JJ00,2012,37561,399,488,13,294,7.8,194,765,20.4,68,697,913,24.3,60,4,853,-148,47,1.3,37608
76249,T001038,Total male and female,GM1742,Rijssen-Holten,2013JJ00,2013,37608,400,477,12.7,287,7.6,190,786,20.9,81,705,923,24.5,85,-9,838,-137,53,1.4,37661
76250,T001038,Total male and female,GM1742,Rijssen-Holten,2014JJ00,2014,37661,400,532,14.1,269,7.1,263,813,21.5,90,723,906,24,82,-14,824,-93,169,4.5,37830
76251,T001038,Total male and female,GM1742,Rijssen-Holten,2015JJ00,2015,37830,402,459,12.1,298,7.9,161,848,22.4,91,757,963,25.4,87,-6,876,-115,45,1.2,37875
76252,T001038,Total male and female,GM1742,Rijssen-Holten,2016JJ00,2016,37875,402,479,12.6,300,7.9,179,1002,26.4,81,921,1071,28.2,92,-3,979,-69,108,2.9,37983
76253,T001038,Total male and female,GM1742,Rijssen-Holten,2017JJ00,2017,37983,404,462,12.1,296,7.8,166,1047,27.5,65,982,1095,28.8,77,-4,1018,-48,114,3,38097
76254,T001038,Total male and female,GM1742,Rijssen-Holten,2018JJ00,2018,38097,405,435,11.4,320,8.4,115,1077,28.2,65,1012,989,25.9,67,0,922,88,203,5.3,38300
76255,T001038,Total male and female,GM1742,Rijssen-Holten,2019JJ00,2019,38300,407,412,10.8,307,8,105,889,23.2,110,779,1116,29.2,72,0,1044,-227,-123,-3.2,38177
76256,T001038,Total male and female,GM1742,Rijssen-Holten,2020JJ00,2020,38177,406,438,11.5,375,9.8,63,977,25.6,122,855,1012,26.5,68,-11,944,-35,27,0.7,38204
76257,T001038,Total male and female,GM1742,Rijssen-Holten,2021JJ00,2021,38204,406,435,11.4,352,9.2,83,924,24.2,79,845,977,25.6,70,-3,907,-53,27,0.7,38231
76258,T001038,Total male and female,GM1742,Rijssen-Holten,2022JJ00,2022,38231,406,417,10.9,351,9.1,66,1208,31.5,345,863,1011,26.4,172,-26,839,197,262,6.9,38493
76259,T001038,Total male and female,GM1742,Rijssen-Holten,2023JJ00,2023,38493,409,432,11.2,350,9.1,82,1160,30.1,159,1001,1063,27.6,124,-6,939,97,182,4.7,38675
76412,T001038,Total male and female,GM0603,Rijswijk (ZH.),2012JJ00,2012,46990,3344,509,10.8,618,13.1,-109,3503,74.2,450,3053,3009,63.8,523,-133,2486,494,382,8.1,47372
76413,T001038,Total male and female,GM0603,Rijswijk (ZH.),2013JJ00,2013,47372,3372,570,12,538,11.3,32,3245,68.3,467,2778,3017,63.5,482,-76,2535,228,262,5.5,47634
76414,T001038,Total male and female,GM0603,Rijswijk (ZH.),2014JJ00,2014,47634,3390,569,11.9,586,12.2,-17,3844,80.2,537,3307,3242,67.6,546,-152,2696,602,582,12.2,48216
76415,T001038,Total male and female,GM0603,Rijswijk (ZH.),2015JJ00,2015,48216,3432,561,11.5,620,12.7,-59,4549,93.3,620,3929,3377,69.2,505,-70,2872,1172,1112,23.1,49328
76416,T001038,Total male and female,GM0603,Rijswijk (ZH.),2016JJ00,2016,49328,3511,638,12.7,605,12.1,33,5349,106.6,737,4612,3688,73.5,489,-79,3199,1661,1699,34.4,51027
76417,T001038,Total male and female,GM0603,Rijswijk (ZH.),2017JJ00,2017,51027,3632,647,12.5,553,10.7,94,5519,106.9,720,4799,4423,85.7,475,-80,3948,1096,1181,23.1,52208
76418,T001038,Total male and female,GM0603,Rijswijk (ZH.),2018JJ00,2018,52208,3740,703,13.3,608,11.5,95,5364,101.5,781,4583,4197,79.4,467,-91,3730,1167,1259,24.1,53467
76419,T001038,Total male and female,GM0603,Rijswijk (ZH.),2019JJ00,2019,53467,3830,683,12.7,587,10.9,96,5469,101.4,849,4620,4574,84.8,569,-135,4005,895,983,18.4,54450
76420,T001038,Total male and female,GM0603,Rijswijk (ZH.),2020JJ00,2020,54450,3900,647,11.8,677,12.3,-30,5276,96.2,624,4652,4470,81.5,451,-65,4019,806,770,14.1,55220
76421,T001038,Total male and female,GM0603,Rijswijk (ZH.),2021JJ00,2021,55220,3956,712,12.7,653,11.6,59,6396,114.1,823,5573,4725,84.3,553,-90,4172,1671,1721,31.2,56941
76422,T001038,Total male and female,GM0603,Rijswijk (ZH.),2022JJ00,2022,56941,4079,675,11.7,626,10.9,49,5696,99.1,1311,4385,4681,81.5,544,-70,4137,1015,1056,18.5,57997
76423,T001038,Total male and female,GM0603,Rijswijk (ZH.),2023JJ00,2023,57997,4149,693,11.8,594,10.1,99,5675,96.5,989,4686,4128,70.2,514,-73,3614,1547,1645,28.4,59642
76822,T001038,Total male and female,GM1669,Roerdalen,2012JJ00,2012,21092,239,162,7.7,196,9.3,-34,770,36.6,117,653,830,39.4,94,-9,736,-60,-96,-4.6,20996
76823,T001038,Total male and female,GM1669,Roerdalen,2013JJ00,2013,20996,238,155,7.4,197,9.4,-42,784,37.5,125,659,910,43.5,143,-35,767,-126,-164,-7.8,20832
76824,T001038,Total male and female,GM1669,Roerdalen,2014JJ00,2014,20832,236,142,6.8,200,9.6,-58,807,38.9,112,695,883,42.5,98,-27,785,-76,-133,-6.4,20699
76825,T001038,Total male and female,GM1669,Roerdalen,2015JJ00,2015,20699,235,129,6.2,216,10.4,-87,985,47.6,124,861,911,44,125,-40,786,74,-13,-0.6,20686
76826,T001038,Total male and female,GM1669,Roerdalen,2016JJ00,2016,20686,234,161,7.8,217,10.5,-56,954,46.1,143,811,879,42.5,102,-10,777,75,14,0.7,20700
76827,T001038,Total male and female,GM1669,Roerdalen,2017JJ00,2017,20700,235,149,7.2,227,11,-78,1006,48.6,160,846,901,43.5,103,-6,798,105,28,1.4,20728
76828,T001038,Total male and female,GM1669,Roerdalen,2018JJ00,2018,20728,235,134,6.5,223,10.8,-89,1048,50.7,157,891,1071,51.8,108,-5,963,-23,-113,-5.5,20615
76829,T001038,Total male and female,GM1669,Roerdalen,2019JJ00,2019,20615,234,138,6.7,201,9.8,-63,1065,51.7,169,896,1045,50.7,133,-29,912,20,-41,-2,20574
76830,T001038,Total male and female,GM1669,Roerdalen,2020JJ00,2020,20574,233,133,6.5,226,11,-93,1106,53.7,140,966,1003,48.7,100,-18,903,103,6,0.3,20580
76831,T001038,Total male and female,GM1669,Roerdalen,2021JJ00,2021,20580,233,172,8.4,266,12.9,-94,927,45.1,107,820,855,41.6,98,-10,757,72,-22,-1.1,20558
76832,T001038,Total male and female,GM1669,Roerdalen,2022JJ00,2022,20558,233,172,8.3,232,11.2,-60,1041,50.5,176,865,837,40.6,148,-20,689,204,144,7,20702
76833,T001038,Total male and female,GM1669,Roerdalen,2023JJ00,2023,20702,235,139,6.7,247,11.9,-108,1021,49.2,177,844,809,39,106,-34,703,212,104,5,20806
76904,T001038,Total male and female,GM0957,Roermond,2012JJ00,2012,56165,923,565,10,540,9.6,25,2780,49.3,515,2265,2274,40.3,330,47,1944,506,525,9.3,56690
76905,T001038,Total male and female,GM0957,Roermond,2013JJ00,2013,56690,931,565,9.9,562,9.9,3,2611,46,446,2165,2373,41.8,447,-60,1926,238,239,4.2,56929
76906,T001038,Total male and female,GM0957,Roermond,2014JJ00,2014,56929,935,513,9,519,9.1,-6,2554,44.8,454,2100,2462,43.2,433,-20,2029,92,76,1.3,57005
76907,T001038,Total male and female,GM0957,Roermond,2015JJ00,2015,57005,937,562,9.9,632,11.1,-70,2693,47.2,475,2218,2630,46.1,514,-57,2116,63,5,0.1,57010
76908,T001038,Total male and female,GM0957,Roermond,2016JJ00,2016,57010,937,546,9.5,550,9.6,-4,2909,50.9,491,2418,2518,44,433,-41,2085,391,380,6.7,57390
76909,T001038,Total male and female,GM0957,Roermond,2017JJ00,2017,57390,943,584,10.1,563,9.8,21,3053,53,562,2491,2696,46.8,424,-41,2272,357,371,6.5,57761
76910,T001038,Total male and female,GM0957,Roermond,2018JJ00,2018,57761,950,530,9.1,543,9.4,-13,3111,53.7,635,2476,2654,45.8,393,-58,2261,457,448,7.8,58209
76911,T001038,Total male and female,GM0957,Roermond,2019JJ00,2019,58209,957,498,8.6,603,10.4,-105,3057,52.5,702,2355,2889,49.6,537,-119,2352,168,51,0.9,58260
76912,T001038,Total male and female,GM0957,Roermond,2020JJ00,2020,58260,958,568,9.7,634,10.8,-66,3366,57.5,729,2637,2793,47.7,447,-74,2346,573,503,8.6,58763
76913,T001038,Total male and female,GM0957,Roermond,2021JJ00,2021,58763,966,583,9.9,700,11.9,-117,3245,55,701,2544,2704,45.9,427,-82,2277,541,421,7.2,59184
76914,T001038,Total male and female,GM0957,Roermond,2022JJ00,2022,59184,976,543,9.1,614,10.3,-71,3702,62.1,1149,2553,2836,47.6,565,-100,2271,866,797,13.5,59981
76915,T001038,Total male and female,GM0957,Roermond,2023JJ00,2023,59981,989,535,8.9,634,10.5,-99,3771,62.5,964,2807,2905,48.1,583,-114,2322,866,762,12.7,60743
77232,T001038,Total male and female,GM0736,De Ronde Venen,2012JJ00,2012,42977,426,311,7.2,309,7.2,2,1317,30.7,196,1121,1450,33.8,176,-2,1274,-133,-131,-3,42846
77233,T001038,Total male and female,GM0736,De Ronde Venen,2013JJ00,2013,42846,428,324,7.6,328,7.7,-4,1309,30.6,239,1070,1510,35.3,201,-6,1309,-201,-204,-4.8,42642
77234,T001038,Total male and female,GM0736,De Ronde Venen,2014JJ00,2014,42642,425,347,8.1,305,7.2,42,1457,34.2,215,1242,1550,36.4,190,-28,1360,-93,-54,-1.3,42588
77235,T001038,Total male and female,GM0736,De Ronde Venen,2015JJ00,2015,42588,425,325,7.6,322,7.6,3,1727,40.6,245,1482,1744,41,236,-13,1508,-17,-12,-0.3,42576
77236,T001038,Total male and female,GM0736,De Ronde Venen,2016JJ00,2016,42576,426,357,8.4,312,7.3,45,1916,44.9,221,1695,1774,41.6,210,-30,1564,142,187,4.4,42763
77237,T001038,Total male and female,GM0736,De Ronde Venen,2017JJ00,2017,42763,428,366,8.5,308,7.1,58,2616,60.6,282,2334,1817,42.1,216,-13,1601,799,857,20,43620
77238,T001038,Total male and female,GM0736,De Ronde Venen,2018JJ00,2018,43620,437,375,8.6,393,9,-18,2265,51.7,314,1951,1808,41.2,235,-2,1573,457,439,10.1,44059
77239,T001038,Total male and female,GM0736,De Ronde Venen,2019JJ00,2019,44059,441,387,8.7,374,8.5,13,2145,48.5,318,1827,1762,39.8,205,-19,1557,383,397,9,44456
77240,T001038,Total male and female,GM0736,De Ronde Venen,2020JJ00,2020,44456,445,390,8.7,355,8,35,2078,46.6,243,1835,1850,41.5,176,-15,1674,228,264,5.9,44720
77241,T001038,Total male and female,GM0736,De Ronde Venen,2021JJ00,2021,44720,448,424,9.5,428,9.5,-4,2231,49.8,237,1994,1992,44.4,216,-18,1776,239,235,5.3,44955
77242,T001038,Total male and female,GM0736,De Ronde Venen,2022JJ00,2022,44955,451,397,8.8,399,8.8,-2,2519,55.7,516,2003,1901,42,287,-21,1614,618,617,13.7,45572
77243,T001038,Total male and female,GM0736,De Ronde Venen,2023JJ00,2023,45572,457,424,9.3,416,9.1,8,2194,48,380,1814,1961,42.9,270,-14,1691,233,241,5.3,45813
77314,T001038,Total male and female,GM1674,Roosendaal,2012JJ00,2012,77426,728,780,10.1,775,10,5,2429,31.4,609,1820,2699,34.9,585,-160,2114,-270,-271,-3.5,77155
77315,T001038,Total male and female,GM1674,Roosendaal,2013JJ00,2013,77155,725,761,9.9,760,9.9,1,2631,34.1,605,2026,2763,35.8,555,-67,2208,-132,-128,-1.7,77027
77316,T001038,Total male and female,GM1674,Roosendaal,2014JJ00,2014,77027,723,762,9.9,774,10.1,-12,2783,36.2,648,2135,2921,38,610,-123,2311,-138,-153,-2,76874
77317,T001038,Total male and female,GM1674,Roosendaal,2015JJ00,2015,76874,722,728,9.5,763,9.9,-35,3065,39.8,750,2315,2944,38.3,640,-133,2304,121,86,1.1,76960
77318,T001038,Total male and female,GM1674,Roosendaal,2016JJ00,2016,76960,723,801,10.4,741,9.6,60,3284,42.6,729,2555,3133,40.7,649,-168,2484,151,203,2.6,77163
77319,T001038,Total male and female,GM1674,Roosendaal,2017JJ00,2017,77163,725,679,8.8,789,10.2,-110,3274,42.5,794,2480,3325,43.1,598,-142,2727,-51,-163,-2.1,77000
77320,T001038,Total male and female,GM1674,Roosendaal,2018JJ00,2018,77000,723,707,9.2,789,10.2,-82,3309,43,894,2415,3190,41.4,612,-174,2578,119,32,0.4,77032
77321,T001038,Total male and female,GM1674,Roosendaal,2019JJ00,2019,77032,723,716,9.3,788,10.2,-72,3615,46.9,1091,2524,3326,43.1,695,-186,2631,289,219,2.8,77251
77322,T001038,Total male and female,GM1674,Roosendaal,2020JJ00,2020,77251,725,681,8.8,798,10.3,-117,3365,43.6,878,2487,3301,42.7,633,-150,2668,64,-51,-0.7,77200
77323,T001038,Total male and female,GM1674,Roosendaal,2021JJ00,2021,77200,725,717,9.3,872,11.3,-155,3415,44.2,933,2482,3212,41.6,735,-230,2477,203,44,0.6,77244
77324,T001038,Total male and female,GM1674,Roosendaal,2022JJ00,2022,77244,725,644,8.3,852,11,-208,3806,49.2,1366,2440,3229,41.7,739,-145,2490,577,369,4.8,77613
77325,T001038,Total male and female,GM1674,Roosendaal,2023JJ00,2023,77613,729,646,8.3,868,11.2,-222,3500,45.1,1062,2438,3333,43,624,-115,2709,167,-54,-0.7,77559
77724,T001038,Total male and female,GM0599,Rotterdam,2012JJ00,2012,616260,2951,8156,13.2,5592,9.1,2564,32725,53.1,10850,21875,35242,57.2,12893,-5824,22349,-2517,34,0.1,616294
77725,T001038,Total male and female,GM0599,Rotterdam,2013JJ00,2013,616294,2950,7961,12.9,5647,9.1,2314,32643,52.9,10460,22183,32963,53.4,11164,-3645,21799,-320,2063,3.3,618357
77726,T001038,Total male and female,GM0599,Rotterdam,2014JJ00,2014,618357,2960,8107,13.1,5228,8.4,2879,34734,55.9,10953,23781,32368,52.1,9898,-2085,22470,2366,5295,8.6,623652
77727,T001038,Total male and female,GM0599,Rotterdam,2015JJ00,2015,623652,2986,7879,12.6,5578,8.9,2301,36953,59,11592,25361,33422,53.3,9590,-1564,23832,3531,5954,9.5,629606
77728,T001038,Total male and female,GM0599,Rotterdam,2016JJ00,2016,629606,2920,8060,12.8,5598,8.9,2462,38811,61.4,12066,26745,36230,57.3,9882,-1969,26348,2581,5054,8,634660
77729,T001038,Total male and female,GM0599,Rotterdam,2017JJ00,2017,634660,2943,7714,12.1,5608,8.8,2106,40552,63.7,13436,27116,38543,60.5,10485,-2698,28058,2009,4052,6.4,638712
77730,T001038,Total male and female,GM0599,Rotterdam,2018JJ00,2018,638712,2936,7767,12.1,5604,8.7,2163,40287,62.8,14178,26109,36544,57,8771,-873,27773,3743,5906,9.2,644618
77731,T001038,Total male and female,GM0599,Rotterdam,2019JJ00,2019,644618,2963,7720,11.9,5464,8.4,2256,43159,66.6,16460,26699,38863,60,9717,-1222,29146,4296,6550,10.2,651168
77732,T001038,Total male and female,GM0599,Rotterdam,2020JJ00,2020,651157,2993,7613,11.7,6537,10,1076,41741,64.1,13956,27785,42266,64.9,9753,-1409,32513,-525,474,0.7,651631
77733,T001038,Total male and female,GM0599,Rotterdam,2021JJ00,2021,651631,2995,7663,11.7,6018,9.2,1645,45106,69,16203,28903,42886,65.6,8790,-1085,34096,2220,3837,5.9,655468
77734,T001038,Total male and female,GM0599,Rotterdam,2022JJ00,2022,655468,3001,7165,10.9,5999,9.1,1166,49869,75.6,21751,28118,42578,64.5,9987,-1259,32591,7291,8432,12.9,663900
77735,T001038,Total male and female,GM0599,Rotterdam,2023JJ00,2023,663900,3040,6886,10.3,5869,8.8,1017,49347,74,19136,30211,43616,65.4,11141,-1924,32475,5731,6710,10.1,670610
77888,T001038,Total male and female,GM0277,Rozendaal,2012JJ00,2012,1514,54,8,5.3,13,8.6,-5,86,57,12,74,94,62.4,14,-2,80,-8,-13,-8.6,1501
77889,T001038,Total male and female,GM0277,Rozendaal,2013JJ00,2013,1501,54,9,6,10,6.7,-1,84,55.9,7,77,81,53.9,3,-1,78,3,2,1.3,1503
77890,T001038,Total male and female,GM0277,Rozendaal,2014JJ00,2014,1503,54,4,2.7,6,4,-2,79,52.5,3,76,71,47.1,5,0,66,8,6,4,1509
77891,T001038,Total male and female,GM0277,Rozendaal,2015JJ00,2015,1509,54,6,4,15,10,-9,72,47.9,11,61,74,49.2,10,1,64,-2,-11,-7.3,1498
77892,T001038,Total male and female,GM0277,Rozendaal,2016JJ00,2016,1498,54,9,6,14,9.3,-5,85,56.7,6,79,80,53.4,4,1,76,5,0,0,1498
77893,T001038,Total male and female,GM0277,Rozendaal,2017JJ00,2017,1498,54,8,5.2,17,11.1,-9,220,143.2,12,208,134,87.2,13,0,121,86,77,51.4,1575
77894,T001038,Total male and female,GM0277,Rozendaal,2018JJ00,2018,1575,56,16,9.9,18,11.1,-2,159,98.5,16,143,78,48.3,8,0,70,81,79,50.2,1654
77895,T001038,Total male and female,GM0277,Rozendaal,2019JJ00,2019,1654,59,15,8.9,11,6.6,4,159,94.7,16,143,113,67.3,10,-1,103,46,50,30.2,1704
77896,T001038,Total male and female,GM0277,Rozendaal,2020JJ00,2020,1704,61,9,5.2,14,8.2,-5,118,68.8,8,110,91,53.1,5,0,86,27,22,12.9,1726
77897,T001038,Total male and female,GM0277,Rozendaal,2021JJ00,2021,1726,62,12,6.9,5,2.9,7,127,72.9,11,116,104,59.7,2,0,102,23,30,17.4,1756
77898,T001038,Total male and female,GM0277,Rozendaal,2022JJ00,2022,1756,63,9,5.1,14,8,-5,132,75.2,22,110,129,73.5,3,0,126,3,-2,-1.1,1754
77899,T001038,Total male and female,GM0277,Rozendaal,2023JJ00,2023,1754,63,13,7.3,12,6.7,1,191,106.6,65,126,115,64.2,14,-4,101,76,77,43.9,1831
77970,T001038,Total male and female,GM0840,Rucphen,2012JJ00,2012,22320,347,166,7.4,226,10.1,-60,616,27.6,101,515,612,27.5,70,1,542,4,-52,-2.3,22268
77971,T001038,Total male and female,GM0840,Rucphen,2013JJ00,2013,22268,346,174,7.8,212,9.5,-38,700,31.5,111,589,750,33.7,94,-25,656,-50,-88,-4,22180
77972,T001038,Total male and female,GM0840,Rucphen,2014JJ00,2014,22180,344,159,7.2,242,10.9,-83,833,37.5,129,704,697,31.4,110,-12,587,136,53,2.4,22233
77973,T001038,Total male and female,GM0840,Rucphen,2015JJ00,2015,22233,345,151,6.8,262,11.8,-111,915,41.1,154,761,761,34.2,128,-6,633,154,43,1.9,22276
77974,T001038,Total male and female,GM0840,Rucphen,2016JJ00,2016,22276,346,176,7.9,289,13,-113,1038,46.5,153,885,860,38.5,128,-1,732,178,69,3.1,22345
77975,T001038,Total male and female,GM0840,Rucphen,2017JJ00,2017,22345,347,189,8.4,276,12.3,-87,1067,47.7,188,879,927,41.4,161,-11,766,140,56,2.5,22401
77976,T001038,Total male and female,GM0840,Rucphen,2018JJ00,2018,22401,348,182,8.1,261,11.6,-79,1198,53.3,195,1003,946,42.1,161,-19,785,252,171,7.6,22572
77977,T001038,Total male and female,GM0840,Rucphen,2019JJ00,2019,22572,350,169,7.4,250,11,-81,1366,60.1,297,1069,981,43.2,237,-14,744,385,306,13.6,22878
77978,T001038,Total male and female,GM0840,Rucphen,2020JJ00,2020,22878,355,206,9,276,12,-70,1342,58.4,257,1085,1074,46.7,220,-16,854,268,202,8.8,23080
77979,T001038,Total male and female,GM0840,Rucphen,2021JJ00,2021,23080,358,229,9.9,290,12.5,-61,1269,54.7,260,1009,960,41.4,223,-32,737,309,246,10.7,23326
77980,T001038,Total male and female,GM0840,Rucphen,2022JJ00,2022,23326,362,198,8.4,308,13.1,-110,1282,54.6,319,963,863,36.8,204,-18,659,419,310,13.3,23636
77981,T001038,Total male and female,GM0840,Rucphen,2023JJ00,2023,23636,367,200,8.4,273,11.5,-73,1360,57.2,180,1180,1001,42.1,183,-12,818,359,284,12,23920
78790,T001038,Total male and female,GM0441,Schagen,2012JJ00,2012,18653,989,161,8.7,187,10,-26,661,35.5,40,621,743,39.9,64,-8,679,-82,-87,-4.7,18566
78791,T001038,Total male and female,GM0441,Schagen,2013JJ00,2013,46207,275,373,8.1,386,8.4,-13,1474,32,286,1188,1669,36.2,226,-42,1443,-195,-229,-5,45978
78792,T001038,Total male and female,GM0441,Schagen,2014JJ00,2014,45978,274,379,8.2,344,7.5,35,1792,38.9,306,1486,1671,36.3,216,-33,1455,121,159,3.5,46137
78793,T001038,Total male and female,GM0441,Schagen,2015JJ00,2015,46137,275,337,7.3,373,8.1,-36,1794,38.9,270,1524,1748,37.9,266,-41,1482,46,22,0.5,46159
78794,T001038,Total male and female,GM0441,Schagen,2016JJ00,2016,46159,275,385,8.3,425,9.2,-40,2041,44.2,377,1664,1966,42.6,203,-15,1763,75,34,0.7,46193
78795,T001038,Total male and female,GM0441,Schagen,2017JJ00,2017,46193,275,366,7.9,389,8.4,-23,2106,45.5,285,1821,1897,41,191,-29,1706,209,186,4,46379
78796,T001038,Total male and female,GM0441,Schagen,2018JJ00,2018,46379,276,351,7.6,455,9.8,-104,2155,46.4,256,1899,1877,40.4,208,-12,1669,278,174,3.8,46553
78797,T001038,Total male and female,GM0441,Schagen,2019JJ00,2019,46553,277,371,8,465,10,-94,1909,41,314,1595,1884,40.5,192,-16,1692,25,-70,-1.5,46483
78798,T001038,Total male and female,GM0441,Schagen,2020JJ00,2020,46483,276,338,7.3,469,10.1,-131,1881,40.4,212,1669,1701,36.6,173,-41,1528,180,49,1.1,46532
78799,T001038,Total male and female,GM0441,Schagen,2021JJ00,2021,46532,277,388,8.3,523,11.2,-135,2174,46.6,242,1932,1738,37.2,196,-25,1542,436,301,6.5,46833
78800,T001038,Total male and female,GM0441,Schagen,2022JJ00,2022,46833,279,364,7.7,500,10.6,-136,2582,54.8,650,1932,1830,38.8,363,-82,1467,752,617,13.2,47450
78801,T001038,Total male and female,GM0441,Schagen,2023JJ00,2023,47450,282,346,7.3,542,11.4,-196,2329,48.9,406,1923,1835,38.6,299,-69,1536,494,294,6.2,47744
79364,T001038,Total male and female,GM0458,Schermer,2012JJ00,2012,5456,89,57,10.4,26,4.7,31,291,53.1,49,242,279,50.9,21,3,258,12,45,8.2,5501
79365,T001038,Total male and female,GM0458,Schermer,2013JJ00,2013,5501,90,61,11.1,24,4.3,37,233,42.2,46,187,232,42,27,-1,205,1,38,6.9,5539
79366,T001038,Total male and female,GM0458,Schermer,2014JJ00,2014,5539,90,57,10.4,33,6,24,259,47.1,51,208,370,67.3,81,-16,289,-111,-87,-15.7,5452
79610,T001038,Total male and female,GM0279,Scherpenzeel,2012JJ00,2012,9354,678,149,15.9,59,6.3,90,293,31.2,50,243,334,35.6,17,1,317,-41,49,5.2,9403
79611,T001038,Total male and female,GM0279,Scherpenzeel,2013JJ00,2013,9403,682,126,13.3,73,7.7,53,362,38.3,40,322,320,33.9,27,-9,293,42,95,10.1,9498
79612,T001038,Total male and female,GM0279,Scherpenzeel,2014JJ00,2014,9498,689,128,13.5,69,7.3,59,342,36,40,302,377,39.6,28,-5,349,-35,24,2.5,9522
79613,T001038,Total male and female,GM0279,Scherpenzeel,2015JJ00,2015,9522,691,102,10.7,72,7.6,30,366,38.4,62,304,391,41,26,-5,365,-25,7,0.7,9529
79614,T001038,Total male and female,GM0279,Scherpenzeel,2016JJ00,2016,9529,691,132,13.7,63,6.6,69,575,59.8,73,502,469,48.8,29,4,440,106,175,18.4,9704
79615,T001038,Total male and female,GM0279,Scherpenzeel,2017JJ00,2017,9704,704,103,10.6,74,7.6,29,555,57.1,52,503,535,55,33,-4,502,20,47,4.8,9751
79616,T001038,Total male and female,GM0279,Scherpenzeel,2018JJ00,2018,9751,707,146,14.9,73,7.4,73,454,46.3,48,406,404,41.2,30,-8,374,50,122,12.5,9873
79617,T001038,Total male and female,GM0279,Scherpenzeel,2019JJ00,2019,9873,716,100,10.1,81,8.2,19,461,46.7,47,414,472,47.8,53,-6,419,-11,7,0.7,9880
79618,T001038,Total male and female,GM0279,Scherpenzeel,2020JJ00,2020,9880,716,137,13.7,92,9.2,45,633,63.3,38,595,430,43,44,-13,386,203,248,25.1,10128
79619,T001038,Total male and female,GM0279,Scherpenzeel,2021JJ00,2021,10128,734,141,13.8,94,9.2,47,561,54.9,38,523,419,41,22,-7,397,142,189,18.7,10317
79620,T001038,Total male and female,GM0279,Scherpenzeel,2022JJ00,2022,10317,748,137,13.2,92,8.9,45,460,44.4,123,337,437,42.2,65,-18,372,23,69,6.7,10386
79621,T001038,Total male and female,GM0279,Scherpenzeel,2023JJ00,2023,10386,753,127,12.3,78,7.5,49,367,35.4,39,328,459,44.3,32,-2,427,-92,-43,-4.1,10343
79692,T001038,Total male and female,GM0606,Schiedam,2012JJ00,2012,76244,4231,873,11.5,793,10.4,80,4789,62.8,1257,3532,4888,64.1,1275,-560,3613,-99,-28,-0.4,76216
79693,T001038,Total male and female,GM0606,Schiedam,2013JJ00,2013,76216,4234,830,10.9,732,9.6,98,4816,63.1,1251,3565,4674,61.2,1149,-341,3525,142,234,3.1,76450
79694,T001038,Total male and female,GM0606,Schiedam,2014JJ00,2014,76450,4247,894,11.7,677,8.8,217,5062,66,1328,3734,4856,63.3,1255,-499,3601,206,419,5.5,76869
79695,T001038,Total male and female,GM0606,Schiedam,2015JJ00,2015,76869,4271,913,11.9,733,9.5,180,5062,65.8,1315,3747,5002,65,1271,-422,3731,60,239,3.1,77108
79696,T001038,Total male and female,GM0606,Schiedam,2016JJ00,2016,77108,4281,876,11.3,747,9.6,129,5511,71.1,1368,4143,4915,63.4,997,-294,3918,596,730,9.5,77838
79697,T001038,Total male and female,GM0606,Schiedam,2017JJ00,2017,77838,4322,907,11.6,760,9.8,147,5437,69.8,1409,4028,5519,70.9,1230,-511,4289,-82,69,0.9,77907
79698,T001038,Total male and female,GM0606,Schiedam,2018JJ00,2018,77907,4372,888,11.4,789,10.1,99,5353,68.7,1480,3873,5361,68.8,912,-260,4449,-8,92,1.2,77999
79699,T001038,Total male and female,GM0606,Schiedam,2019JJ00,2019,77999,4377,850,10.8,789,10.1,61,6234,79.6,1989,4245,5557,70.9,986,-176,4571,677,731,9.4,78730
79700,T001038,Total male and female,GM0606,Schiedam,2020JJ00,2020,78730,4418,848,10.7,793,10,55,6127,77.6,1514,4613,5627,71.2,962,-136,4665,500,549,7,79279
79701,T001038,Total male and female,GM0606,Schiedam,2021JJ00,2021,79279,4449,961,12.1,822,10.3,139,6246,78.6,1638,4608,6016,75.7,1162,-372,4854,230,365,4.6,79644
79702,T001038,Total male and female,GM0606,Schiedam,2022JJ00,2022,79644,4472,902,11.3,755,9.4,147,6593,82.3,2091,4502,5751,71.8,1165,-309,4586,842,984,12.4,80628
79703,T001038,Total male and female,GM0606,Schiedam,2023JJ00,2023,80628,4527,916,11.3,750,9.2,166,6760,83.2,1961,4799,5711,70.3,969,-158,4742,1049,1210,15,81838
79774,T001038,Total male and female,GM0088,Schiermonnikoog,2012JJ00,2012,932,21,9,9.5,12,12.7,-3,71,75.1,4,67,38,40.2,-1,3,39,33,28,30,960
79775,T001038,Total male and female,GM0088,Schiermonnikoog,2013JJ00,2013,960,26,7,7.4,14,14.7,-7,59,62,4,55,71,74.7,7,-1,64,-12,-18,-18.8,942
79776,T001038,Total male and female,GM0088,Schiermonnikoog,2014JJ00,2014,942,25,4,4.3,14,15,-10,60,64.2,5,55,68,72.8,4,2,64,-8,-16,-17,926
79777,T001038,Total male and female,GM0088,Schiermonnikoog,2015JJ00,2015,926,25,5,5.4,5,5.4,0,64,69.4,7,57,71,77,4,-1,67,-7,-7,-7.6,919
79778,T001038,Total male and female,GM0088,Schiermonnikoog,2016JJ00,2016,919,25,6,6.5,7,7.5,-1,79,84.9,9,70,56,60.2,4,0,52,23,22,23.9,941
79779,T001038,Total male and female,GM0088,Schiermonnikoog,2017JJ00,2017,941,25,5,5.3,10,10.7,-5,76,81.2,4,72,80,85.4,7,1,73,-4,-9,-9.6,932
79780,T001038,Total male and female,GM0088,Schiermonnikoog,2018JJ00,2018,932,23,8,8.6,15,16.1,-7,74,79.2,13,61,63,67.5,9,2,54,11,4,4.3,936
79781,T001038,Total male and female,GM0088,Schiermonnikoog,2019JJ00,2019,936,23,7,7.4,8,8.5,-1,92,97.7,16,76,80,85,12,0,68,12,11,11.8,947
79782,T001038,Total male and female,GM0088,Schiermonnikoog,2020JJ00,2020,947,23,3,3.2,14,14.9,-11,60,63.9,6,54,65,69.2,5,1,60,-5,-16,-16.9,931
79783,T001038,Total male and female,GM0088,Schiermonnikoog,2021JJ00,2021,931,23,3,3.2,14,14.9,-11,95,101.3,15,80,71,75.7,6,0,65,24,13,14,944
79784,T001038,Total male and female,GM0088,Schiermonnikoog,2022JJ00,2022,944,22,5,5.2,7,7.3,-2,116,120.5,63,53,76,78.9,17,-3,59,40,38,40.3,982
79785,T001038,Total male and female,GM0088,Schiermonnikoog,2023JJ00,2023,982,23,4,4.1,7,7.2,-3,111,113.6,52,59,117,119.8,51,-19,66,-6,-10,-10.2,972
79856,T001038,Total male and female,GM0844,Schijndel,2012JJ00,2012,23016,554,203,8.8,177,7.6,26,914,39.5,119,795,696,30.1,75,-41,621,218,246,10.7,23262
79857,T001038,Total male and female,GM0844,Schijndel,2013JJ00,2013,23262,560,216,9.3,187,8,29,862,37,119,743,795,34.1,88,-39,707,67,98,4.2,23360
79858,T001038,Total male and female,GM0844,Schijndel,2014JJ00,2014,23360,562,242,10.3,157,6.7,85,904,38.5,108,796,805,34.3,65,-26,740,99,183,7.8,23543
79859,T001038,Total male and female,GM0844,Schijndel,2015JJ00,2015,23543,567,217,9.2,191,8.1,26,982,41.6,165,817,925,39.2,107,-47,818,57,82,3.5,23625
79860,T001038,Total male and female,GM0844,Schijndel,2016JJ00,2016,23625,569,216,9.1,180,7.6,36,910,38.4,133,777,927,39.2,105,-23,822,-17,97,4.1,23722
80020,T001038,Total male and female,GM0962,Schinnen,2012JJ00,2012,13202,549,106,8.1,113,8.6,-7,585,44.7,68,517,831,63.6,233,-182,598,-246,-252,-19.1,12950
80021,T001038,Total male and female,GM0962,Schinnen,2013JJ00,2013,12950,538,78,6,134,10.4,-56,599,46.3,47,552,594,46,62,-17,532,5,-49,-3.8,12901
80022,T001038,Total male and female,GM0962,Schinnen,2014JJ00,2014,12901,536,97,7.5,119,9.2,-22,1028,79.4,418,610,918,70.9,43,1,875,110,91,7.1,12992
80023,T001038,Total male and female,GM0962,Schinnen,2015JJ00,2015,12992,540,106,8.2,115,8.9,-9,1011,77.9,313,698,1030,79.4,86,-31,944,-19,-32,-2.5,12960
80024,T001038,Total male and female,GM0962,Schinnen,2016JJ00,2016,12960,539,90,6.9,144,11.1,-54,976,75.3,192,784,929,71.7,61,-21,868,47,-6,-0.5,12954
80025,T001038,Total male and female,GM0962,Schinnen,2017JJ00,2017,12954,538,93,7.2,137,10.6,-44,999,77.2,106,893,998,77.2,55,-19,943,1,-43,-3.3,12911
80026,T001038,Total male and female,GM0962,Schinnen,2018JJ00,2018,12911,537,84,6.5,170,13.2,-86,841,65.5,69,772,904,70.4,57,-8,847,-63,-153,-11.9,12758
80430,T001038,Total male and female,GM0608,Schoonhoven,2012JJ00,2012,11814,1884,126,10.6,93,7.9,33,469,39.6,34,435,452,38.2,29,0,423,17,50,4.2,11864
80431,T001038,Total male and female,GM0608,Schoonhoven,2013JJ00,2013,11864,1889,100,8.4,76,6.4,24,493,41.5,33,460,479,40.3,30,-6,449,14,39,3.3,11903
80432,T001038,Total male and female,GM0608,Schoonhoven,2014JJ00,2014,11903,1895,126,10.6,96,8.1,30,497,41.8,42,455,502,42.2,27,0,475,-5,-5,-0.4,11898
80676,T001038,Total male and female,GM1676,Schouwen-Duiveland,2012JJ00,2012,34151,148,265,7.8,337,9.9,-72,889,26.1,128,761,925,27.1,125,-12,800,-36,-111,-3.3,34040
80677,T001038,Total male and female,GM1676,Schouwen-Duiveland,2013JJ00,2013,34040,148,292,8.6,380,11.2,-88,923,27.2,145,778,1025,30.2,101,-7,924,-102,-188,-5.5,33852
80678,T001038,Total male and female,GM1676,Schouwen-Duiveland,2014JJ00,2014,33852,147,280,8.3,338,10,-58,1029,30.4,149,880,999,29.5,98,2,901,30,-31,-0.9,33821
80679,T001038,Total male and female,GM1676,Schouwen-Duiveland,2015JJ00,2015,33821,147,279,8.3,374,11.1,-95,1027,30.4,149,878,1019,30.2,132,-17,887,8,-86,-2.5,33735
80680,T001038,Total male and female,GM1676,Schouwen-Duiveland,2016JJ00,2016,33735,147,243,7.2,334,9.9,-91,1113,33,162,951,992,29.4,100,-15,892,121,30,0.9,33765
80681,T001038,Total male and female,GM1676,Schouwen-Duiveland,2017JJ00,2017,33765,147,284,8.4,395,11.7,-111,1194,35.4,123,1071,1152,34.2,121,-8,1031,42,-78,-2.3,33687
80682,T001038,Total male and female,GM1676,Schouwen-Duiveland,2018JJ00,2018,33687,147,276,8.2,372,11,-96,1225,36.3,152,1073,1036,30.7,93,4,943,189,92,2.7,33779
80683,T001038,Total male and female,GM1676,Schouwen-Duiveland,2019JJ00,2019,33779,147,308,9.1,391,11.6,-83,1181,34.9,152,1029,1042,30.8,110,-6,932,139,60,1.8,33839
80684,T001038,Total male and female,GM1676,Schouwen-Duiveland,2020JJ00,2020,33839,147,264,7.8,392,11.5,-128,1403,41.3,142,1261,1051,31,114,-37,937,352,226,6.7,34065
80685,T001038,Total male and female,GM1676,Schouwen-Duiveland,2021JJ00,2021,34065,148,308,9,495,14.5,-187,1210,35.5,141,1069,936,27.4,107,-12,829,274,87,2.6,34152
80686,T001038,Total male and female,GM1676,Schouwen-Duiveland,2022JJ00,2022,34152,149,286,8.3,415,12.1,-129,1614,47,486,1128,1079,31.4,177,-13,902,535,409,12,34561
80687,T001038,Total male and female,GM1676,Schouwen-Duiveland,2023JJ00,2023,34561,151,301,8.7,421,12.2,-120,1323,38.2,287,1036,1134,32.8,167,11,967,189,70,2,34631
81086,T001038,Total male and female,GM0965,Simpelveld,2012JJ00,2012,10914,681,69,6.3,104,9.5,-35,541,49.6,48,493,496,45.4,58,-8,438,45,6,0.5,10920
81087,T001038,Total male and female,GM0965,Simpelveld,2013JJ00,2013,10920,682,74,6.8,128,11.8,-54,407,37.4,38,369,430,39.5,61,-2,369,-23,-76,-7,10844
81088,T001038,Total male and female,GM0965,Simpelveld,2014JJ00,2014,10844,677,78,7.2,111,10.2,-33,451,41.6,47,404,417,38.5,41,1,376,34,0,0,10844
81089,T001038,Total male and female,GM0965,Simpelveld,2015JJ00,2015,10844,676,80,7.4,117,10.8,-37,454,42.1,40,414,520,48.2,51,-5,469,-66,-103,-9.5,10741
81090,T001038,Total male and female,GM0965,Simpelveld,2016JJ00,2016,10741,670,79,7.4,109,10.2,-30,471,44.2,42,429,611,57.3,28,2,583,-140,-170,-15.8,10571
81091,T001038,Total male and female,GM0965,Simpelveld,2017JJ00,2017,10571,659,78,7.4,95,9,-17,545,51.6,39,506,538,50.9,44,-4,494,7,-10,-0.9,10561
81092,T001038,Total male and female,GM0965,Simpelveld,2018JJ00,2018,10561,659,94,8.9,101,9.6,-7,545,51.7,54,491,582,55.2,55,-1,527,-37,-45,-4.3,10516
81093,T001038,Total male and female,GM0965,Simpelveld,2019JJ00,2019,10516,656,81,7.7,79,7.5,2,573,54.4,57,516,536,50.9,44,-4,492,37,39,3.7,10555
81094,T001038,Total male and female,GM0965,Simpelveld,2020JJ00,2020,10555,658,76,7.2,92,8.7,-16,556,52.9,58,498,618,58.8,56,-13,562,-62,-78,-7.4,10477
81095,T001038,Total male and female,GM0965,Simpelveld,2021JJ00,2021,10477,654,70,6.7,123,11.8,-53,557,53.3,64,493,558,53.4,37,-2,521,-1,-52,-5,10425
81096,T001038,Total male and female,GM0965,Simpelveld,2022JJ00,2022,10425,650,75,7.2,114,11,-39,552,53,117,435,542,52.1,72,-15,470,10,-29,-2.8,10396
81097,T001038,Total male and female,GM0965,Simpelveld,2023JJ00,2023,10396,649,72,7,102,9.9,-30,460,44.5,67,393,572,55.4,75,-20,497,-112,-141,-13.6,10255
81168,T001038,Total male and female,GM1702,Sint Anthonis,2012JJ00,2012,11803,119,81,6.9,91,7.7,-10,379,32.2,34,345,412,35,27,3,385,-33,-43,-3.6,11760
81169,T001038,Total male and female,GM1702,Sint Anthonis,2013JJ00,2013,11760,118,110,9.4,88,7.5,22,391,33.3,46,345,486,41.4,43,-4,443,-95,-69,-5.9,11691
81170,T001038,Total male and female,GM1702,Sint Anthonis,2014JJ00,2014,11691,118,85,7.3,88,7.6,-3,401,34.4,29,372,477,40.9,44,-6,433,-76,-79,-6.8,11612
81171,T001038,Total male and female,GM1702,Sint Anthonis,2015JJ00,2015,11612,117,99,8.5,92,7.9,7,410,35.3,32,378,436,37.6,20,0,416,-26,-18,-1.6,11594
81172,T001038,Total male and female,GM1702,Sint Anthonis,2016JJ00,2016,11594,117,96,8.3,82,7.1,14,451,38.9,39,412,461,39.8,27,-3,434,-10,0,0,11594
81173,T001038,Total male and female,GM1702,Sint Anthonis,2017JJ00,2017,11594,117,110,9.5,128,11,-18,514,44.4,44,470,513,44.3,23,-3,490,1,-17,-1.5,11577
81174,T001038,Total male and female,GM1702,Sint Anthonis,2018JJ00,2018,11577,117,105,9.1,100,8.6,5,497,42.9,51,446,472,40.7,33,0,439,25,29,2.5,11606
81175,T001038,Total male and female,GM1702,Sint Anthonis,2019JJ00,2019,11606,117,124,10.7,105,9,19,557,47.9,73,484,517,44.4,37,-11,480,40,58,5,11664
81176,T001038,Total male and female,GM1702,Sint Anthonis,2020JJ00,2020,11664,117,90,7.7,115,9.8,-25,559,47.9,22,537,508,43.5,42,0,466,51,27,2.3,11691
81177,T001038,Total male and female,GM1702,Sint Anthonis,2021JJ00,2021,11691,118,94,8,119,10.1,-25,618,52.6,47,571,491,41.8,20,-1,471,127,99,8.5,11790
81988,T001038,Total male and female,GM0845,Sint-Michielsgestel,2012JJ00,2012,28128,481,224,8,236,8.4,-12,1008,35.9,113,895,1085,38.6,95,-22,990,-77,-88,-3.1,28040
81989,T001038,Total male and female,GM0845,Sint-Michielsgestel,2013JJ00,2013,28040,480,192,6.8,232,8.3,-40,1152,41,104,1048,1029,36.6,85,-18,944,123,81,2.9,28121
81990,T001038,Total male and female,GM0845,Sint-Michielsgestel,2014JJ00,2014,28121,481,248,8.8,259,9.2,-11,1406,49.8,130,1276,1121,39.7,87,-9,1034,285,274,9.7,28395
81991,T001038,Total male and female,GM0845,Sint-Michielsgestel,2015JJ00,2015,28395,486,221,7.8,286,10.1,-65,1328,46.8,97,1231,1257,44.3,120,-8,1137,71,8,0.3,28403
81992,T001038,Total male and female,GM0845,Sint-Michielsgestel,2016JJ00,2016,28403,486,228,8,258,9.1,-30,1397,49,143,1254,1185,41.6,82,-12,1103,212,181,6.4,28584
81993,T001038,Total male and female,GM0845,Sint-Michielsgestel,2017JJ00,2017,28584,489,233,8.1,315,11,-82,1554,54.3,91,1463,1383,48.3,116,-28,1267,171,89,3.1,28673
81994,T001038,Total male and female,GM0845,Sint-Michielsgestel,2018JJ00,2018,28673,491,243,8.4,280,9.7,-37,1524,52.9,132,1392,1170,40.6,85,-9,1085,354,318,11.1,28991
81995,T001038,Total male and female,GM0845,Sint-Michielsgestel,2019JJ00,2019,28991,497,273,9.4,279,9.6,-6,1409,48.4,153,1256,1185,40.7,82,-10,1103,224,217,7.5,29208
81996,T001038,Total male and female,GM0845,Sint-Michielsgestel,2020JJ00,2020,29208,500,263,9,288,9.8,-25,1583,53.9,118,1465,1268,43.2,69,-15,1199,315,290,9.9,29498
81997,T001038,Total male and female,GM0845,Sint-Michielsgestel,2021JJ00,2021,29498,505,259,8.7,298,10.1,-39,1508,50.9,120,1388,1240,41.9,81,-25,1159,268,233,7.9,29731
81998,T001038,Total male and female,GM0845,Sint-Michielsgestel,2022JJ00,2022,29731,510,288,9.6,270,9,18,1649,55.1,250,1399,1263,42.2,125,-19,1138,386,404,13.6,30135
81999,T001038,Total male and female,GM0845,Sint-Michielsgestel,2023JJ00,2023,30135,516,266,8.8,297,9.9,-31,1344,44.6,128,1216,1354,45,104,-16,1250,-10,-41,-1.4,30094
82070,T001038,Total male and female,GM0846,Sint-Oedenrode,2012JJ00,2012,17910,278,170,9.5,157,8.8,13,544,30.4,95,449,545,30.4,32,6,513,-1,11,0.6,17921
82071,T001038,Total male and female,GM0846,Sint-Oedenrode,2013JJ00,2013,17921,278,172,9.6,152,8.5,20,557,31.1,101,456,564,31.5,82,-13,482,-7,13,0.7,17934
82072,T001038,Total male and female,GM0846,Sint-Oedenrode,2014JJ00,2014,17934,278,156,8.7,146,8.1,10,637,35.5,135,502,645,36,62,-2,583,-8,3,0.2,17937
82073,T001038,Total male and female,GM0846,Sint-Oedenrode,2015JJ00,2015,17937,278,154,8.6,146,8.1,8,612,34.2,65,547,660,36.8,78,-24,582,-48,-41,-2.3,17896
82074,T001038,Total male and female,GM0846,Sint-Oedenrode,2016JJ00,2016,17896,278,147,8.2,172,9.6,-25,724,40.5,126,598,678,37.9,102,-16,576,46,-4,-0.2,17892
82234,T001038,Total male and female,GM1883,Sittard-Geleen,2012JJ00,2012,94535,1196,770,8.2,1100,11.7,-330,3475,36.9,629,2846,3654,38.8,544,99,3110,-179,-511,-5.4,94024
82235,T001038,Total male and female,GM1883,Sittard-Geleen,2013JJ00,2013,94024,1190,756,8.1,1043,11.1,-287,3358,35.8,589,2769,3396,36.2,445,92,2951,-38,-333,-3.5,93691
82236,T001038,Total male and female,GM1883,Sittard-Geleen,2014JJ00,2014,93691,1186,741,7.9,988,10.5,-247,3711,39.6,556,3155,3419,36.5,485,-14,2934,292,33,0.4,93724
82237,T001038,Total male and female,GM1883,Sittard-Geleen,2015JJ00,2015,93724,1185,710,7.6,1057,11.3,-347,3888,41.5,590,3298,3702,39.5,527,34,3175,186,-169,-1.8,93555
82238,T001038,Total male and female,GM1883,Sittard-Geleen,2016JJ00,2016,93555,1184,710,7.6,1083,11.6,-373,3934,42.1,571,3363,3795,40.6,553,-28,3242,139,-236,-2.5,93319
82239,T001038,Total male and female,GM1883,Sittard-Geleen,2017JJ00,2017,93319,1181,711,7.6,1064,11.4,-353,4004,43,645,3359,4011,43.1,750,-172,3261,-7,-363,-3.9,92956
82240,T001038,Total male and female,GM1883,Sittard-Geleen,2018JJ00,2018,92956,1177,736,7.9,1050,11.3,-314,3914,42.2,690,3224,3893,41.9,606,-55,3287,21,-295,-3.2,92661
82241,T001038,Total male and female,GM1883,Sittard-Geleen,2019JJ00,2019,92661,1173,733,7.9,1175,12.7,-442,4070,44,815,3255,3867,41.8,597,2,3270,203,-232,-2.5,92429
82242,T001038,Total male and female,GM1883,Sittard-Geleen,2020JJ00,2020,92429,1170,668,7.3,1297,14.1,-629,3997,43.4,671,3326,4049,44,480,-11,3569,-52,-686,-7.4,91743
82243,T001038,Total male and female,GM1883,Sittard-Geleen,2021JJ00,2021,91743,1161,777,8.5,1273,13.9,-496,4291,46.8,706,3585,3818,41.6,618,-39,3200,473,-24,-0.3,91719
82244,T001038,Total male and female,GM1883,Sittard-Geleen,2022JJ00,2022,91719,1167,767,8.3,1110,12.1,-343,4649,50.5,1308,3341,3789,41.2,617,-22,3172,860,515,5.6,92234
82245,T001038,Total male and female,GM1883,Sittard-Geleen,2023JJ00,2023,92234,1173,728,7.9,1221,13.2,-493,4897,53,1077,3820,3988,43.1,645,-69,3343,909,416,4.5,92650
82316,T001038,Total male and female,GM0051,Skarsterlân,2012JJ00,2012,27520,149,264,9.6,222,8.1,42,826,30.1,92,734,969,35.3,83,-26,886,-143,-101,-3.7,27419
82317,T001038,Total male and female,GM0051,Skarsterlân,2013JJ00,2013,27419,148,268,9.8,233,8.5,35,888,32.3,87,801,897,32.7,58,1,839,-9,82,3,27501
82562,T001038,Total male and female,GM0610,Sliedrecht,2012JJ00,2012,24232,1889,276,11.4,243,10,33,989,40.7,83,906,867,35.7,79,-13,788,122,157,6.5,24389
82563,T001038,Total male and female,GM0610,Sliedrecht,2013JJ00,2013,24389,1901,312,12.8,266,10.9,46,926,37.9,87,839,834,34.1,97,-15,737,92,139,5.7,24528
82564,T001038,Total male and female,GM0610,Sliedrecht,2014JJ00,2014,24528,1912,307,12.5,230,9.3,77,922,37.4,115,807,770,31.2,103,-14,667,152,230,9.4,24758
82565,T001038,Total male and female,GM0610,Sliedrecht,2015JJ00,2015,24758,1930,303,12.2,260,10.5,43,1064,42.8,124,940,897,36.1,171,-60,726,167,210,8.5,24968
82566,T001038,Total male and female,GM0610,Sliedrecht,2016JJ00,2016,24968,1946,299,12,296,11.8,3,1095,43.8,100,995,1058,42.3,111,-27,947,37,44,1.8,25012
82567,T001038,Total male and female,GM0610,Sliedrecht,2017JJ00,2017,25012,1949,332,13.3,281,11.2,51,1029,41.1,95,934,1072,42.9,95,-11,977,-43,8,0.3,25020
82568,T001038,Total male and female,GM0610,Sliedrecht,2018JJ00,2018,25020,1949,278,11.1,296,11.8,-18,1136,45.4,96,1040,1112,44.4,90,-20,1022,24,6,0.2,25026
82569,T001038,Total male and female,GM0610,Sliedrecht,2019JJ00,2019,25026,1949,295,11.7,252,10,43,1118,44.5,104,1014,963,38.3,65,2,898,155,194,7.8,25220
82570,T001038,Total male and female,GM0610,Sliedrecht,2020JJ00,2020,25220,1964,280,11,337,13.3,-57,1458,57.4,104,1354,1026,40.4,56,-15,970,432,377,14.9,25597
82571,T001038,Total male and female,GM0610,Sliedrecht,2021JJ00,2021,25597,1994,322,12.5,326,12.7,-4,1340,52,87,1253,1036,40.2,60,-10,976,304,300,11.7,25897
82572,T001038,Total male and female,GM0610,Sliedrecht,2022JJ00,2022,25897,2015,305,11.7,288,11.1,17,1293,49.7,359,934,1020,39.2,108,-16,912,273,287,11.1,26184
82573,T001038,Total male and female,GM0610,Sliedrecht,2023JJ00,2023,26184,2038,311,11.9,293,11.2,18,1222,46.6,128,1094,1165,44.4,119,-30,1046,57,77,2.9,26261
82644,T001038,Total male and female,GM0040,Slochteren,2012JJ00,2012,15536,103,149,9.6,131,8.4,18,672,43.1,48,624,603,38.7,32,-3,571,69,86,5.5,15622
82645,T001038,Total male and female,GM0040,Slochteren,2013JJ00,2013,15622,104,132,8.5,131,8.4,1,543,34.8,29,514,617,39.6,37,0,580,-74,-74,-4.7,15548
82646,T001038,Total male and female,GM0040,Slochteren,2014JJ00,2014,15548,103,148,9.5,112,7.2,36,643,41.3,35,608,644,41.4,33,-1,611,-1,35,2.3,15583
82647,T001038,Total male and female,GM0040,Slochteren,2015JJ00,2015,15583,103,155,9.9,139,8.9,16,829,53,42,787,730,46.7,51,-10,679,99,115,7.4,15698
82648,T001038,Total male and female,GM0040,Slochteren,2016JJ00,2016,15698,104,156,9.9,126,8,30,925,58.8,49,876,882,56.1,31,-3,851,43,72,4.6,15770
82649,T001038,Total male and female,GM0040,Slochteren,2017JJ00,2017,14737,110,123,8.3,126,8.5,-3,800,54.2,32,768,750,50.8,8,4,742,50,45,3.1,14782
82808,T001038,Total male and female,GM1714,Sluis,2012JJ00,2012,23892,85,178,7.5,313,13.1,-135,874,36.6,379,495,744,31.1,199,-43,545,130,-6,-0.3,23886
82809,T001038,Total male and female,GM1714,Sluis,2013JJ00,2013,23886,85,190,8,294,12.3,-104,834,35,314,520,789,33.1,234,-49,555,45,-66,-2.8,23820
82810,T001038,Total male and female,GM1714,Sluis,2014JJ00,2014,23820,85,199,8.4,295,12.4,-96,827,34.8,350,477,811,34.1,287,-65,524,16,-73,-3.1,23747
82811,T001038,Total male and female,GM1714,Sluis,2015JJ00,2015,23747,85,185,7.8,315,13.3,-130,797,33.6,300,497,776,32.8,217,-22,559,21,-108,-4.5,23639
82812,T001038,Total male and female,GM1714,Sluis,2016JJ00,2016,23639,85,151,6.4,270,11.4,-119,939,39.7,379,560,801,33.9,239,-26,562,138,19,0.8,23658
82813,T001038,Total male and female,GM1714,Sluis,2017JJ00,2017,23658,85,187,7.9,316,13.4,-129,821,34.8,317,504,822,34.8,238,-40,584,-1,-132,-5.6,23526
82814,T001038,Total male and female,GM1714,Sluis,2018JJ00,2018,23526,84,153,6.5,279,11.9,-126,813,34.7,325,488,834,35.6,277,-15,557,-21,-140,-6,23386
82815,T001038,Total male and female,GM1714,Sluis,2019JJ00,2019,23386,84,162,7,299,12.8,-137,809,34.7,344,465,848,36.4,282,-35,566,-39,-176,-7.5,23210
82816,T001038,Total male and female,GM1714,Sluis,2020JJ00,2020,23210,83,165,7.1,317,13.7,-152,962,41.5,374,588,849,36.6,278,-21,571,113,-44,-1.9,23166
82817,T001038,Total male and female,GM1714,Sluis,2021JJ00,2021,23166,83,176,7.6,314,13.6,-138,934,40.3,332,602,819,35.4,280,-45,539,115,-25,-1.1,23141
82818,T001038,Total male and female,GM1714,Sluis,2022JJ00,2022,23141,83,181,7.8,300,12.9,-119,1116,48.1,548,568,890,38.4,338,-59,552,226,102,4.4,23243
82819,T001038,Total male and female,GM1714,Sluis,2023JJ00,2023,23243,83,176,7.6,325,14,-149,1012,43.6,488,524,957,41.3,344,-58,613,55,-93,-4,23150
83054,T001038,Total male and female,GM0090,Smallingerland,2012JJ00,2012,55456,469,568,10.2,468,8.4,100,2152,38.8,345,1807,2259,40.7,210,-45,2049,-107,-2,0,55454
83055,T001038,Total male and female,GM0090,Smallingerland,2013JJ00,2013,55454,471,574,10.3,467,8.4,107,2231,40.2,405,1826,2321,41.8,149,0,2172,-90,13,0.2,55467
83056,T001038,Total male and female,GM0090,Smallingerland,2014JJ00,2014,55467,471,552,9.9,466,8.4,86,2678,48.2,617,2061,2604,46.9,198,-42,2406,74,168,3,55635
83057,T001038,Total male and female,GM0090,Smallingerland,2015JJ00,2015,55635,473,555,10,466,8.4,89,2429,43.7,460,1969,2715,48.9,162,-23,2553,-286,-196,-3.5,55439
83058,T001038,Total male and female,GM0090,Smallingerland,2016JJ00,2016,55439,471,524,9.4,521,9.4,3,2736,49.2,365,2371,2484,44.7,175,-39,2309,252,256,4.6,55695
83059,T001038,Total male and female,GM0090,Smallingerland,2017JJ00,2017,55695,473,552,9.9,523,9.4,29,2678,48,236,2442,2511,45,140,-27,2371,167,194,3.5,55889
83060,T001038,Total male and female,GM0090,Smallingerland,2018JJ00,2018,55889,476,520,9.3,483,8.6,37,2546,45.5,263,2283,2537,45.4,171,-33,2366,9,49,0.9,55938
83061,T001038,Total male and female,GM0090,Smallingerland,2019JJ00,2019,55938,477,509,9.1,525,9.4,-16,2604,46.5,433,2171,2379,42.4,147,-16,2232,225,212,3.8,56150
83062,T001038,Total male and female,GM0090,Smallingerland,2020JJ00,2020,56150,479,525,9.4,518,9.2,7,2374,42.3,267,2107,2491,44.4,133,-43,2358,-117,-110,-2,56040
83063,T001038,Total male and female,GM0090,Smallingerland,2021JJ00,2021,56040,478,566,10.1,554,9.9,12,2374,42.4,126,2248,2530,45.2,198,-116,2332,-156,-145,-2.6,55895
83064,T001038,Total male and female,GM0090,Smallingerland,2022JJ00,2022,55895,477,469,8.4,557,9.9,-88,2762,49.3,452,2310,2465,44,197,-41,2268,297,203,3.6,56098
83065,T001038,Total male and female,GM0090,Smallingerland,2023JJ00,2023,56098,479,490,8.7,572,10.1,-82,3139,55.7,549,2590,2491,44.2,230,-54,2261,648,563,10,56661
83382,T001038,Total male and female,GM0342,Soest,2012JJ00,2012,45612,986,409,9,417,9.2,-8,1832,40.2,246,1586,1926,42.3,211,-35,1715,-94,-104,-2.3,45508
83383,T001038,Total male and female,GM0342,Soest,2013JJ00,2013,45508,984,372,8.2,417,9.2,-45,1991,43.8,238,1753,1961,43.1,271,-34,1690,30,-15,-0.3,45493
83384,T001038,Total male and female,GM0342,Soest,2014JJ00,2014,45493,984,408,9,467,10.3,-59,2103,46.2,210,1893,2085,45.9,248,-14,1837,18,-39,-0.9,45454
83385,T001038,Total male and female,GM0342,Soest,2015JJ00,2015,45454,983,367,8.1,430,9.5,-63,2323,51.1,228,2095,2225,48.9,237,-46,1988,98,33,0.7,45487
83386,T001038,Total male and female,GM0342,Soest,2016JJ00,2016,45487,984,412,9,454,9.9,-42,2705,59.2,233,2472,2277,49.8,208,-21,2069,428,387,8.5,45874
83387,T001038,Total male and female,GM0342,Soest,2017JJ00,2017,45874,992,413,9,442,9.6,-29,2671,58.1,272,2399,2425,52.7,241,-19,2184,246,215,4.7,46089
83388,T001038,Total male and female,GM0342,Soest,2018JJ00,2018,46089,997,406,8.8,455,9.9,-49,2619,56.8,336,2283,2466,53.4,238,-12,2228,153,105,2.3,46194
83389,T001038,Total male and female,GM0342,Soest,2019JJ00,2019,46194,999,406,8.8,424,9.1,-18,2911,62.7,352,2559,2481,53.5,225,-27,2256,430,412,8.9,46606
83390,T001038,Total male and female,GM0342,Soest,2020JJ00,2020,46606,1008,416,8.9,490,10.5,-74,2926,62.6,285,2641,2553,54.6,202,-6,2351,373,300,6.4,46906
83391,T001038,Total male and female,GM0342,Soest,2021JJ00,2021,46906,1014,434,9.2,480,10.2,-46,2886,61.4,310,2576,2636,56.1,222,-20,2414,250,207,4.4,47113
83392,T001038,Total male and female,GM0342,Soest,2022JJ00,2022,47113,1019,428,9.1,517,10.9,-89,2821,59.7,450,2371,2407,50.9,207,-7,2200,414,326,6.9,47439
83393,T001038,Total male and female,GM0342,Soest,2023JJ00,2023,47439,1026,423,8.9,493,10.4,-70,2901,61,406,2495,2589,54.4,279,-13,2310,312,243,5.1,47682
83464,T001038,Total male and female,GM0847,Someren,2012JJ00,2012,18580,231,147,7.9,151,8.1,-4,619,33.3,178,441,570,30.6,76,-1,494,49,48,2.6,18628
83465,T001038,Total male and female,GM0847,Someren,2013JJ00,2013,18628,232,170,9.1,139,7.4,31,692,37.1,139,553,661,35.4,142,-39,519,31,62,3.3,18690
83466,T001038,Total male and female,GM0847,Someren,2014JJ00,2014,18690,233,167,8.9,148,7.9,19,723,38.7,204,519,739,39.5,160,-23,579,-16,5,0.3,18695
83467,T001038,Total male and female,GM0847,Someren,2015JJ00,2015,18695,233,211,11.2,169,9,42,877,46.6,248,629,699,37.2,166,-51,533,178,219,11.7,18914
83468,T001038,Total male and female,GM0847,Someren,2016JJ00,2016,18914,236,184,9.7,151,8,33,870,45.8,216,654,782,41.2,200,-38,582,88,122,6.5,19036
83469,T001038,Total male and female,GM0847,Someren,2017JJ00,2017,19036,237,187,9.8,180,9.4,7,943,49.4,226,717,866,45.4,220,-69,646,77,84,4.4,19120
83470,T001038,Total male and female,GM0847,Someren,2018JJ00,2018,19120,238,206,10.7,161,8.4,45,977,50.8,288,689,818,42.6,178,-27,640,159,202,10.6,19322
83471,T001038,Total male and female,GM0847,Someren,2019JJ00,2019,19322,241,184,9.5,157,8.1,27,812,42,209,603,791,40.9,184,-55,607,21,46,2.4,19368
83472,T001038,Total male and female,GM0847,Someren,2020JJ00,2020,19368,241,207,10.7,226,11.7,-19,889,45.8,225,664,811,41.8,142,-28,669,78,60,3.1,19428
83473,T001038,Total male and female,GM0847,Someren,2021JJ00,2021,19428,242,214,10.9,181,9.3,33,1065,54.4,207,858,825,42.2,180,-28,645,240,273,14.1,19701
83474,T001038,Total male and female,GM0847,Someren,2022JJ00,2022,19701,246,229,11.5,188,9.5,41,1067,53.7,299,768,748,37.6,169,-49,579,319,360,18.3,20061
83475,T001038,Total male and female,GM0847,Someren,2023JJ00,2023,20061,250,222,11,176,8.7,46,887,44.1,184,703,806,40.1,175,-45,631,81,127,6.3,20188
83628,T001038,Total male and female,GM0848,Son en Breugel,2012JJ00,2012,15822,610,146,9.1,139,8.7,7,835,52.3,59,776,528,33,52,-7,476,307,316,20,16138
83629,T001038,Total male and female,GM0848,Son en Breugel,2013JJ00,2013,16138,622,155,9.6,137,8.5,18,675,41.7,79,596,594,36.7,77,-2,517,81,97,6,16235
83630,T001038,Total male and female,GM0848,Son en Breugel,2014JJ00,2014,16235,626,159,9.8,137,8.4,22,738,45.3,82,656,651,40,73,-12,578,87,109,6.7,16344
83631,T001038,Total male and female,GM0848,Son en Breugel,2015JJ00,2015,16344,630,155,9.5,142,8.7,13,715,43.6,71,644,647,39.5,68,-7,579,68,81,5,16425
83632,T001038,Total male and female,GM0848,Son en Breugel,2016JJ00,2016,16425,633,149,9,162,9.8,-13,917,55.5,72,845,704,42.6,72,-5,632,213,201,12.2,16626
83633,T001038,Total male and female,GM0848,Son en Breugel,2017JJ00,2017,16626,641,163,9.8,165,9.9,-2,915,54.8,66,849,786,47.1,54,-4,732,129,127,7.6,16753
83634,T001038,Total male and female,GM0848,Son en Breugel,2018JJ00,2018,16753,646,124,7.4,160,9.5,-36,975,57.9,84,891,789,46.9,63,-5,726,186,151,9,16904
83635,T001038,Total male and female,GM0848,Son en Breugel,2019JJ00,2019,16904,651,160,9.3,170,9.9,-10,1097,64.1,143,954,669,39.1,61,-11,608,428,418,24.7,17322
83636,T001038,Total male and female,GM0848,Son en Breugel,2020JJ00,2020,17322,668,188,10.8,201,11.5,-13,1033,59.2,79,954,790,45.3,61,-15,729,243,230,13.3,17552
83637,T001038,Total male and female,GM0848,Son en Breugel,2021JJ00,2021,17552,676,176,10,172,9.7,4,1028,58.2,100,928,809,45.8,64,-7,745,219,223,12.7,17775
83638,T001038,Total male and female,GM0848,Son en Breugel,2022JJ00,2022,17775,685,167,9.3,190,10.6,-23,1034,57.8,201,833,776,43.4,89,-7,687,258,235,13.2,18010
83639,T001038,Total male and female,GM0848,Son en Breugel,2023JJ00,2023,18010,694,179,10,214,11.9,-35,806,44.8,107,699,821,45.7,108,-21,713,-15,-51,-2.8,17959
83874,T001038,Total male and female,GM0612,Spijkenisse,2012JJ00,2012,72171,2763,740,10.2,490,6.8,250,2731,37.8,267,2464,2779,38.5,424,-174,2355,-48,204,2.8,72375
83875,T001038,Total male and female,GM0612,Spijkenisse,2013JJ00,2013,72375,2773,671,9.3,513,7.1,158,2690,37.1,283,2407,2671,36.9,377,-139,2294,19,186,2.6,72561
83876,T001038,Total male and female,GM0612,Spijkenisse,2014JJ00,2014,72561,2780,739,10.2,494,6.8,245,2617,36,295,2322,2654,36.5,300,-28,2354,-37,179,2.5,72740
84284,T001038,Total male and female,GM0037,Stadskanaal,2012JJ00,2012,32998,280,315,9.6,388,11.8,-73,1366,41.5,178,1188,1403,42.6,60,24,1343,-37,-113,-3.4,32885
84285,T001038,Total male and female,GM0037,Stadskanaal,2013JJ00,2013,32885,280,281,8.6,370,11.3,-89,1454,44.3,404,1050,1439,43.8,83,6,1356,15,-82,-2.5,32803
84286,T001038,Total male and female,GM0037,Stadskanaal,2014JJ00,2014,32803,279,309,9.4,372,11.4,-63,1560,47.7,521,1039,1668,51,102,-5,1566,-108,-193,-5.9,32610
84287,T001038,Total male and female,GM0037,Stadskanaal,2015JJ00,2015,32610,277,300,9.2,400,12.3,-100,2171,66.6,886,1285,2031,62.3,138,-17,1893,140,11,0.3,32621
84288,T001038,Total male and female,GM0037,Stadskanaal,2016JJ00,2016,32621,277,327,10.1,409,12.6,-82,1858,57.3,392,1466,2119,65.3,101,-25,2018,-261,-369,-11.3,32252
84289,T001038,Total male and female,GM0037,Stadskanaal,2017JJ00,2017,32252,274,259,8,399,12.4,-140,1889,58.6,194,1695,1734,53.8,153,-100,1581,155,6,0.2,32258
84290,T001038,Total male and female,GM0037,Stadskanaal,2018JJ00,2018,32258,274,236,7.4,429,13.4,-193,1513,47.2,128,1385,1798,56.1,179,-74,1619,-285,-469,-14.5,31789
84291,T001038,Total male and female,GM0037,Stadskanaal,2019JJ00,2019,31789,270,255,8,427,13.5,-172,1487,46.9,104,1383,1412,44.5,110,-39,1302,75,-103,-3.2,31686
84292,T001038,Total male and female,GM0037,Stadskanaal,2020JJ00,2020,31686,269,246,7.8,440,13.9,-194,1663,52.4,84,1579,1401,44.2,59,-18,1342,262,68,2.1,31754
84293,T001038,Total male and female,GM0037,Stadskanaal,2021JJ00,2021,31754,270,237,7.5,435,13.7,-198,1957,61.5,63,1894,1668,52.4,44,4,1624,289,97,3.1,31851
84294,T001038,Total male and female,GM0037,Stadskanaal,2022JJ00,2022,31851,271,278,8.7,467,14.6,-189,2236,69.9,451,1785,1763,55.1,111,-15,1652,473,284,8.9,32135
84295,T001038,Total male and female,GM0037,Stadskanaal,2023JJ00,2023,32135,273,217,6.8,478,14.9,-261,1911,59.6,308,1603,1772,55.2,199,-44,1573,139,-122,-3.8,32013
84530,T001038,Total male and female,GM0180,Staphorst,2012JJ00,2012,16224,121,231,14.2,88,5.4,143,444,27.3,37,407,537,33,37,-1,500,-93,51,3.1,16275
84531,T001038,Total male and female,GM0180,Staphorst,2013JJ00,2013,16275,121,224,13.7,98,6,126,486,29.8,43,443,519,31.8,44,-13,475,-33,92,5.7,16367
84532,T001038,Total male and female,GM0180,Staphorst,2014JJ00,2014,16367,122,243,14.8,106,6.5,137,460,28.1,49,411,540,32.9,45,-11,495,-80,54,3.3,16421
84533,T001038,Total male and female,GM0180,Staphorst,2015JJ00,2015,16421,122,251,15.2,104,6.3,147,479,29.1,39,440,504,30.6,43,-22,461,-25,123,7.5,16544
84534,T001038,Total male and female,GM0180,Staphorst,2016JJ00,2016,16544,123,248,14.9,109,6.6,139,564,33.9,36,528,556,33.5,33,1,523,8,147,8.9,16691
84535,T001038,Total male and female,GM0180,Staphorst,2017JJ00,2017,16691,124,235,14,146,8.7,89,651,38.9,45,606,635,37.9,39,-12,596,16,106,6.4,16797
84536,T001038,Total male and female,GM0180,Staphorst,2018JJ00,2018,16797,125,243,14.4,128,7.6,115,685,40.5,63,622,594,35.1,32,-4,562,91,206,12.3,17003
84537,T001038,Total male and female,GM0180,Staphorst,2019JJ00,2019,17003,127,262,15.3,113,6.6,149,620,36.3,66,554,628,36.8,39,-13,589,-8,142,8.4,17145
84538,T001038,Total male and female,GM0180,Staphorst,2020JJ00,2020,17145,128,260,15.1,125,7.3,135,601,34.9,60,541,620,36,32,-10,588,-19,116,6.8,17261
84539,T001038,Total male and female,GM0180,Staphorst,2021JJ00,2021,17261,129,231,13.4,119,6.9,112,552,32,39,513,646,37.4,36,-5,610,-94,21,1.2,17282
84540,T001038,Total male and female,GM0180,Staphorst,2022JJ00,2022,17282,129,251,14.4,123,7,128,865,49.6,294,571,647,37.1,83,-5,564,218,346,20,17628
84541,T001038,Total male and female,GM0180,Staphorst,2023JJ00,2023,17628,132,216,12.2,108,6.1,108,772,43.7,231,541,768,43.4,105,-36,663,4,111,6.3,17739
84776,T001038,Total male and female,GM0532,Stede Broec,2012JJ00,2012,21468,1467,211,9.8,144,6.7,67,843,39.3,118,725,947,44.2,89,-29,858,-104,-38,-1.8,21430
84777,T001038,Total male and female,GM0532,Stede Broec,2013JJ00,2013,21430,1473,244,11.4,158,7.4,86,855,39.8,103,752,886,41.3,70,-1,816,-31,55,2.6,21485
84778,T001038,Total male and female,GM0532,Stede Broec,2014JJ00,2014,21485,1477,213,9.9,146,6.8,67,954,44.4,132,822,1009,46.9,115,-7,894,-55,13,0.6,21498
84779,T001038,Total male and female,GM0532,Stede Broec,2015JJ00,2015,21498,1478,223,10.4,172,8,51,960,44.7,153,807,1019,47.4,89,-6,930,-59,-5,-0.2,21493
84780,T001038,Total male and female,GM0532,Stede Broec,2016JJ00,2016,21493,1477,232,10.8,162,7.5,70,1073,49.9,140,933,1085,50.4,94,-9,991,-12,59,2.7,21552
84781,T001038,Total male and female,GM0532,Stede Broec,2017JJ00,2017,21552,1481,232,10.7,191,8.8,41,1160,53.7,122,1038,1083,50.1,92,-13,991,77,118,5.5,21670
84782,T001038,Total male and female,GM0532,Stede Broec,2018JJ00,2018,21670,1494,212,9.8,185,8.5,27,1079,49.8,107,972,1070,49.3,82,-10,988,9,36,1.7,21706
84783,T001038,Total male and female,GM0532,Stede Broec,2019JJ00,2019,21706,1497,217,10,200,9.2,17,1049,48.3,144,905,1046,48.2,97,-13,949,3,20,0.9,21726
84784,T001038,Total male and female,GM0532,Stede Broec,2020JJ00,2020,21726,1498,202,9.3,188,8.6,14,1099,50.6,152,947,1094,50.3,121,-21,973,5,17,0.8,21743
84785,T001038,Total male and female,GM0532,Stede Broec,2021JJ00,2021,21743,1500,221,10.1,195,8.9,26,1081,49.5,145,936,903,41.3,91,-7,812,178,204,9.4,21947
84786,T001038,Total male and female,GM0532,Stede Broec,2022JJ00,2022,21947,1516,199,9,177,8,22,1271,57.7,307,964,1101,49.9,150,-13,951,170,191,8.7,22138
84787,T001038,Total male and female,GM0532,Stede Broec,2023JJ00,2023,22138,1529,200,9,214,9.6,-14,1182,53.3,154,1028,1089,49.1,156,-32,933,93,79,3.6,22217
84940,T001038,Total male and female,GM0851,Steenbergen,2012JJ00,2012,23354,159,197,8.4,194,8.3,3,864,37,165,699,819,35,123,-23,696,45,46,2,23400
84941,T001038,Total male and female,GM0851,Steenbergen,2013JJ00,2013,23400,160,202,8.6,220,9.4,-18,873,37.3,208,665,880,37.6,109,-8,771,-7,-26,-1.1,23374
84942,T001038,Total male and female,GM0851,Steenbergen,2014JJ00,2014,23374,159,195,8.3,227,9.7,-32,1271,54.1,527,744,976,41.5,156,-13,820,295,264,11.3,23638
84943,T001038,Total male and female,GM0851,Steenbergen,2015JJ00,2015,23638,161,196,8.3,217,9.2,-21,1142,48.5,380,762,1284,54.5,410,-255,874,-142,-161,-6.8,23477
84944,T001038,Total male and female,GM0851,Steenbergen,2016JJ00,2016,23477,160,210,8.9,225,9.5,-15,1756,74,951,805,1247,52.6,377,-224,870,509,493,21,23970
84945,T001038,Total male and female,GM0851,Steenbergen,2017JJ00,2017,23970,164,205,8.4,265,10.9,-60,2614,107.2,1652,962,1744,71.5,747,-497,997,870,811,33.8,24781
84946,T001038,Total male and female,GM0851,Steenbergen,2018JJ00,2018,24781,169,195,7.8,238,9.6,-43,2502,100.4,1437,1065,2183,87.6,1204,-581,979,319,273,11,25054
84947,T001038,Total male and female,GM0851,Steenbergen,2019JJ00,2019,25054,171,219,8.9,256,10.3,-37,1713,69.3,675,1038,2314,93.6,1318,-721,996,-601,-638,-25.5,24416
84948,T001038,Total male and female,GM0851,Steenbergen,2020JJ00,2020,24416,167,195,8,250,10.3,-55,1391,57.1,372,1019,1437,59,412,-109,1025,-46,-106,-4.3,24310
84949,T001038,Total male and female,GM0851,Steenbergen,2021JJ00,2021,24310,166,240,9.9,278,11.4,-38,1577,64.8,399,1178,1519,62.5,505,-210,1014,58,23,0.9,24333
84950,T001038,Total male and female,GM0851,Steenbergen,2022JJ00,2022,24333,166,216,8.8,274,11.2,-58,1555,63.5,472,1083,1220,49.9,353,-99,867,335,277,11.4,24610
84951,T001038,Total male and female,GM0851,Steenbergen,2023JJ00,2023,24610,168,190,7.7,298,12.1,-108,1285,52.4,334,951,1311,53.4,424,-195,887,-26,-134,-5.4,24476
85268,T001038,Total male and female,GM1708,Steenwijkerland,2012JJ00,2012,43402,150,428,9.9,395,9.1,33,1342,30.9,135,1207,1341,30.9,133,-30,1208,1,35,0.8,43437
85269,T001038,Total male and female,GM1708,Steenwijkerland,2013JJ00,2013,43437,150,404,9.3,370,8.5,34,1321,30.4,110,1211,1443,33.3,133,-36,1310,-122,-87,-2,43350
85270,T001038,Total male and female,GM1708,Steenwijkerland,2014JJ00,2014,43350,150,433,10,403,9.3,30,1399,32.3,168,1231,1564,36.1,120,4,1444,-165,-131,-3,43219
85271,T001038,Total male and female,GM1708,Steenwijkerland,2015JJ00,2015,43219,149,420,9.7,416,9.6,4,1540,35.6,156,1384,1432,33.1,112,-27,1320,108,114,2.6,43333
85272,T001038,Total male and female,GM1708,Steenwijkerland,2016JJ00,2016,43333,150,423,9.7,451,10.4,-28,1761,40.6,166,1595,1617,37.3,139,-14,1478,144,115,2.7,43448
85273,T001038,Total male and female,GM1708,Steenwijkerland,2017JJ00,2017,43448,150,422,9.7,412,9.4,10,1969,45.2,164,1805,1657,38,122,-14,1535,312,320,7.4,43768
85274,T001038,Total male and female,GM1708,Steenwijkerland,2018JJ00,2018,43768,152,408,9.3,428,9.8,-20,1986,45.3,224,1762,1795,40.9,106,1,1689,191,172,3.9,43940
85275,T001038,Total male and female,GM1708,Steenwijkerland,2019JJ00,2019,43940,152,412,9.4,469,10.7,-57,2014,45.7,198,1816,1770,40.2,156,-21,1614,244,186,4.2,44126
85276,T001038,Total male and female,GM1708,Steenwijkerland,2020JJ00,2020,44126,153,382,8.6,444,10,-62,2112,47.7,168,1944,1840,41.6,113,-11,1727,272,215,4.9,44341
85277,T001038,Total male and female,GM1708,Steenwijkerland,2021JJ00,2021,44341,154,413,9.3,478,10.7,-65,2193,49.2,200,1993,1727,38.8,118,-7,1609,466,400,9,44741
85278,T001038,Total male and female,GM1708,Steenwijkerland,2022JJ00,2022,44741,155,429,9.5,514,11.4,-85,2421,53.7,606,1815,1701,37.8,194,-17,1507,720,635,14.2,45376
85279,T001038,Total male and female,GM1708,Steenwijkerland,2023JJ00,2023,45376,157,361,7.9,466,10.3,-105,2133,47,434,1699,1931,42.5,255,-41,1676,202,96,2.1,45472
85432,T001038,Total male and female,GM0971,Stein (L.),2012JJ00,2012,25623,1211,153,6,259,10.1,-106,797,31.2,85,712,884,34.6,80,-3,804,-87,-192,-7.5,25431
85433,T001038,Total male and female,GM0971,Stein (L.),2013JJ00,2013,25431,1207,176,6.9,204,8,-28,793,31.2,85,708,806,31.7,76,-4,730,-13,-41,-1.6,25390
85434,T001038,Total male and female,GM0971,Stein (L.),2014JJ00,2014,25390,1205,146,5.8,250,9.9,-104,784,31,75,709,938,37.1,95,-2,843,-154,-256,-10.1,25134
85435,T001038,Total male and female,GM0971,Stein (L.),2015JJ00,2015,25134,1183,168,6.7,274,10.9,-106,904,36,108,796,867,34.5,85,7,782,37,-70,-2.8,25064
85436,T001038,Total male and female,GM0971,Stein (L.),2016JJ00,2016,25064,1188,178,7.1,251,10,-73,1003,40,95,908,934,37.3,90,7,844,69,-5,-0.2,25059
85437,T001038,Total male and female,GM0971,Stein (L.),2017JJ00,2017,25059,1188,176,7,288,11.5,-112,1013,40.5,107,906,973,38.9,94,-4,879,40,-72,-2.9,24987
85438,T001038,Total male and female,GM0971,Stein (L.),2018JJ00,2018,24987,1185,172,6.9,275,11,-103,1044,41.8,78,966,967,38.7,99,4,868,77,-26,-1,24961
85439,T001038,Total male and female,GM0971,Stein (L.),2019JJ00,2019,24961,1184,183,7.3,243,9.7,-60,1056,42.3,112,944,949,38,80,-2,869,107,46,1.8,25007
85440,T001038,Total male and female,GM0971,Stein (L.),2020JJ00,2020,25007,1186,189,7.6,307,12.3,-118,943,37.8,59,884,958,38.4,76,-4,882,-15,-132,-5.3,24875
85441,T001038,Total male and female,GM0971,Stein (L.),2021JJ00,2021,24875,1180,215,8.7,343,13.8,-128,1027,41.3,86,941,971,39.1,113,-3,858,56,-72,-2.9,24803
85442,T001038,Total male and female,GM0971,Stein (L.),2022JJ00,2022,24803,1186,181,7.3,327,13.2,-146,1119,45.1,196,923,1001,40.4,167,-3,834,118,-31,-1.2,24772
85443,T001038,Total male and female,GM0971,Stein (L.),2023JJ00,2023,24772,1184,163,6.6,286,11.6,-123,1038,41.9,112,926,943,38.1,98,0,845,95,-28,-1.1,24744
85678,T001038,Total male and female,GM1904,Stichtse Vecht,2012JJ00,2012,63315,655,692,10.9,471,7.4,221,2765,43.6,416,2349,2803,44.2,291,-36,2512,-38,176,2.8,63491
85679,T001038,Total male and female,GM1904,Stichtse Vecht,2013JJ00,2013,63491,657,620,9.7,452,7.1,168,2863,45,421,2442,2670,41.9,365,-59,2305,193,365,5.7,63856
85680,T001038,Total male and female,GM1904,Stichtse Vecht,2014JJ00,2014,63856,661,638,10,502,7.9,136,3027,47.4,431,2596,3075,48.1,312,-22,2763,-48,87,1.4,63943
85681,T001038,Total male and female,GM1904,Stichtse Vecht,2015JJ00,2015,63943,662,601,9.4,523,8.2,78,3264,51,403,2861,3225,50.4,389,-30,2836,39,118,1.8,64061
85682,T001038,Total male and female,GM1904,Stichtse Vecht,2016JJ00,2016,64061,666,617,9.6,549,8.5,68,3691,57.4,453,3238,3371,52.5,328,-7,3043,320,389,6.1,64450
85683,T001038,Total male and female,GM1904,Stichtse Vecht,2017JJ00,2017,64450,670,653,10.1,528,8.2,125,3411,52.9,449,2962,3473,53.9,322,-38,3151,-62,63,1,64513
85684,T001038,Total male and female,GM1904,Stichtse Vecht,2018JJ00,2018,64513,671,603,9.4,547,8.5,56,3190,49.5,457,2733,3420,53.1,384,-71,3036,-230,-177,-2.7,64336
85685,T001038,Total male and female,GM1904,Stichtse Vecht,2019JJ00,2019,64336,669,639,9.9,514,8,125,3764,58.2,492,3272,3291,50.9,296,-21,2995,473,595,9.2,64931
85686,T001038,Total male and female,GM1904,Stichtse Vecht,2020JJ00,2020,64931,676,603,9.3,608,9.4,-5,3556,54.7,412,3144,3378,52,263,-38,3115,178,177,2.7,65108
85687,T001038,Total male and female,GM1904,Stichtse Vecht,2021JJ00,2021,65108,678,673,10.3,590,9.1,83,3679,56.4,458,3221,3628,55.7,258,-34,3370,51,132,2,65240
85688,T001038,Total male and female,GM1904,Stichtse Vecht,2022JJ00,2022,65240,679,638,9.7,602,9.2,36,3866,59,965,2901,3370,51.4,388,-54,2982,496,531,8.1,65771
85689,T001038,Total male and female,GM1904,Stichtse Vecht,2023JJ00,2023,65771,685,636,9.7,627,9.5,9,3903,59.3,608,3295,3803,57.8,558,-94,3245,100,107,1.6,65878
86170,T001038,Total male and female,GM0617,Strijen,2012JJ00,2012,8848,174,72,8.2,59,6.7,13,286,32.5,15,271,371,42.1,28,-4,343,-85,-71,-8,8777
86171,T001038,Total male and female,GM0617,Strijen,2013JJ00,2013,8777,174,54,6.2,65,7.4,-11,293,33.6,13,280,377,43.2,23,2,354,-84,-94,-10.7,8683
86172,T001038,Total male and female,GM0617,Strijen,2014JJ00,2014,8683,172,56,6.4,85,9.8,-29,402,46.2,17,385,340,39.1,21,-6,319,62,33,3.8,8716
86173,T001038,Total male and female,GM0617,Strijen,2015JJ00,2015,8716,173,66,7.6,68,7.8,-2,406,46.4,31,375,354,40.5,20,-3,334,52,50,5.7,8766
86174,T001038,Total male and female,GM0617,Strijen,2016JJ00,2016,8766,174,55,6.3,86,9.8,-31,422,48.1,18,404,372,42.4,30,-1,342,50,19,2.2,8785
86175,T001038,Total male and female,GM0617,Strijen,2017JJ00,2017,8785,175,78,8.9,101,11.5,-23,488,55.5,31,457,457,52,14,16,443,31,8,0.9,8793
86176,T001038,Total male and female,GM0617,Strijen,2018JJ00,2018,8793,174,64,7.3,86,9.8,-22,471,53.6,28,443,456,51.9,14,6,442,15,-17,-1.9,8776
86252,T001038,Total male and female,GM1900,Súdwest-Fryslân,2012JJ00,2012,82634,191,809,9.8,771,9.3,38,2337,28.3,272,2065,2367,28.6,266,-53,2101,-30,5,0.1,82639
86253,T001038,Total male and female,GM1900,Súdwest-Fryslân,2013JJ00,2013,82639,192,812,9.8,827,10,-15,2391,29,259,2132,2482,30.1,246,-22,2236,-91,-112,-1.4,82527
86254,T001038,Total male and female,GM1900,Súdwest-Fryslân,2014JJ00,2014,84180,185,763,9.1,746,8.9,17,2467,29.3,226,2241,2511,29.8,212,-26,2299,-44,-16,-0.2,84164
86255,T001038,Total male and female,GM1900,Súdwest-Fryslân,2015JJ00,2015,84164,185,773,9.2,806,9.6,-33,2479,29.5,260,2219,2564,30.5,209,-10,2355,-85,-116,-1.4,84048
86256,T001038,Total male and female,GM1900,Súdwest-Fryslân,2016JJ00,2016,84048,185,817,9.7,778,9.3,39,2847,33.9,286,2561,2772,33,223,-18,2549,75,110,1.3,84158
86257,T001038,Total male and female,GM1900,Súdwest-Fryslân,2017JJ00,2017,84158,185,750,8.9,775,9.2,-25,3200,38,337,2863,3156,37.5,220,-26,2936,44,25,0.3,84183
86258,T001038,Total male and female,GM1900,Súdwest-Fryslân,2018JJ00,2018,89594,172,789,8.8,900,10,-111,3296,36.8,412,2884,3067,34.2,274,-35,2793,229,116,1.3,89710
86259,T001038,Total male and female,GM1900,Súdwest-Fryslân,2019JJ00,2019,89710,172,837,9.3,884,9.8,-47,3265,36.3,396,2869,2942,32.7,291,-58,2651,323,277,3.1,89987
86260,T001038,Total male and female,GM1900,Súdwest-Fryslân,2020JJ00,2020,89987,172,809,9,914,10.2,-105,3277,36.4,324,2953,3156,35.1,207,-37,2949,121,12,0.1,89999
86261,T001038,Total male and female,GM1900,Súdwest-Fryslân,2021JJ00,2021,89999,172,831,9.2,946,10.5,-115,3698,41,324,3374,3282,36.4,219,-34,3063,416,301,3.3,90300
86262,T001038,Total male and female,GM1900,Súdwest-Fryslân,2022JJ00,2022,90300,173,795,8.8,1000,11,-205,4286,47.3,1039,3247,3491,38.5,407,-48,3084,795,583,6.5,90883
86263,T001038,Total male and female,GM1900,Súdwest-Fryslân,2023JJ00,2023,90883,174,768,8.5,1028,11.3,-260,3576,39.4,486,3090,3782,41.7,445,-66,3337,-206,-462,-5.1,90421
86744,T001038,Total male and female,GM0715,Terneuzen,2012JJ00,2012,54742,218,489,8.9,596,10.9,-107,1818,33.2,690,1128,1721,31.4,508,-83,1213,97,-13,-0.2,54729
86745,T001038,Total male and female,GM0715,Terneuzen,2013JJ00,2013,54729,218,486,8.9,602,11,-116,1819,33.2,683,1136,1721,31.5,453,-61,1268,98,-20,-0.4,54709
86746,T001038,Total male and female,GM0715,Terneuzen,2014JJ00,2014,54709,218,466,8.5,532,9.7,-66,1789,32.7,631,1158,1854,33.9,577,-94,1277,-65,-132,-2.4,54577
86747,T001038,Total male and female,GM0715,Terneuzen,2015JJ00,2015,54577,218,479,8.8,658,12,-179,1910,35,723,1187,1647,30.2,493,-70,1154,263,80,1.5,54657
86748,T001038,Total male and female,GM0715,Terneuzen,2016JJ00,2016,54657,218,494,9,626,11.5,-132,2281,41.8,949,1332,2214,40.5,518,-76,1696,67,-69,-1.3,54588
86749,T001038,Total male and female,GM0715,Terneuzen,2017JJ00,2017,54588,218,432,7.9,630,11.6,-198,2007,36.8,785,1222,1954,35.8,527,-96,1427,53,-148,-2.7,54440
86750,T001038,Total male and female,GM0715,Terneuzen,2018JJ00,2018,54440,217,437,8,642,11.8,-205,2292,42,1036,1256,1949,35.8,529,-47,1420,343,149,2.7,54589
86751,T001038,Total male and female,GM0715,Terneuzen,2019JJ00,2019,54589,218,401,7.4,645,11.8,-244,2138,39.2,907,1231,2059,37.8,594,-97,1465,79,-163,-3,54426
86752,T001038,Total male and female,GM0715,Terneuzen,2020JJ00,2020,54426,217,430,7.9,667,12.3,-237,2108,38.7,798,1310,1829,33.6,488,-44,1341,279,37,0.7,54463
86753,T001038,Total male and female,GM0715,Terneuzen,2021JJ00,2021,54463,218,484,8.9,731,13.4,-247,2177,40,849,1328,1896,34.8,557,-55,1339,281,38,0.7,54501
86754,T001038,Total male and female,GM0715,Terneuzen,2022JJ00,2022,54501,218,406,7.4,736,13.4,-330,2901,53,1437,1464,2075,37.9,746,-125,1329,826,492,9,54993
86755,T001038,Total male and female,GM0715,Terneuzen,2023JJ00,2023,54993,220,492,8.9,691,12.5,-199,2500,45.4,1071,1429,2165,39.3,671,-129,1494,335,139,2.5,55132
86826,T001038,Total male and female,GM0093,Terschelling,2012JJ00,2012,4748,55,44,9.2,58,12.2,-14,316,66.2,7,309,256,53.7,16,-5,240,60,47,9.9,4795
86827,T001038,Total male and female,GM0093,Terschelling,2013JJ00,2013,4795,57,37,7.7,47,9.8,-10,340,71,8,332,345,72.1,14,-5,331,-5,-15,-3.1,4780
86828,T001038,Total male and female,GM0093,Terschelling,2014JJ00,2014,4780,57,44,9.2,35,7.3,9,380,79.1,22,358,343,71.4,25,-6,318,37,47,9.8,4827
86829,T001038,Total male and female,GM0093,Terschelling,2015JJ00,2015,4827,58,29,6,46,9.5,-17,372,76.7,22,350,312,64.3,23,-4,289,60,43,8.9,4870
86830,T001038,Total male and female,GM0093,Terschelling,2016JJ00,2016,4870,58,30,6.2,60,12.3,-30,369,75.9,22,347,350,71.9,19,-3,331,19,-11,-2.3,4859
86831,T001038,Total male and female,GM0093,Terschelling,2017JJ00,2017,4859,58,43,8.8,41,8.4,2,385,78.9,39,346,341,69.8,21,-5,320,44,47,9.7,4906
86832,T001038,Total male and female,GM0093,Terschelling,2018JJ00,2018,4906,58,13,2.7,42,8.6,-29,386,78.8,46,340,372,75.9,49,-24,323,14,-16,-3.3,4890
86833,T001038,Total male and female,GM0093,Terschelling,2019JJ00,2019,4890,57,34,7,38,7.8,-4,364,74.5,47,317,362,74,35,2,327,2,-2,-0.4,4888
86834,T001038,Total male and female,GM0093,Terschelling,2020JJ00,2020,4888,57,27,5.5,40,8.2,-13,364,74.6,45,319,366,75,34,-5,332,-2,-18,-3.7,4870
86835,T001038,Total male and female,GM0093,Terschelling,2021JJ00,2021,4870,57,43,8.7,56,11.4,-13,427,86.9,70,357,322,65.5,26,-2,296,105,90,18.5,4960
86836,T001038,Total male and female,GM0093,Terschelling,2022JJ00,2022,4960,57,28,5.7,56,11.3,-28,394,79.7,107,287,399,80.7,82,-14,317,-5,-32,-6.5,4928
86837,T001038,Total male and female,GM0093,Terschelling,2023JJ00,2023,4928,57,42,8.5,48,9.8,-6,386,78.6,73,313,411,83.7,68,-12,343,-25,-30,-6.1,4898
86990,T001038,Total male and female,GM0448,Texel,2012JJ00,2012,13668,85,108,7.9,119,8.7,-11,499,36.5,79,420,494,36.2,59,-9,435,5,-6,-0.4,13662
86991,T001038,Total male and female,GM0448,Texel,2013JJ00,2013,13662,85,103,7.6,137,10.1,-34,498,36.6,50,448,575,42.3,67,-9,508,-77,-110,-8.1,13552
86992,T001038,Total male and female,GM0448,Texel,2014JJ00,2014,13552,84,107,7.9,114,8.4,-7,572,42.2,61,511,536,39.5,59,-3,477,36,29,2.1,13581
86993,T001038,Total male and female,GM0448,Texel,2015JJ00,2015,13581,84,87,6.4,146,10.8,-59,585,43.1,81,504,533,39.3,61,2,472,52,-7,-0.5,13574
86994,T001038,Total male and female,GM0448,Texel,2016JJ00,2016,13574,84,125,9.2,157,11.6,-32,620,45.7,56,564,617,45.5,82,-4,535,3,-29,-2.1,13545
86995,T001038,Total male and female,GM0448,Texel,2017JJ00,2017,13545,84,85,6.3,148,10.9,-63,693,51.1,102,591,590,43.5,59,-11,531,103,39,2.9,13584
86996,T001038,Total male and female,GM0448,Texel,2018JJ00,2018,13584,84,107,7.9,148,10.9,-41,580,42.8,89,491,582,42.9,65,3,517,-2,-37,-2.7,13547
86997,T001038,Total male and female,GM0448,Texel,2019JJ00,2019,13547,84,96,7.1,139,10.2,-43,606,44.7,81,525,529,39,46,-3,483,77,28,2.1,13575
86998,T001038,Total male and female,GM0448,Texel,2020JJ00,2020,13575,84,109,8,137,10.1,-28,592,43.5,107,485,483,35.5,50,-8,433,109,81,6,13656
86999,T001038,Total male and female,GM0448,Texel,2021JJ00,2021,13656,84,111,8.1,131,9.6,-20,598,43.7,100,498,547,40,67,1,480,51,31,2.3,13687
87000,T001038,Total male and female,GM0448,Texel,2022JJ00,2022,13687,84,125,9,159,11.5,-34,900,65.1,414,486,574,41.5,136,-14,438,326,292,21.3,13979
87001,T001038,Total male and female,GM0448,Texel,2023JJ00,2023,13979,86,94,6.8,184,13.2,-90,598,43,190,408,672,48.4,113,-32,559,-74,-164,-11.7,13815
87072,T001038,Total male and female,GM1525,Teylingen,2012JJ00,2012,35686,1250,318,8.9,310,8.7,8,1619,45.3,205,1414,1515,42.4,187,1,1328,104,114,3.2,35800
87073,T001038,Total male and female,GM1525,Teylingen,2013JJ00,2013,35800,1254,322,9,297,8.3,25,1558,43.6,160,1398,1649,46.1,137,2,1512,-91,-65,-1.8,35735
87074,T001038,Total male and female,GM1525,Teylingen,2014JJ00,2014,35735,1252,329,9.2,309,8.7,20,1561,43.7,172,1389,1670,46.8,142,-7,1528,-109,-89,-2.5,35646
87075,T001038,Total male and female,GM1525,Teylingen,2015JJ00,2015,35646,1249,286,8,306,8.5,-20,2111,58.9,201,1910,1725,48.1,153,1,1572,386,367,10.3,36013
87076,T001038,Total male and female,GM1525,Teylingen,2016JJ00,2016,36013,1266,315,8.7,334,9.3,-19,2052,56.9,234,1818,1956,54.3,158,8,1798,96,80,2.2,36093
87077,T001038,Total male and female,GM1525,Teylingen,2017JJ00,2017,36093,1269,354,9.7,305,8.4,49,2487,68.4,243,2244,2045,56.3,139,-6,1906,442,491,13.6,36584
87078,T001038,Total male and female,GM1525,Teylingen,2018JJ00,2018,36584,1289,383,10.4,280,7.6,103,2052,55.7,258,1794,1672,45.4,166,-1,1506,380,477,13,37061
87079,T001038,Total male and female,GM1525,Teylingen,2019JJ00,2019,37061,1306,358,9.6,308,8.3,50,1961,52.6,215,1746,1633,43.8,174,-12,1459,328,379,10.2,37440
87080,T001038,Total male and female,GM1525,Teylingen,2020JJ00,2020,37440,1319,351,9.3,320,8.5,31,2070,55,180,1890,1752,46.6,135,-13,1617,318,351,9.4,37791
87081,T001038,Total male and female,GM1525,Teylingen,2021JJ00,2021,37791,1332,403,10.6,352,9.3,51,1887,49.8,189,1698,1787,47.2,163,-16,1624,100,151,4,37942
87082,T001038,Total male and female,GM1525,Teylingen,2022JJ00,2022,37942,1340,372,9.7,385,10.1,-13,2281,59.7,373,1908,1701,44.5,196,-7,1505,580,568,15,38510
87083,T001038,Total male and female,GM1525,Teylingen,2023JJ00,2023,38510,1360,375,9.7,388,10.1,-13,1926,50,296,1630,1953,50.7,222,-45,1731,-27,-40,-1,38470
87154,T001038,Total male and female,GM0716,Tholen,2012JJ00,2012,25540,174,316,12.4,236,9.2,80,631,24.7,66,565,737,28.9,72,-12,665,-106,-26,-1,25514
87155,T001038,Total male and female,GM0716,Tholen,2013JJ00,2013,25514,174,267,10.5,226,8.9,41,618,24.3,68,550,766,30.1,56,-9,710,-148,-106,-4.2,25408
87156,T001038,Total male and female,GM0716,Tholen,2014JJ00,2014,25408,173,310,12.2,221,8.7,89,734,28.9,80,654,796,31.3,85,-11,711,-62,32,1.3,25440
87157,T001038,Total male and female,GM0716,Tholen,2015JJ00,2015,25440,173,266,10.5,211,8.3,55,720,28.3,105,615,793,31.2,85,-14,708,-73,-19,-0.7,25421
87158,T001038,Total male and female,GM0716,Tholen,2016JJ00,2016,25421,173,286,11.2,191,7.5,95,868,34.1,125,743,858,33.7,74,-6,784,10,106,4.2,25527
87159,T001038,Total male and female,GM0716,Tholen,2017JJ00,2017,25527,174,286,11.2,222,8.7,64,911,35.6,91,820,919,36,99,-10,820,-8,56,2.2,25583
87160,T001038,Total male and female,GM0716,Tholen,2018JJ00,2018,25583,174,302,11.8,230,9,72,1017,39.6,109,908,892,34.7,77,-6,815,125,197,7.7,25780
87161,T001038,Total male and female,GM0716,Tholen,2019JJ00,2019,25780,176,304,11.8,208,8.1,96,914,35.5,115,799,1032,40,91,-6,941,-118,-23,-0.9,25757
87162,T001038,Total male and female,GM0716,Tholen,2020JJ00,2020,25757,176,286,11,265,10.2,21,1152,44.4,121,1031,843,32.5,60,-7,783,309,328,12.7,26085
87163,T001038,Total male and female,GM0716,Tholen,2021JJ00,2021,26085,178,328,12.5,245,9.3,83,1179,44.9,87,1092,948,36.1,77,-10,871,231,316,12.1,26401
87164,T001038,Total male and female,GM0716,Tholen,2022JJ00,2022,26401,180,330,12.4,226,8.5,104,1271,47.8,420,851,950,35.7,172,-5,778,321,424,16.1,26825
87165,T001038,Total male and female,GM0716,Tholen,2023JJ00,2023,26825,183,297,11.1,240,8.9,57,1047,39,187,860,1075,40.1,194,-27,881,-28,26,1,26851
87318,T001038,Total male and female,GM0281,Tiel,2012JJ00,2012,41527,1287,437,10.5,310,7.4,127,1564,37.6,150,1414,1468,35.3,151,-13,1317,96,224,5.4,41751
87319,T001038,Total male and female,GM0281,Tiel,2013JJ00,2013,41751,1295,447,10.7,331,7.9,116,1485,35.6,187,1298,1595,38.2,228,-60,1367,-110,4,0.1,41755
87320,T001038,Total male and female,GM0281,Tiel,2014JJ00,2014,41775,1268,453,10.9,310,7.4,143,1452,34.8,205,1247,1779,42.7,163,15,1616,-327,-185,-4.4,41590
87321,T001038,Total male and female,GM0281,Tiel,2015JJ00,2015,41590,1262,399,9.6,358,8.6,41,1615,38.9,214,1401,1737,41.8,208,-11,1529,-122,-80,-1.9,41510
87322,T001038,Total male and female,GM0281,Tiel,2016JJ00,2016,41510,1262,415,10,346,8.3,69,1749,42.1,240,1509,1838,44.3,148,4,1690,-89,-22,-0.5,41488
87323,T001038,Total male and female,GM0281,Tiel,2017JJ00,2017,41488,1261,406,9.8,363,8.8,43,1928,46.5,259,1669,1994,48.1,216,-30,1778,-66,-23,-0.6,41465
87324,T001038,Total male and female,GM0281,Tiel,2018JJ00,2018,41465,1261,381,9.1,350,8.4,31,2454,58.8,965,1489,1969,47.2,258,-60,1711,485,513,12.4,41978
87325,T001038,Total male and female,GM0281,Tiel,2019JJ00,2019,41978,1277,356,8.5,358,8.5,-2,2337,55.6,720,1617,2155,51.2,499,-155,1656,182,181,4.3,42159
87326,T001038,Total male and female,GM0281,Tiel,2020JJ00,2020,42159,1282,390,9.3,429,10.2,-39,2524,60,859,1665,2722,64.7,858,-218,1864,-198,-239,-5.7,41920
87327,T001038,Total male and female,GM0281,Tiel,2021JJ00,2021,41920,1275,405,9.6,455,10.8,-50,2713,64.4,904,1809,2306,54.8,636,-85,1670,407,357,8.5,42277
87328,T001038,Total male and female,GM0281,Tiel,2022JJ00,2022,42277,1289,368,8.7,386,9.1,-18,2830,66.7,1203,1627,2483,58.5,754,-148,1729,347,327,7.7,42604
87329,T001038,Total male and female,GM0281,Tiel,2023JJ00,2023,42604,1299,366,8.6,409,9.6,-43,2562,60.3,681,1881,2751,64.7,1011,-605,1740,-189,-234,-5.5,42370
87646,T001038,Total male and female,GM0855,Tilburg,2012JJ00,2012,207580,1770,2217,10.7,1675,8.1,542,10517,50.5,2543,7974,10108,48.6,2078,-262,8030,409,947,4.6,208527
87647,T001038,Total male and female,GM0855,Tilburg,2013JJ00,2013,208527,1779,2197,10.5,1677,8,520,11381,54.4,2801,8580,10168,48.6,2026,-33,8142,1213,1743,8.4,210270
87648,T001038,Total male and female,GM0855,Tilburg,2014JJ00,2014,210270,1794,2253,10.7,1685,8,568,11808,56,2868,8940,10988,52.1,2641,-738,8347,820,1378,6.6,211648
87649,T001038,Total male and female,GM0855,Tilburg,2015JJ00,2015,211648,1805,2139,10.1,1744,8.2,395,12149,57.2,3358,8791,11243,53,2560,-593,8683,906,1293,6.1,212941
87650,T001038,Total male and female,GM0855,Tilburg,2016JJ00,2016,212941,1817,2203,10.3,1831,8.6,372,12980,60.8,3746,9234,12480,58.5,2810,-734,9670,500,863,4.1,213804
87651,T001038,Total male and female,GM0855,Tilburg,2017JJ00,2017,213804,1824,2064,9.6,1868,8.7,196,13459,62.7,4042,9417,11857,55.2,2335,-124,9522,1602,1784,8.3,215588
87652,T001038,Total male and female,GM0855,Tilburg,2018JJ00,2018,215521,1855,2062,9.5,1886,8.7,176,13567,62.7,4554,9013,12009,55.5,3006,-734,9003,1558,1738,8.1,217259
87653,T001038,Total male and female,GM0855,Tilburg,2019JJ00,2019,217259,1870,2008,9.2,1814,8.3,194,14039,64.2,5075,8964,11695,53.5,2848,-434,8847,2344,2530,11.6,219789
87654,T001038,Total male and female,GM0855,Tilburg,2020JJ00,2020,219789,1892,2037,9.3,2219,10.1,-182,13665,62.1,4357,9308,12755,57.9,3401,-849,9354,910,716,3.3,220505
87655,T001038,Total male and female,GM0855,Tilburg,2021JJ00,2021,221947,1762,2276,10.2,2024,9.1,252,13872,62.1,4839,9033,11603,52,2761,-426,8842,2269,2512,11.3,224459
87656,T001038,Total male and female,GM0855,Tilburg,2022JJ00,2022,224459,1783,2116,9.4,2089,9.2,27,15267,67.5,6025,9242,12040,53.3,3151,-473,8889,3227,3248,14.5,227707
87657,T001038,Total male and female,GM0855,Tilburg,2023JJ00,2023,227707,1809,2081,9.1,2095,9.2,-14,14958,65.4,5428,9530,12794,55.9,3781,-821,9013,2164,2129,9.3,229836
87728,T001038,Total male and female,GM0183,Tubbergen,2012JJ00,2012,21206,144,216,10.2,171,8.1,45,482,22.7,59,423,560,26.4,48,-14,512,-78,-34,-1.6,21172
87729,T001038,Total male and female,GM0183,Tubbergen,2013JJ00,2013,21172,144,199,9.4,161,7.6,38,528,24.9,48,480,532,25.1,39,-1,493,-4,34,1.6,21206
87730,T001038,Total male and female,GM0183,Tubbergen,2014JJ00,2014,21206,144,182,8.6,191,9,-9,546,25.8,71,475,599,28.3,47,-11,552,-53,-64,-3,21142
87731,T001038,Total male and female,GM0183,Tubbergen,2015JJ00,2015,21142,144,196,9.3,163,7.7,33,528,25,38,490,581,27.5,28,0,553,-53,-22,-1,21120
87732,T001038,Total male and female,GM0183,Tubbergen,2016JJ00,2016,21120,144,181,8.6,162,7.7,19,624,29.5,41,583,611,28.9,42,-5,569,13,33,1.6,21153
87733,T001038,Total male and female,GM0183,Tubbergen,2017JJ00,2017,21153,144,182,8.6,153,7.2,29,708,33.4,45,663,674,31.8,25,-2,649,34,60,2.8,21213
87734,T001038,Total male and female,GM0183,Tubbergen,2018JJ00,2018,21213,144,197,9.3,197,9.3,0,644,30.3,55,589,581,27.3,36,-7,545,63,63,3,21276
87735,T001038,Total male and female,GM0183,Tubbergen,2019JJ00,2019,21276,145,210,9.9,192,9,18,628,29.5,66,562,646,30.4,56,-9,590,-18,-1,0,21275
87736,T001038,Total male and female,GM0183,Tubbergen,2020JJ00,2020,21275,145,188,8.8,213,10,-25,696,32.7,39,657,631,29.6,46,-7,585,65,40,1.9,21315
87737,T001038,Total male and female,GM0183,Tubbergen,2021JJ00,2021,21315,145,213,10,216,10.1,-3,653,30.6,60,593,601,28.2,34,-10,567,52,49,2.3,21364
87738,T001038,Total male and female,GM0183,Tubbergen,2022JJ00,2022,21364,145,194,9.1,221,10.3,-27,654,30.6,136,518,583,27.3,65,-10,518,71,44,2.1,21408
87739,T001038,Total male and female,GM0183,Tubbergen,2023JJ00,2023,21408,146,231,10.8,209,9.8,22,678,31.7,132,546,713,33.3,68,-17,645,-35,-11,-0.5,21397
87974,T001038,Total male and female,GM1700,Twenterand,2012JJ00,2012,33929,319,394,11.6,292,8.6,102,776,22.9,59,717,836,24.6,36,-4,800,-60,42,1.2,33971
87975,T001038,Total male and female,GM1700,Twenterand,2013JJ00,2013,33971,320,377,11.1,296,8.7,81,781,23,53,728,911,26.8,57,-2,854,-130,-42,-1.2,33929
87976,T001038,Total male and female,GM1700,Twenterand,2014JJ00,2014,33929,319,358,10.6,290,8.6,68,792,23.4,51,741,915,27,68,-5,847,-123,-55,-1.6,33874
87977,T001038,Total male and female,GM1700,Twenterand,2015JJ00,2015,33874,319,376,11.1,283,8.4,93,798,23.6,59,739,915,27,53,-4,862,-117,-28,-0.8,33846
87978,T001038,Total male and female,GM1700,Twenterand,2016JJ00,2016,33846,318,337,10,321,9.5,16,848,25.1,56,792,866,25.6,36,-2,830,-18,-1,0,33845
87979,T001038,Total male and female,GM1700,Twenterand,2017JJ00,2017,33845,318,344,10.2,269,7.9,75,917,27.1,51,866,935,27.6,42,0,893,-18,58,1.7,33903
87980,T001038,Total male and female,GM1700,Twenterand,2018JJ00,2018,33903,319,334,9.9,314,9.3,20,936,27.7,71,865,1067,31.5,39,-7,1028,-131,-111,-3.3,33792
87981,T001038,Total male and female,GM1700,Twenterand,2019JJ00,2019,33792,318,310,9.2,323,9.6,-13,910,26.9,58,852,942,27.9,49,3,893,-32,-49,-1.5,33743
87982,T001038,Total male and female,GM1700,Twenterand,2020JJ00,2020,33743,318,298,8.8,325,9.6,-27,932,27.6,43,889,949,28.1,36,-8,913,-17,-44,-1.3,33699
87983,T001038,Total male and female,GM1700,Twenterand,2021JJ00,2021,33699,317,321,9.5,349,10.4,-28,904,26.8,37,867,858,25.5,35,1,823,46,19,0.6,33718
87984,T001038,Total male and female,GM1700,Twenterand,2022JJ00,2022,33718,318,309,9.1,332,9.8,-23,1090,32.3,238,852,915,27.1,88,3,827,175,149,4.4,33867
87985,T001038,Total male and female,GM1700,Twenterand,2023JJ00,2023,33867,319,330,9.7,330,9.7,0,1176,34.6,148,1028,970,28.6,58,-11,912,206,206,6.1,34073
88138,T001038,Total male and female,GM1730,Tynaarlo,2012JJ00,2012,32357,225,294,9.1,360,11.1,-66,1622,50.1,82,1540,1456,44.9,24,14,1432,166,99,3.1,32456
88139,T001038,Total male and female,GM1730,Tynaarlo,2013JJ00,2013,32456,226,254,7.8,354,10.9,-100,1648,50.7,92,1556,1511,46.5,36,17,1475,137,37,1.1,32493
88140,T001038,Total male and female,GM1730,Tynaarlo,2014JJ00,2014,32493,227,290,8.9,313,9.6,-23,1719,52.8,100,1619,1620,49.8,64,0,1556,99,77,2.4,32570
88141,T001038,Total male and female,GM1730,Tynaarlo,2015JJ00,2015,32570,227,258,7.9,382,11.7,-124,2053,62.8,96,1957,1690,51.7,102,-1,1588,363,234,7.2,32804
88142,T001038,Total male and female,GM1730,Tynaarlo,2016JJ00,2016,32804,229,298,9,353,10.7,-55,2189,66.2,105,2084,1657,50.1,71,10,1586,532,476,14.5,33280
88143,T001038,Total male and female,GM1730,Tynaarlo,2017JJ00,2017,33280,232,267,8,427,12.8,-160,2281,68.4,98,2183,1943,58.2,62,-4,1881,338,182,5.5,33462
88144,T001038,Total male and female,GM1730,Tynaarlo,2018JJ00,2018,33462,234,312,9.3,417,12.4,-105,2295,68.3,126,2169,1950,58.1,80,-5,1870,345,236,7.1,33698
88145,T001038,Total male and female,GM1730,Tynaarlo,2019JJ00,2019,33698,236,314,9.3,365,10.8,-51,2220,65.7,104,2116,1977,58.5,80,-1,1897,243,189,5.6,33887
88146,T001038,Total male and female,GM1730,Tynaarlo,2020JJ00,2020,33887,237,281,8.3,455,13.4,-174,2176,64.1,117,2059,1911,56.3,48,1,1863,265,91,2.7,33978
88147,T001038,Total male and female,GM1730,Tynaarlo,2021JJ00,2021,33978,238,290,8.5,443,13,-153,2231,65.4,98,2133,1837,53.9,68,-4,1769,394,243,7.2,34221
88148,T001038,Total male and female,GM1730,Tynaarlo,2022JJ00,2022,34221,240,311,9,482,14,-171,2643,76.8,285,2358,2101,61.1,105,-6,1996,542,371,10.8,34592
88149,T001038,Total male and female,GM1730,Tynaarlo,2023JJ00,2023,34592,242,276,8,429,12.4,-153,2319,66.9,116,2203,2023,58.4,144,-22,1879,296,144,4.2,34736
88220,T001038,Total male and female,GM0737,Tytsjerksteradiel,2012JJ00,2012,32164,215,324,10.1,340,10.6,-16,1279,39.9,230,1049,1452,45.3,141,18,1311,-173,-185,-5.8,31979
88221,T001038,Total male and female,GM0737,Tytsjerksteradiel,2013JJ00,2013,31979,214,289,9,333,10.4,-44,1341,41.9,146,1195,1311,41,78,-2,1233,30,-6,-0.2,31973
88222,T001038,Total male and female,GM0737,Tytsjerksteradiel,2014JJ00,2014,31973,214,281,8.8,334,10.4,-53,1432,44.8,128,1304,1395,43.6,79,-16,1316,37,-16,-0.5,31957
88223,T001038,Total male and female,GM0737,Tytsjerksteradiel,2015JJ00,2015,31957,214,282,8.8,323,10.1,-41,1461,45.6,95,1366,1300,40.6,63,15,1237,161,120,3.8,32077
88224,T001038,Total male and female,GM0737,Tytsjerksteradiel,2016JJ00,2016,32077,215,252,7.9,323,10.1,-71,1458,45.5,112,1346,1503,46.9,52,17,1451,-45,-114,-3.6,31963
88225,T001038,Total male and female,GM0737,Tytsjerksteradiel,2017JJ00,2017,31963,214,287,9,337,10.6,-50,1608,50.4,104,1504,1653,51.8,147,-81,1506,-45,-93,-2.9,31870
88226,T001038,Total male and female,GM0737,Tytsjerksteradiel,2018JJ00,2018,31870,214,279,8.8,361,11.3,-82,1541,48.4,104,1437,1549,48.7,78,-45,1471,-8,-90,-2.8,31780
88227,T001038,Total male and female,GM0737,Tytsjerksteradiel,2019JJ00,2019,31780,213,305,9.6,322,10.1,-17,1609,50.4,106,1503,1323,41.5,65,-25,1258,286,272,8.6,32052
88228,T001038,Total male and female,GM0737,Tytsjerksteradiel,2020JJ00,2020,32052,215,306,9.5,337,10.5,-31,1439,44.9,89,1350,1402,43.7,63,-3,1339,37,8,0.2,32060
88229,T001038,Total male and female,GM0737,Tytsjerksteradiel,2021JJ00,2021,32060,215,344,10.7,376,11.7,-32,1642,51,65,1577,1386,43.1,75,-22,1311,256,222,6.9,32282
88230,T001038,Total male and female,GM0737,Tytsjerksteradiel,2022JJ00,2022,32282,217,264,8.2,379,11.7,-115,1726,53.4,278,1448,1484,45.9,125,-29,1359,242,126,3.9,32408
88231,T001038,Total male and female,GM0737,Tytsjerksteradiel,2023JJ00,2023,32408,218,305,9.4,378,11.6,-73,1793,55.2,161,1632,1531,47.1,156,-73,1375,262,187,5.8,32595
88384,T001038,Total male and female,GM0282,Ubbergen,2012JJ00,2012,9387,278,75,7.9,102,10.8,-27,589,62.4,46,543,443,46.9,39,-1,404,146,117,12.5,9504
88385,T001038,Total male and female,GM0282,Ubbergen,2013JJ00,2013,9504,282,65,6.9,107,11.3,-42,490,51.7,53,437,503,53.1,48,-8,455,-13,-53,-5.6,9451
88386,T001038,Total male and female,GM0282,Ubbergen,2014JJ00,2014,9451,280,77,8.2,117,12.4,-40,487,51.6,46,441,482,51.1,38,-1,444,5,-35,-3.7,9416
88466,T001038,Total male and female,GM0856,Uden,2012JJ00,2012,40805,609,388,9.5,294,7.2,94,1308,32,165,1143,1260,30.8,128,-12,1132,48,143,3.5,40948
88467,T001038,Total male and female,GM0856,Uden,2013JJ00,2013,40948,611,389,9.5,318,7.8,71,1271,31.1,193,1078,1376,33.6,190,-30,1186,-105,-35,-0.9,40913
88468,T001038,Total male and female,GM0856,Uden,2014JJ00,2014,40913,610,443,10.8,331,8.1,112,1499,36.6,203,1296,1435,35,188,-14,1247,64,176,4.3,41089
88469,T001038,Total male and female,GM0856,Uden,2015JJ00,2015,41089,613,408,9.9,350,8.5,58,1514,36.8,207,1307,1418,34.4,204,-44,1214,96,158,3.8,41247
88470,T001038,Total male and female,GM0856,Uden,2016JJ00,2016,41247,615,405,9.8,361,8.7,44,1641,39.7,241,1400,1549,37.5,180,-30,1369,92,137,3.3,41384
88471,T001038,Total male and female,GM0856,Uden,2017JJ00,2017,41384,617,409,9.8,370,8.9,39,1848,44.5,246,1602,1540,37.1,159,-1,1381,308,341,8.2,41725
88472,T001038,Total male and female,GM0856,Uden,2018JJ00,2018,41725,623,365,8.7,386,9.2,-21,1797,43,263,1534,1720,41.2,202,-41,1518,77,57,1.4,41782
88473,T001038,Total male and female,GM0856,Uden,2019JJ00,2019,41782,624,426,10.2,370,8.8,56,1921,45.8,325,1596,1640,39.1,217,-46,1423,281,337,8.1,42119
88474,T001038,Total male and female,GM0856,Uden,2020JJ00,2020,42119,629,415,9.8,472,11.2,-57,1906,45.2,300,1606,1674,39.7,150,-6,1524,232,172,4.1,42291
88475,T001038,Total male and female,GM0856,Uden,2021JJ00,2021,42291,631,428,10.1,433,10.2,-5,1730,40.8,245,1485,1566,37,243,-61,1323,164,175,4.1,42466
88630,T001038,Total male and female,GM0450,Uitgeest,2012JJ00,2012,12897,672,126,9.7,79,6.1,47,573,44.1,32,541,455,35.1,33,-7,422,118,164,12.7,13061
88631,T001038,Total male and female,GM0450,Uitgeest,2013JJ00,2013,13061,682,133,10.1,85,6.5,48,568,43.2,46,522,440,33.5,28,-10,412,128,173,13.2,13234
88632,T001038,Total male and female,GM0450,Uitgeest,2014JJ00,2014,13234,691,156,11.8,72,5.4,84,511,38.5,34,477,539,40.6,20,-1,519,-28,57,4.3,13291
88633,T001038,Total male and female,GM0450,Uitgeest,2015JJ00,2015,13291,694,146,11,74,5.6,72,527,39.5,23,504,532,39.9,28,-3,504,-5,69,5.2,13360
88634,T001038,Total male and female,GM0450,Uitgeest,2016JJ00,2016,13360,697,144,10.7,78,5.8,66,638,47.6,55,583,594,44.3,18,2,576,44,105,7.9,13465
88635,T001038,Total male and female,GM0450,Uitgeest,2017JJ00,2017,13465,702,127,9.4,86,6.4,41,621,46,49,572,607,45,49,-4,558,14,55,4.1,13520
88636,T001038,Total male and female,GM0450,Uitgeest,2018JJ00,2018,13520,706,144,10.6,95,7,49,529,39.1,41,488,569,42.1,46,-7,523,-40,8,0.6,13528
88637,T001038,Total male and female,GM0450,Uitgeest,2019JJ00,2019,13528,706,135,9.9,79,5.8,56,666,49,52,614,586,43.1,46,-11,540,80,138,10.2,13666
88638,T001038,Total male and female,GM0450,Uitgeest,2020JJ00,2020,13666,713,122,8.9,102,7.5,20,636,46.6,44,592,690,50.6,31,-3,659,-54,-34,-2.5,13632
88639,T001038,Total male and female,GM0450,Uitgeest,2021JJ00,2021,13632,711,146,10.7,112,8.2,34,557,41,48,509,660,48.5,43,-2,617,-103,-69,-5.1,13563
88640,T001038,Total male and female,GM0450,Uitgeest,2022JJ00,2022,13563,708,103,7.6,95,7,8,649,48,74,575,745,55.1,65,-6,680,-96,-91,-6.7,13472
88641,T001038,Total male and female,GM0450,Uitgeest,2023JJ00,2023,13472,703,128,9.5,107,8,21,559,41.6,73,486,653,48.6,42,-3,611,-94,-72,-5.3,13400
88712,T001038,Total male and female,GM0451,Uithoorn,2012JJ00,2012,28307,1552,263,9.3,217,7.7,46,1274,44.9,195,1079,1241,43.8,170,-32,1071,33,80,2.8,28387
88713,T001038,Total male and female,GM0451,Uithoorn,2013JJ00,2013,28387,1556,244,8.6,196,6.9,48,1193,42,175,1018,1210,42.6,176,-57,1034,-17,31,1.1,28418
88714,T001038,Total male and female,GM0451,Uithoorn,2014JJ00,2014,28418,1558,259,9.1,203,7.1,56,1565,54.8,261,1304,1305,45.7,176,-48,1129,260,313,11,28731
88715,T001038,Total male and female,GM0451,Uithoorn,2015JJ00,2015,28731,1575,287,9.9,219,7.6,68,1913,66.1,275,1638,1533,52.9,232,-63,1301,380,450,15.7,29181
88716,T001038,Total male and female,GM0451,Uithoorn,2016JJ00,2016,29181,1602,290,9.9,211,7.2,79,1553,53.2,228,1325,1610,55.2,252,-75,1358,-57,20,0.7,29201
88717,T001038,Total male and female,GM0451,Uithoorn,2017JJ00,2017,29201,1603,264,9,241,8.2,23,1871,63.8,256,1615,1651,56.3,160,8,1491,220,244,8.4,29445
88718,T001038,Total male and female,GM0451,Uithoorn,2018JJ00,2018,29445,1623,289,9.8,222,7.5,67,1635,55.5,261,1374,1723,58.5,200,-21,1523,-88,-21,-0.7,29424
88719,T001038,Total male and female,GM0451,Uithoorn,2019JJ00,2019,29424,1622,259,8.8,211,7.2,48,1796,61,336,1460,1792,60.8,283,-52,1509,4,54,1.8,29478
88720,T001038,Total male and female,GM0451,Uithoorn,2020JJ00,2020,29478,1625,298,10,237,7.9,61,2373,79.5,242,2131,1704,57.1,192,-23,1512,669,728,24.7,30206
88721,T001038,Total male and female,GM0451,Uithoorn,2021JJ00,2021,30206,1665,369,12.1,255,8.3,114,2363,77.2,321,2042,1663,54.3,236,-18,1427,700,812,26.9,31018
88722,T001038,Total male and female,GM0451,Uithoorn,2022JJ00,2022,31018,1712,301,9.6,246,7.9,55,2176,69.7,541,1635,1805,57.8,278,-24,1527,371,424,13.7,31442
88723,T001038,Total male and female,GM0451,Uithoorn,2023JJ00,2023,31442,1735,299,9.5,217,6.9,82,2042,64.7,465,1577,1880,59.6,355,-78,1525,162,243,7.7,31685
89122,T001038,Total male and female,GM0184,Urk,2012JJ00,2012,18950,1644,377,19.8,80,4.2,297,208,10.9,33,175,230,12,27,-4,203,-22,275,14.5,19225
89123,T001038,Total male and female,GM0184,Urk,2013JJ00,2013,19225,1670,393,20.3,88,4.5,305,232,12,29,203,291,15,21,-3,270,-59,245,12.7,19470
89124,T001038,Total male and female,GM0184,Urk,2014JJ00,2014,19470,1692,380,19.4,99,5.1,281,248,12.7,24,224,294,15,20,0,274,-46,235,12.1,19705
89125,T001038,Total male and female,GM0184,Urk,2015JJ00,2015,19705,1712,400,20.2,90,4.5,310,327,16.5,46,281,357,18,35,-3,322,-30,282,14.3,19987
89126,T001038,Total male and female,GM0184,Urk,2016JJ00,2016,19987,1736,376,18.7,94,4.7,282,308,15.3,32,276,356,17.7,40,-5,316,-48,233,11.7,20220
89127,T001038,Total male and female,GM0184,Urk,2017JJ00,2017,20220,1757,413,20.3,87,4.3,326,323,15.9,63,260,344,16.9,16,0,328,-21,304,15,20524
89128,T001038,Total male and female,GM0184,Urk,2018JJ00,2018,20524,1783,359,17.4,108,5.2,251,329,15.9,51,278,341,16.5,17,3,324,-12,239,11.6,20763
89129,T001038,Total male and female,GM0184,Urk,2019JJ00,2019,20776,1580,389,18.6,88,4.2,301,348,16.6,81,267,394,18.8,61,-11,333,-46,255,12.3,21031
89130,T001038,Total male and female,GM0184,Urk,2020JJ00,2020,21031,1599,388,18.4,132,6.2,256,367,17.4,88,279,427,20.2,36,-3,391,-60,196,9.3,21227
89131,T001038,Total male and female,GM0184,Urk,2021JJ00,2021,21227,1614,425,19.9,120,5.6,305,348,16.3,65,283,412,19.3,55,-4,357,-64,241,11.4,21468
89132,T001038,Total male and female,GM0184,Urk,2022JJ00,2022,21468,1634,397,18.3,97,4.5,300,597,27.6,328,269,538,24.9,92,-31,446,59,361,16.8,21829
89133,T001038,Total male and female,GM0184,Urk,2023JJ00,2023,21829,1661,384,17.5,120,5.5,264,317,14.5,101,216,451,20.6,55,-22,396,-134,129,5.9,21958
89532,T001038,Total male and female,GM0344,Utrecht Municipality,2012JJ00,2012,316275,3353,5117,16,1855,5.8,3262,23971,75.1,4712,19259,21598,67.7,4654,-603,16944,2373,5641,17.8,321916
89533,T001038,Total male and female,GM0344,Utrecht Municipality,2013JJ00,2013,321916,3415,4958,15.3,1900,5.8,3058,25013,77,4905,20108,21852,67.2,4921,-494,16931,3161,6248,19.4,328164
89534,T001038,Total male and female,GM0344,Utrecht Municipality,2014JJ00,2014,328164,3481,5187,15.7,1823,5.5,3364,26602,80.3,5133,21469,23972,72.4,4695,-276,19277,2630,6012,18.3,334176
89535,T001038,Total male and female,GM0344,Utrecht Municipality,2015JJ00,2015,334176,3545,4981,14.8,1914,5.7,3067,27555,81.9,5765,21790,25832,76.8,4802,-545,21030,1723,4791,14.3,338967
89536,T001038,Total male and female,GM0344,Utrecht Municipality,2016JJ00,2016,338967,3600,4936,14.5,1886,5.5,3050,27912,81.9,6422,21490,26907,78.9,4325,-338,22582,1005,4071,12,343038
89537,T001038,Total male and female,GM0344,Utrecht Municipality,2017JJ00,2017,343038,3644,4814,13.9,1929,5.6,2885,28288,81.9,6729,21559,26723,77.4,4707,-534,22016,1565,4445,13,347483
89538,T001038,Total male and female,GM0344,Utrecht Municipality,2018JJ00,2018,347483,3703,4829,13.8,1838,5.2,2991,29270,83.6,7362,21908,26865,76.7,5234,-413,21631,2405,5383,15.5,352866
89539,T001038,Total male and female,GM0344,Utrecht Municipality,2019JJ00,2019,352866,3761,4740,13.3,1923,5.4,2817,29858,84.1,8375,21483,27907,78.6,5769,-417,22138,1951,4731,13.4,357597
89540,T001038,Total male and female,GM0344,Utrecht Municipality,2020JJ00,2020,357597,3811,4805,13.4,2068,5.8,2737,28253,78.8,6555,21698,29211,81.5,5313,-39,23898,-958,1773,5,359370
89541,T001038,Total male and female,GM0344,Utrecht Municipality,2021JJ00,2021,359370,3830,4972,13.8,2076,5.8,2896,29747,82.5,7916,21831,30284,84,4692,-354,25592,-537,2329,6.5,361699
89542,T001038,Total male and female,GM0344,Utrecht Municipality,2022JJ00,2022,361699,3857,4357,11.9,2064,5.7,2293,33535,91.9,10987,22548,29557,81,5158,-132,24399,3978,6248,17.3,367947
89543,T001038,Total male and female,GM0344,Utrecht Municipality,2023JJ00,2023,367947,3924,4145,11.2,2149,5.8,1996,34277,92.4,9409,24868,29965,80.7,5582,-616,24383,4312,6291,17.1,374238
89614,T001038,Total male and female,GM1581,Utrechtse Heuvelrug,2012JJ00,2012,48267,365,357,7.4,551,11.4,-194,2751,57.1,630,2121,2737,56.8,213,-52,2524,14,-175,-3.6,48092
89615,T001038,Total male and female,GM1581,Utrechtse Heuvelrug,2013JJ00,2013,48092,364,332,6.9,588,12.2,-256,3057,63.7,736,2321,2951,61.5,191,-18,2760,106,-141,-2.9,47951
89616,T001038,Total male and female,GM1581,Utrechtse Heuvelrug,2014JJ00,2014,47951,363,353,7.3,529,11,-176,3605,75,823,2782,3199,66.6,224,-22,2975,406,232,4.8,48183
89617,T001038,Total male and female,GM1581,Utrechtse Heuvelrug,2015JJ00,2015,48183,364,390,8.1,588,12.2,-198,4131,85.4,1056,3075,3612,74.7,227,-8,3385,519,323,6.7,48506
89618,T001038,Total male and female,GM1581,Utrechtse Heuvelrug,2016JJ00,2016,48506,367,377,7.7,588,12.1,-211,4418,90.6,815,3603,3682,75.5,203,-2,3479,736,529,10.9,49035
89619,T001038,Total male and female,GM1581,Utrechtse Heuvelrug,2017JJ00,2017,49035,371,404,8.2,592,12,-188,3850,78.3,282,3568,3382,68.8,212,-22,3170,468,279,5.7,49314
89620,T001038,Total male and female,GM1581,Utrechtse Heuvelrug,2018JJ00,2018,49314,374,435,8.8,517,10.5,-82,3495,70.7,321,3174,3215,65.1,179,-12,3036,280,201,4.1,49515
89621,T001038,Total male and female,GM1581,Utrechtse Heuvelrug,2019JJ00,2019,49515,375,363,7.3,600,12.1,-237,3548,71.6,301,3247,3243,65.5,222,-33,3021,305,65,1.3,49580
89622,T001038,Total male and female,GM1581,Utrechtse Heuvelrug,2020JJ00,2020,49580,376,406,8.2,632,12.7,-226,3700,74.4,269,3431,3112,62.5,223,-22,2889,588,366,7.4,49946
89623,T001038,Total male and female,GM1581,Utrechtse Heuvelrug,2021JJ00,2021,49946,378,440,8.8,621,12.4,-181,3529,70.6,275,3254,3312,66.3,266,-90,3046,217,35,0.7,49981
89624,T001038,Total male and female,GM1581,Utrechtse Heuvelrug,2022JJ00,2022,49981,379,363,7.2,643,12.8,-280,3809,75.9,604,3205,3079,61.3,254,13,2825,730,448,9,50429
89625,T001038,Total male and female,GM1581,Utrechtse Heuvelrug,2023JJ00,2023,50429,382,377,7.5,650,12.9,-273,3757,74.4,327,3430,3362,66.6,340,-44,3022,395,121,2.4,50550
89696,T001038,Total male and female,GM0981,Vaals,2012JJ00,2012,9749,409,64,6.6,107,11,-43,631,64.7,301,330,568,58.2,239,-58,329,63,22,2.3,9771
89697,T001038,Total male and female,GM0981,Vaals,2013JJ00,2013,9771,410,60,6.2,113,11.6,-53,566,58.2,266,300,599,61.6,292,-41,307,-33,-86,-8.8,9685
89698,T001038,Total male and female,GM0981,Vaals,2014JJ00,2014,9685,406,58,6,137,14.1,-79,654,67.5,303,351,568,58.6,281,-48,287,86,9,0.9,9694
89699,T001038,Total male and female,GM0981,Vaals,2015JJ00,2015,9694,406,60,6.2,147,15.2,-87,593,61.4,264,329,571,59.1,268,-34,303,22,-62,-6.4,9632
89700,T001038,Total male and female,GM0981,Vaals,2016JJ00,2016,9632,403,66,6.8,123,12.7,-57,730,75.5,365,365,595,61.5,259,-35,336,135,78,8.1,9710
89701,T001038,Total male and female,GM0981,Vaals,2017JJ00,2017,9710,406,46,4.7,120,12.3,-74,864,88.2,532,332,625,63.8,317,-61,308,239,164,16.9,9874
89702,T001038,Total male and female,GM0981,Vaals,2018JJ00,2018,9874,413,61,6.1,123,12.3,-62,862,86.3,580,282,581,58.2,292,-60,289,281,218,22.1,10092
89703,T001038,Total male and female,GM0981,Vaals,2019JJ00,2019,10092,422,56,5.5,109,10.8,-53,731,72.4,446,285,663,65.7,376,-34,287,68,13,1.3,10105
89704,T001038,Total male and female,GM0981,Vaals,2020JJ00,2020,10105,423,57,5.6,133,13.2,-76,713,70.6,390,323,658,65.2,350,-18,308,55,-21,-2.1,10084
89705,T001038,Total male and female,GM0981,Vaals,2021JJ00,2021,10084,422,62,6.1,150,14.8,-88,765,75.7,396,369,628,62.1,335,-33,293,137,51,5.1,10135
89706,T001038,Total male and female,GM0981,Vaals,2022JJ00,2022,10135,424,48,4.7,140,13.8,-92,882,86.8,551,331,734,72.2,353,-4,381,148,55,5.4,10190
89707,T001038,Total male and female,GM0981,Vaals,2023JJ00,2023,10190,427,51,5,139,13.7,-88,778,76.6,399,379,755,74.3,403,-46,352,23,-69,-6.8,10121
89942,T001038,Total male and female,GM0994,Valkenburg aan de Geul,2012JJ00,2012,16945,461,97,5.7,218,12.9,-121,728,43.1,86,642,733,43.4,95,-3,638,-5,-131,-7.7,16814
89943,T001038,Total male and female,GM0994,Valkenburg aan de Geul,2013JJ00,2013,16814,458,92,5.5,235,14,-143,772,46.1,102,670,767,45.8,92,-1,675,5,-139,-8.3,16675
89944,T001038,Total male and female,GM0994,Valkenburg aan de Geul,2014JJ00,2014,16675,454,102,6.1,216,13,-114,897,53.9,104,793,840,50.5,106,-21,734,57,-57,-3.4,16618
89945,T001038,Total male and female,GM0994,Valkenburg aan de Geul,2015JJ00,2015,16618,452,98,5.9,240,14.5,-142,982,59.3,109,873,939,56.7,95,-21,844,43,-100,-6,16518
89946,T001038,Total male and female,GM0994,Valkenburg aan de Geul,2016JJ00,2016,16518,450,105,6.4,213,12.9,-108,962,58.4,71,891,936,56.8,96,-6,840,26,-78,-4.7,16440
89947,T001038,Total male and female,GM0994,Valkenburg aan de Geul,2017JJ00,2017,16440,448,102,6.2,229,13.9,-127,1055,64.2,128,927,937,57,77,7,860,118,-9,-0.5,16431
89948,T001038,Total male and female,GM0994,Valkenburg aan de Geul,2018JJ00,2018,16431,447,97,5.9,213,12.9,-116,1053,64,139,914,895,54.4,95,-2,800,158,39,2.4,16470
89949,T001038,Total male and female,GM0994,Valkenburg aan de Geul,2019JJ00,2019,16470,448,100,6.1,229,13.9,-129,1005,61.2,139,866,980,59.7,103,-13,877,25,-103,-6.3,16367
89950,T001038,Total male and female,GM0994,Valkenburg aan de Geul,2020JJ00,2020,16367,446,123,7.5,244,14.9,-121,1113,68,139,974,997,60.9,76,-1,921,116,-2,-0.1,16365
89951,T001038,Total male and female,GM0994,Valkenburg aan de Geul,2021JJ00,2021,16365,446,102,6.3,267,16.4,-165,1008,62,120,888,1034,63.6,110,-22,924,-26,-198,-12.1,16167
89952,T001038,Total male and female,GM0994,Valkenburg aan de Geul,2022JJ00,2022,16167,440,100,6.1,215,13.2,-115,1384,84.9,422,962,1009,61.9,161,-11,848,375,256,15.8,16423
89953,T001038,Total male and female,GM0994,Valkenburg aan de Geul,2023JJ00,2023,16423,447,93,5.7,252,15.3,-159,1132,68.9,229,903,968,58.9,163,-21,805,164,8,0.5,16431
90188,T001038,Total male and female,GM0858,Valkenswaard,2012JJ00,2012,30666,557,249,8.1,282,9.2,-33,1017,33.2,183,834,1065,34.8,189,-41,876,-48,-82,-2.7,30584
90189,T001038,Total male and female,GM0858,Valkenswaard,2013JJ00,2013,30584,557,207,6.8,305,10,-98,967,31.7,144,823,1119,36.7,139,-3,980,-152,-249,-8.1,30335
90190,T001038,Total male and female,GM0858,Valkenswaard,2014JJ00,2014,30335,552,239,7.9,291,9.6,-52,1136,37.5,226,910,1188,39.2,229,-25,959,-52,-101,-3.3,30234
90191,T001038,Total male and female,GM0858,Valkenswaard,2015JJ00,2015,30234,551,264,8.7,321,10.6,-57,1159,38.3,210,949,1072,35.4,163,-23,909,87,28,0.9,30262
90192,T001038,Total male and female,GM0858,Valkenswaard,2016JJ00,2016,30262,551,241,7.9,309,10.2,-68,1612,53,285,1327,1290,42.4,165,-30,1125,322,254,8.4,30516
90193,T001038,Total male and female,GM0858,Valkenswaard,2017JJ00,2017,30516,556,261,8.5,322,10.5,-61,1404,45.9,204,1200,1201,39.3,142,5,1059,203,138,4.5,30654
90194,T001038,Total male and female,GM0858,Valkenswaard,2018JJ00,2018,30654,558,269,8.7,356,11.6,-87,1411,45.8,221,1190,1068,34.7,152,-10,916,343,256,8.4,30910
90195,T001038,Total male and female,GM0858,Valkenswaard,2019JJ00,2019,30910,563,252,8.1,357,11.5,-105,1433,46.1,240,1193,1043,33.6,134,-4,909,390,283,9.2,31193
90196,T001038,Total male and female,GM0858,Valkenswaard,2020JJ00,2020,31193,568,259,8.3,390,12.5,-131,1389,44.5,215,1174,1227,39.3,167,-6,1060,162,28,0.9,31221
90197,T001038,Total male and female,GM0858,Valkenswaard,2021JJ00,2021,31221,568,274,8.8,394,12.6,-120,1462,46.8,231,1231,1327,42.5,224,-22,1103,135,15,0.5,31236
90198,T001038,Total male and female,GM0858,Valkenswaard,2022JJ00,2022,31236,569,264,8.4,383,12.2,-119,1648,52.5,433,1215,1239,39.5,309,-54,930,409,291,9.3,31527
90199,T001038,Total male and female,GM0858,Valkenswaard,2023JJ00,2023,31527,574,291,9.2,374,11.8,-83,1670,52.8,344,1326,1399,44.2,266,-31,1133,271,187,5.9,31714
90434,T001038,Total male and female,GM0047,Veendam,2012JJ00,2012,27920,367,273,9.8,317,11.4,-44,1102,39.5,76,1026,1067,38.2,67,3,1000,35,-6,-0.2,27914
90435,T001038,Total male and female,GM0047,Veendam,2013JJ00,2013,27914,367,259,9.3,321,11.5,-62,1086,39,56,1030,1147,41.2,99,-12,1048,-61,-122,-4.4,27792
90436,T001038,Total male and female,GM0047,Veendam,2014JJ00,2014,27792,366,238,8.6,304,11,-66,1104,39.8,86,1018,1135,40.9,72,-13,1063,-31,-97,-3.5,27695
90437,T001038,Total male and female,GM0047,Veendam,2015JJ00,2015,27695,364,223,8.1,302,10.9,-79,1126,40.8,69,1057,1275,46.2,129,-36,1146,-149,-228,-8.2,27467
90438,T001038,Total male and female,GM0047,Veendam,2016JJ00,2016,27467,361,232,8.4,322,11.7,-90,1351,49.1,91,1260,1201,43.7,98,-23,1103,150,60,2.2,27527
90439,T001038,Total male and female,GM0047,Veendam,2017JJ00,2017,27527,362,209,7.6,330,12,-121,1453,52.8,81,1372,1350,49.1,51,16,1299,103,-19,-0.7,27508
90440,T001038,Total male and female,GM0047,Veendam,2018JJ00,2018,27508,362,207,7.5,309,11.2,-102,1405,51.1,95,1310,1321,48,87,-3,1234,84,-17,-0.6,27491
90441,T001038,Total male and female,GM0047,Veendam,2019JJ00,2019,27491,362,213,7.8,318,11.6,-105,1448,52.8,121,1327,1447,52.7,84,-13,1363,1,-107,-3.9,27384
90442,T001038,Total male and female,GM0047,Veendam,2020JJ00,2020,27384,360,211,7.7,310,11.3,-99,1424,52,97,1327,1292,47.2,86,-6,1206,132,33,1.2,27417
90443,T001038,Total male and female,GM0047,Veendam,2021JJ00,2021,27417,361,214,7.8,330,12,-116,1426,52,103,1323,1259,45.9,88,-12,1171,167,49,1.8,27466
90444,T001038,Total male and female,GM0047,Veendam,2022JJ00,2022,27466,362,241,8.8,282,10.2,-41,1408,51.1,192,1216,1217,44.2,92,-14,1125,191,150,5.5,27616
90445,T001038,Total male and female,GM0047,Veendam,2023JJ00,2023,27616,364,202,7.3,313,11.4,-111,1252,45.4,110,1142,1237,44.9,114,-29,1123,15,-96,-3.5,27520
90516,T001038,Total male and female,GM0345,Veenendaal,2012JJ00,2012,62870,3222,708,11.2,463,7.4,245,2042,32.4,219,1823,2126,33.8,255,-26,1871,-84,162,2.6,63032
90517,T001038,Total male and female,GM0345,Veenendaal,2013JJ00,2013,63032,3232,725,11.5,411,6.5,314,2008,31.8,223,1785,2106,33.4,204,-49,1902,-98,220,3.5,63252
90518,T001038,Total male and female,GM0345,Veenendaal,2014JJ00,2014,63252,3244,772,12.2,441,7,331,1994,31.5,193,1801,2139,33.8,279,-28,1860,-145,188,3,63440
90519,T001038,Total male and female,GM0345,Veenendaal,2015JJ00,2015,63440,3253,742,11.7,467,7.3,275,2245,35.3,290,1955,2145,33.7,227,-25,1918,100,376,5.9,63816
90520,T001038,Total male and female,GM0345,Veenendaal,2016JJ00,2016,63816,3276,836,13.1,505,7.9,331,2526,39.4,234,2292,2394,37.4,238,-42,2156,132,461,7.2,64277
90521,T001038,Total male and female,GM0345,Veenendaal,2017JJ00,2017,64277,3300,780,12.1,483,7.5,297,2783,43.1,246,2537,2438,37.7,204,-29,2234,345,641,10,64918
90522,T001038,Total male and female,GM0345,Veenendaal,2018JJ00,2018,64918,3336,733,11.2,515,7.9,218,2678,41,283,2395,2225,34.1,169,-16,2056,453,671,10.3,65589
90523,T001038,Total male and female,GM0345,Veenendaal,2019JJ00,2019,65589,3370,850,12.9,497,7.5,353,2880,43.6,299,2581,2329,35.3,156,-18,2173,551,904,13.8,66493
90524,T001038,Total male and female,GM0345,Veenendaal,2020JJ00,2020,66493,3417,800,12,607,9.1,193,2685,40.3,301,2384,2458,36.9,165,-41,2293,227,419,6.3,66912
90525,T001038,Total male and female,GM0345,Veenendaal,2021JJ00,2021,66912,3438,814,12.1,597,8.9,217,2998,44.6,277,2721,2453,36.5,253,-49,2200,545,759,11.3,67671
90526,T001038,Total male and female,GM0345,Veenendaal,2022JJ00,2022,67671,3485,806,11.8,577,8.5,229,2887,42.4,549,2338,2263,33.2,240,-30,2023,624,854,12.6,68525
90527,T001038,Total male and female,GM0345,Veenendaal,2023JJ00,2023,68525,3529,767,11.1,554,8,213,3236,46.9,434,2802,2532,36.7,278,-71,2254,704,915,13.4,69440
90598,T001038,Total male and female,GM0717,Veere,2012JJ00,2012,21959,165,190,8.7,200,9.1,-10,897,40.9,115,782,943,43,87,-9,856,-46,-56,-2.6,21903
90599,T001038,Total male and female,GM0717,Veere,2013JJ00,2013,21903,165,205,9.4,193,8.8,12,851,38.9,93,758,898,41,56,0,842,-47,-35,-1.6,21868
90600,T001038,Total male and female,GM0717,Veere,2014JJ00,2014,21868,164,204,9.3,191,8.7,13,901,41.1,89,812,856,39.1,71,-11,785,45,58,2.7,21926
90601,T001038,Total male and female,GM0717,Veere,2015JJ00,2015,21926,165,215,9.8,230,10.5,-15,966,44,94,872,917,41.8,71,-11,846,49,34,1.6,21960
90602,T001038,Total male and female,GM0717,Veere,2016JJ00,2016,21960,165,215,9.8,236,10.8,-21,994,45.3,100,894,1034,47.2,69,-9,965,-40,-60,-2.7,21900
90603,T001038,Total male and female,GM0717,Veere,2017JJ00,2017,21900,165,193,8.8,223,10.2,-30,985,45,105,880,986,45.1,73,-10,913,-1,-33,-1.5,21867
90604,T001038,Total male and female,GM0717,Veere,2018JJ00,2018,21867,165,195,8.9,229,10.5,-34,986,45.1,89,897,984,45,91,-12,893,2,-32,-1.5,21835
90605,T001038,Total male and female,GM0717,Veere,2019JJ00,2019,21835,165,196,9,223,10.2,-27,943,43.1,125,818,871,39.8,65,-9,806,72,45,2.1,21880
90606,T001038,Total male and female,GM0717,Veere,2020JJ00,2020,21880,165,207,9.4,213,9.7,-6,1035,47.2,117,918,956,43.6,49,-2,907,79,73,3.3,21953
90607,T001038,Total male and female,GM0717,Veere,2021JJ00,2021,21953,166,204,9.3,255,11.6,-51,871,39.8,91,780,924,42.2,86,-13,838,-53,-103,-4.7,21850
90608,T001038,Total male and female,GM0717,Veere,2022JJ00,2022,21850,164,193,8.8,245,11.2,-52,1208,55,387,821,959,43.7,144,-19,815,249,195,8.9,22045
90609,T001038,Total male and female,GM0717,Veere,2023JJ00,2023,22045,166,176,8,269,12.2,-93,1054,47.8,179,875,940,42.6,120,-19,820,114,22,1,22067
90680,T001038,Total male and female,GM0860,Veghel,2012JJ00,2012,37553,480,392,10.5,266,7.1,126,1206,32.2,237,969,1448,38.6,212,-52,1236,-242,-116,-3.1,37437
90681,T001038,Total male and female,GM0860,Veghel,2013JJ00,2013,37437,479,353,9.4,288,7.7,65,1385,37,233,1152,1423,38,204,-44,1219,-38,27,0.7,37464
90682,T001038,Total male and female,GM0860,Veghel,2014JJ00,2014,37464,479,403,10.7,283,7.5,120,1658,44.1,475,1183,1485,39.5,288,-75,1197,173,290,7.7,37754
90683,T001038,Total male and female,GM0860,Veghel,2015JJ00,2015,37754,483,369,9.7,307,8.1,62,1795,47.3,381,1414,1533,40.4,254,-67,1279,262,324,8.6,38078
90684,T001038,Total male and female,GM0860,Veghel,2016JJ00,2016,38078,487,403,10.6,292,7.7,111,1661,43.5,362,1299,1548,40.6,275,-58,1273,113,177,4.6,38255
90762,T001038,Total male and female,GM0861,Veldhoven,2012JJ00,2012,43880,1383,453,10.3,308,7,145,1909,43.4,348,1561,1837,41.8,279,-32,1558,72,212,4.8,44092
90763,T001038,Total male and female,GM0861,Veldhoven,2013JJ00,2013,44092,1390,437,9.9,302,6.8,135,1901,43.1,353,1548,1971,44.7,317,-40,1654,-70,63,1.4,44155
90764,T001038,Total male and female,GM0861,Veldhoven,2014JJ00,2014,44155,1392,424,9.6,331,7.5,93,1936,43.8,287,1649,2014,45.6,306,-20,1708,-78,11,0.2,44166
90765,T001038,Total male and female,GM0861,Veldhoven,2015JJ00,2015,44166,1392,409,9.2,356,8,53,2148,48.6,284,1864,2049,46.3,381,-51,1668,99,151,3.4,44317
90766,T001038,Total male and female,GM0861,Veldhoven,2016JJ00,2016,44317,1397,396,8.9,392,8.8,4,2542,57.1,323,2219,2131,47.9,306,-27,1825,411,407,9.2,44724
90767,T001038,Total male and female,GM0861,Veldhoven,2017JJ00,2017,44724,1411,414,9.2,375,8.4,39,2575,57.4,317,2258,2408,53.7,241,-26,2167,167,201,4.5,44925
90768,T001038,Total male and female,GM0861,Veldhoven,2018JJ00,2018,44925,1418,377,8.4,367,8.1,10,2609,57.8,397,2212,2205,48.9,257,-47,1948,404,412,9.2,45337
90769,T001038,Total male and female,GM0861,Veldhoven,2019JJ00,2019,45337,1431,401,8.8,384,8.5,17,2486,54.8,432,2054,2371,52.2,279,-22,2092,115,129,2.8,45466
90770,T001038,Total male and female,GM0861,Veldhoven,2020JJ00,2020,45466,1435,402,8.8,405,8.9,-3,2392,52.6,352,2040,2351,51.7,230,-37,2121,41,34,0.7,45500
90771,T001038,Total male and female,GM0861,Veldhoven,2021JJ00,2021,45500,1436,399,8.7,437,9.6,-38,2745,60.1,421,2324,2381,52.1,286,-44,2095,364,322,7.1,45822
90772,T001038,Total male and female,GM0861,Veldhoven,2022JJ00,2022,45822,1446,355,7.7,417,9,-62,3285,71.2,719,2566,2628,57,366,-47,2262,657,595,13,46417
90773,T001038,Total male and female,GM0861,Veldhoven,2023JJ00,2023,46417,1465,384,8.2,431,9.2,-47,3154,67.7,605,2549,2690,57.7,360,-32,2330,464,410,8.8,46827
91008,T001038,Total male and female,GM0453,Velsen,2012JJ00,2012,67286,1503,592,8.8,645,9.6,-53,2385,35.5,387,1998,2496,37.1,337,-77,2159,-111,-164,-2.4,67122
91009,T001038,Total male and female,GM0453,Velsen,2013JJ00,2013,67122,1499,612,9.1,669,10,-57,2537,37.8,378,2159,2380,35.4,319,-61,2061,157,98,1.5,67220
91010,T001038,Total male and female,GM0453,Velsen,2014JJ00,2014,67220,1501,587,8.7,666,9.9,-79,2789,41.5,411,2378,2765,41.2,361,-86,2404,24,-54,-0.8,67166
91011,T001038,Total male and female,GM0453,Velsen,2015JJ00,2015,67166,1500,616,9.2,679,10.1,-63,3101,46.1,485,2616,2760,41,367,-77,2393,341,282,4.2,67448
91012,T001038,Total male and female,GM0453,Velsen,2016JJ00,2016,67448,1506,632,9.4,704,10.4,-72,3074,45.5,413,2661,2828,41.9,364,-98,2464,246,171,2.5,67619
91013,T001038,Total male and female,GM0453,Velsen,2017JJ00,2017,67619,1509,592,8.7,687,10.1,-95,3242,47.9,409,2833,2934,43.3,341,-63,2593,308,212,3.1,67831
91014,T001038,Total male and female,GM0453,Velsen,2018JJ00,2018,67831,1501,584,8.6,667,9.8,-83,3229,47.4,544,2685,2639,38.8,394,-68,2245,590,517,7.6,68348
91015,T001038,Total male and female,GM0453,Velsen,2019JJ00,2019,68348,1512,588,8.6,702,10.2,-114,3474,50.7,527,2947,3059,44.7,439,-108,2620,415,300,4.4,68648
91016,T001038,Total male and female,GM0453,Velsen,2020JJ00,2020,68648,1519,615,9,762,11.1,-147,3202,46.7,410,2792,3086,45,350,-74,2736,116,-31,-0.5,68617
91017,T001038,Total male and female,GM0453,Velsen,2021JJ00,2021,68617,1518,632,9.2,762,11.1,-130,3063,44.7,379,2684,3068,44.8,316,-58,2752,-5,-135,-2,68482
91018,T001038,Total male and female,GM0453,Velsen,2022JJ00,2022,68482,1521,622,9.1,773,11.3,-151,3502,51,813,2689,3042,44.3,376,-53,2666,460,308,4.5,68790
91019,T001038,Total male and female,GM0453,Velsen,2023JJ00,2023,68790,1528,590,8.5,812,11.8,-222,4074,59,750,3324,3400,49.3,498,-122,2902,674,451,6.6,69241
91172,T001038,Total male and female,GM0983,Venlo,2012JJ00,2012,100027,800,989,9.9,918,9.2,71,3301,33,1188,2113,3244,32.4,740,-135,2504,57,132,1.3,100159
91173,T001038,Total male and female,GM0983,Venlo,2013JJ00,2013,100159,803,964,9.6,888,8.9,76,3385,33.8,1240,2145,3189,31.8,708,-132,2481,196,269,2.7,100428
91174,T001038,Total male and female,GM0983,Venlo,2014JJ00,2014,100428,806,907,9,905,9,2,3665,36.5,1444,2221,3563,35.5,763,-101,2800,102,108,1.1,100536
91175,T001038,Total male and female,GM0983,Venlo,2015JJ00,2015,100536,806,832,8.3,981,9.8,-149,3608,35.9,1081,2527,3623,36.1,1003,-350,2620,-15,-165,-1.6,100371
91176,T001038,Total male and female,GM0983,Venlo,2016JJ00,2016,100371,807,950,9.4,953,9.5,-3,4226,42,1520,2706,3530,35,702,-103,2828,696,688,6.9,101059
91177,T001038,Total male and female,GM0983,Venlo,2017JJ00,2017,101059,812,947,9.4,995,9.8,-48,4066,40.2,1352,2714,3871,38.3,938,-218,2933,195,133,1.3,101192
91178,T001038,Total male and female,GM0983,Venlo,2018JJ00,2018,101192,814,951,9.4,970,9.6,-19,3924,38.7,1510,2414,3498,34.5,911,-201,2587,426,411,4.1,101603
91179,T001038,Total male and female,GM0983,Venlo,2019JJ00,2019,101603,818,890,8.8,971,9.5,-81,4002,39.4,1624,2378,3717,36.5,1118,-285,2599,285,199,2,101802
91180,T001038,Total male and female,GM0983,Venlo,2020JJ00,2020,101802,819,903,8.9,1039,10.2,-136,3873,38,1468,2405,3552,34.9,896,-131,2656,321,186,1.8,101988
91181,T001038,Total male and female,GM0983,Venlo,2021JJ00,2021,101988,821,970,9.5,1066,10.4,-96,3922,38.4,1415,2507,3667,35.9,973,-296,2694,255,148,1.5,102136
91182,T001038,Total male and female,GM0983,Venlo,2022JJ00,2022,102136,823,864,8.4,1018,9.9,-154,4996,48.6,2448,2548,3655,35.6,1185,-249,2470,1341,1192,11.7,103328
91183,T001038,Total male and female,GM0983,Venlo,2023JJ00,2023,103328,832,874,8.4,1077,10.4,-203,4662,45,1975,2687,3992,38.5,1235,-269,2757,670,461,4.5,103789
91254,T001038,Total male and female,GM0984,Venray,2012JJ00,2012,42959,263,401,9.3,338,7.9,63,1510,35.1,348,1162,1494,34.7,254,-44,1240,16,79,1.8,43038
91255,T001038,Total male and female,GM0984,Venray,2013JJ00,2013,43038,263,419,9.7,322,7.5,97,1440,33.4,338,1102,1463,34,263,-40,1200,-23,74,1.7,43112
91256,T001038,Total male and female,GM0984,Venray,2014JJ00,2014,43112,264,377,8.7,306,7.1,71,1636,37.9,402,1234,1619,37.5,305,-36,1314,17,90,2.1,43202
91257,T001038,Total male and female,GM0984,Venray,2015JJ00,2015,43202,264,350,8.1,354,8.2,-4,1690,39.1,444,1246,1594,36.9,289,-45,1305,96,89,2.1,43291
91258,T001038,Total male and female,GM0984,Venray,2016JJ00,2016,43291,265,430,9.9,329,7.6,101,2009,46.3,492,1517,1835,42.3,298,-49,1537,174,274,6.3,43565
91259,T001038,Total male and female,GM0984,Venray,2017JJ00,2017,43565,267,402,9.3,343,7.9,59,2081,47.9,484,1597,2365,54.4,348,-70,2017,-284,-224,-5.1,43341
91260,T001038,Total male and female,GM0984,Venray,2018JJ00,2018,43341,265,370,8.5,363,8.4,7,1734,40,436,1298,1755,40.5,301,-41,1454,-21,-15,-0.3,43326
91261,T001038,Total male and female,GM0984,Venray,2019JJ00,2019,43326,265,401,9.2,359,8.3,42,1939,44.6,537,1402,1694,39,297,-52,1397,245,288,6.6,43614
91262,T001038,Total male and female,GM0984,Venray,2020JJ00,2020,43614,267,382,8.7,416,9.5,-34,1841,42.2,452,1389,1707,39.1,260,-26,1447,134,99,2.3,43713
91263,T001038,Total male and female,GM0984,Venray,2021JJ00,2021,43713,268,417,9.5,439,10,-22,2045,46.6,494,1551,1772,40.4,330,-54,1442,273,251,5.7,43964
91264,T001038,Total male and female,GM0984,Venray,2022JJ00,2022,43964,269,356,8,411,9.3,-55,2454,55.4,929,1525,1735,39.2,421,-68,1314,719,664,15.1,44628
91265,T001038,Total male and female,GM0984,Venray,2023JJ00,2023,44628,273,332,7.4,436,9.8,-104,2266,50.8,846,1420,2127,47.6,604,-151,1523,139,34,0.8,44662
91418,T001038,Total male and female,GM0620,Vianen,2012JJ00,2012,19670,499,199,10.1,141,7.2,58,706,35.9,67,639,764,38.8,56,-4,708,-58,0,0,19670
91419,T001038,Total male and female,GM0620,Vianen,2013JJ00,2013,19670,501,208,10.6,153,7.8,55,648,33,65,583,781,39.8,99,-20,682,-133,-74,-3.8,19596
91420,T001038,Total male and female,GM0620,Vianen,2014JJ00,2014,19596,499,195,9.9,144,7.3,51,776,39.6,58,718,791,40.3,46,-5,745,-15,36,1.8,19632
91421,T001038,Total male and female,GM0620,Vianen,2015JJ00,2015,19632,500,185,9.5,185,9.5,0,781,39.9,72,709,902,46.1,101,-19,801,-121,-119,-6.1,19513
91422,T001038,Total male and female,GM0620,Vianen,2016JJ00,2016,19513,498,176,9,171,8.7,5,1118,57,66,1052,920,46.9,58,1,862,198,201,10.3,19714
91423,T001038,Total male and female,GM0620,Vianen,2017JJ00,2017,19714,503,191,9.6,184,9.3,7,1234,62.2,55,1179,988,49.8,64,-6,924,246,253,12.8,19967
91424,T001038,Total male and female,GM0620,Vianen,2018JJ00,2018,19967,509,213,10.5,190,9.4,23,1292,63.9,75,1217,839,41.5,56,0,783,453,477,23.9,20444
91671,T001038,Total male and female,GM1961,Vijfheerenlanden,2019JJ00,2019,55712,381,640,11.4,531,9.4,109,3008,53.5,302,2706,2019,35.9,170,-33,1849,989,1099,19.7,56811
91672,T001038,Total male and female,GM1961,Vijfheerenlanden,2020JJ00,2020,56811,388,658,11.5,613,10.7,45,3029,52.8,204,2825,2054,35.8,120,-16,1934,975,1018,17.9,57829
91673,T001038,Total male and female,GM1961,Vijfheerenlanden,2021JJ00,2021,57829,395,814,14,601,10.3,213,3058,52.4,221,2837,2310,39.6,180,-6,2130,748,959,16.6,58788
91674,T001038,Total male and female,GM1961,Vijfheerenlanden,2022JJ00,2022,58788,402,689,11.6,573,9.6,116,3370,56.7,504,2866,2219,37.3,244,-16,1975,1151,1264,21.5,60052
91675,T001038,Total male and female,GM1961,Vijfheerenlanden,2023JJ00,2023,60052,411,756,12.4,595,9.8,161,3664,60.2,351,3313,2209,36.3,251,-31,1958,1455,1617,26.9,61669
91828,T001038,Total male and female,GM0622,Vlaardingen,2012JJ00,2012,71042,3005,788,11.1,735,10.4,53,3041,42.8,638,2403,3231,45.5,607,-77,2624,-190,-137,-1.9,70905
91829,T001038,Total male and female,GM0622,Vlaardingen,2013JJ00,2013,70905,2999,724,10.2,708,10,16,3153,44.4,646,2507,3085,43.5,675,-154,2410,68,76,1.1,70981
91830,T001038,Total male and female,GM0622,Vlaardingen,2014JJ00,2014,70981,3003,807,11.3,714,10,93,3688,51.7,1074,2614,3119,43.7,662,-142,2457,569,664,9.4,71645
91831,T001038,Total male and female,GM0622,Vlaardingen,2015JJ00,2015,71645,3031,780,10.9,734,10.2,46,3469,48.4,716,2753,3349,46.7,790,-253,2559,120,163,2.3,71808
91832,T001038,Total male and female,GM0622,Vlaardingen,2016JJ00,2016,71808,3038,807,11.2,790,11,17,3522,49,688,2834,3345,46.5,649,-206,2696,177,191,2.7,71999
91833,T001038,Total male and female,GM0622,Vlaardingen,2017JJ00,2017,71999,3046,789,11,767,10.6,22,3478,48.3,638,2840,3452,47.9,520,-102,2932,26,51,0.7,72050
91834,T001038,Total male and female,GM0622,Vlaardingen,2018JJ00,2018,72050,3057,754,10.4,773,10.7,-19,3790,52.5,760,3030,3416,47.3,505,-73,2911,374,354,4.9,72404
91835,T001038,Total male and female,GM0622,Vlaardingen,2019JJ00,2019,72404,3072,800,11,809,11.1,-9,4347,59.6,1027,3320,3346,45.9,551,-165,2795,1001,993,13.7,73397
91836,T001038,Total male and female,GM0622,Vlaardingen,2020JJ00,2020,73397,3114,841,11.4,830,11.3,11,4237,57.5,948,3289,3718,50.5,637,-134,3081,519,527,7.2,73924
91837,T001038,Total male and female,GM0622,Vlaardingen,2021JJ00,2021,73924,3136,771,10.4,856,11.6,-85,4325,58.4,958,3367,4022,54.3,676,-104,3346,303,219,3,74143
91838,T001038,Total male and female,GM0622,Vlaardingen,2022JJ00,2022,74143,3174,792,10.6,822,11,-30,4612,61.8,1287,3325,3648,48.9,616,-40,3032,964,936,12.6,75079
91839,T001038,Total male and female,GM0622,Vlaardingen,2023JJ00,2023,75079,3214,775,10.2,855,11.3,-80,5344,70.6,1343,4001,3929,51.9,817,-94,3112,1415,1330,17.7,76409
91910,T001038,Total male and female,GM0048,Vlagtwedde,2012JJ00,2012,16260,97,140,8.6,175,10.8,-35,1104,68.2,65,1039,1197,73.9,155,-76,1042,-93,-128,-7.9,16132
91911,T001038,Total male and female,GM0048,Vlagtwedde,2013JJ00,2013,16132,96,114,7.1,197,12.3,-83,769,48,70,699,917,57.2,131,-52,786,-148,-227,-14.1,15905
91912,T001038,Total male and female,GM0048,Vlagtwedde,2014JJ00,2014,15905,95,120,7.5,167,10.4,-47,1864,116.1,1175,689,1514,94.3,163,-74,1351,350,307,19.3,16212
91913,T001038,Total male and female,GM0048,Vlagtwedde,2015JJ00,2015,16212,97,141,8.6,177,10.8,-36,4039,247.5,3338,701,3822,234.2,166,-100,3656,217,210,13,16422
91914,T001038,Total male and female,GM0048,Vlagtwedde,2016JJ00,2016,16422,98,133,8.2,192,11.9,-59,4429,274,3707,722,4903,303.3,115,-65,4788,-474,-514,-31.3,15908
91915,T001038,Total male and female,GM0048,Vlagtwedde,2017JJ00,2017,15908,95,138,8.7,181,11.4,-43,2571,161.8,1605,966,2571,161.8,79,-31,2492,0,-40,-2.5,15868
92238,T001038,Total male and female,GM0096,Vlieland,2012JJ00,2012,1105,31,4,3.6,6,5.4,-2,135,121.7,28,107,124,111.8,19,-11,105,11,9,8.1,1114
92239,T001038,Total male and female,GM0096,Vlieland,2013JJ00,2013,1114,31,4,3.6,7,6.3,-3,144,129.5,24,120,145,130.4,21,-3,124,-1,-4,-3.6,1110
92240,T001038,Total male and female,GM0096,Vlieland,2014JJ00,2014,1110,31,8,7.2,6,5.4,2,148,133.8,25,123,157,141.9,22,-9,135,-9,-7,-6.3,1103
92241,T001038,Total male and female,GM0096,Vlieland,2015JJ00,2015,1103,31,9,8.2,14,12.8,-5,132,120.8,29,103,146,133.6,28,-16,118,-14,-20,-18.1,1083
92242,T001038,Total male and female,GM0096,Vlieland,2016JJ00,2016,1083,31,8,7.4,24,22.1,-16,153,141.1,22,131,133,122.7,8,-1,125,20,2,1.8,1085
92243,T001038,Total male and female,GM0096,Vlieland,2017JJ00,2017,1085,31,5,4.5,13,11.7,-8,198,178.6,51,147,142,128.1,17,-3,125,56,47,43.3,1132
92244,T001038,Total male and female,GM0096,Vlieland,2018JJ00,2018,1132,29,4,3.5,11,9.7,-7,197,173.6,91,106,185,163,59,-9,126,12,6,5.3,1138
92245,T001038,Total male and female,GM0096,Vlieland,2019JJ00,2019,1138,29,7,6.1,11,9.6,-4,253,220.7,101,152,228,198.9,89,-29,139,25,17,14.9,1155
92246,T001038,Total male and female,GM0096,Vlieland,2020JJ00,2020,1155,30,10,8.5,11,9.4,-1,218,185.6,73,145,179,152.4,56,-4,123,39,39,33.8,1194
92247,T001038,Total male and female,GM0096,Vlieland,2021JJ00,2021,1194,30,6,5,8,6.7,-2,246,205.9,97,149,243,203.4,110,-58,133,3,1,0.8,1195
92248,T001038,Total male and female,GM0096,Vlieland,2022JJ00,2022,1195,29,5,4,8,6.4,-3,258,207.6,131,127,158,127.1,47,-4,111,100,96,80.3,1291
92249,T001038,Total male and female,GM0096,Vlieland,2023JJ00,2023,1291,31,12,9.4,10,7.9,2,181,142.2,89,92,217,170.5,83,-39,134,-36,-36,-27.9,1255
92402,T001038,Total male and female,GM0718,Vlissingen,2012JJ00,2012,44502,1302,430,9.7,509,11.4,-79,2392,53.8,721,1671,2364,53.2,685,-338,1679,28,-51,-1.1,44451
92403,T001038,Total male and female,GM0718,Vlissingen,2013JJ00,2013,44451,1300,399,9,518,11.7,-119,2292,51.6,629,1663,2182,49.1,502,-209,1680,110,-7,-0.2,44444
92404,T001038,Total male and female,GM0718,Vlissingen,2014JJ00,2014,44444,1300,401,9,442,9.9,-41,2333,52.5,598,1735,2249,50.6,563,-167,1686,84,41,0.9,44485
92405,T001038,Total male and female,GM0718,Vlissingen,2015JJ00,2015,44485,1301,403,9.1,522,11.7,-119,2452,55.1,662,1790,2367,53.2,537,-189,1830,85,-34,-0.8,44451
92406,T001038,Total male and female,GM0718,Vlissingen,2016JJ00,2016,44451,1298,394,8.9,539,12.1,-145,2520,56.7,584,1936,2431,54.7,546,-180,1885,89,-57,-1.3,44394
92407,T001038,Total male and female,GM0718,Vlissingen,2017JJ00,2017,44394,1297,382,8.6,502,11.3,-120,2634,59.3,706,1928,2421,54.5,497,-142,1924,213,91,2,44485
92408,T001038,Total male and female,GM0718,Vlissingen,2018JJ00,2018,44485,1297,356,8,530,11.9,-174,2740,61.7,797,1943,2679,60.3,623,-218,2056,61,-114,-2.6,44371
92409,T001038,Total male and female,GM0718,Vlissingen,2019JJ00,2019,44371,1293,376,8.5,458,10.3,-82,2677,60.3,940,1737,2603,58.7,610,-211,1993,74,-11,-0.2,44360
92410,T001038,Total male and female,GM0718,Vlissingen,2020JJ00,2020,44360,1293,351,7.9,536,12.1,-185,2741,61.8,777,1964,2559,57.7,489,-127,2070,182,-2,0,44358
92411,T001038,Total male and female,GM0718,Vlissingen,2021JJ00,2021,44358,1293,379,8.5,639,14.4,-260,2876,64.7,812,2064,2385,53.6,581,-209,1804,491,227,5.1,44585
92412,T001038,Total male and female,GM0718,Vlissingen,2022JJ00,2022,44585,1297,359,8,584,13,-225,3456,77,1202,2254,2664,59.4,672,-164,1992,792,565,12.7,45150
92413,T001038,Total male and female,GM0718,Vlissingen,2023JJ00,2023,45150,1314,307,6.8,562,12.4,-255,3404,75.2,945,2459,2901,64.1,719,-260,2182,503,239,5.3,45389
92484,T001038,Total male and female,GM0623,Vlist,2012JJ00,2012,9773,182,83,8.5,94,9.6,-11,325,33.3,26,299,356,36.5,18,-3,338,-31,-43,-4.4,9730
92485,T001038,Total male and female,GM0623,Vlist,2013JJ00,2013,9730,181,77,7.9,77,7.9,0,305,31.4,10,295,342,35.2,6,7,336,-37,-36,-3.7,9694
92486,T001038,Total male and female,GM0623,Vlist,2014JJ00,2014,9694,180,97,10,79,8.1,18,388,39.9,34,354,338,34.8,28,-4,310,50,46,4.7,9740
92648,T001038,Total male and female,GM0986,Voerendaal,2012JJ00,2012,12664,402,82,6.5,90,7.1,-8,497,39.3,49,448,537,42.5,21,6,516,-40,-47,-3.7,12617
92649,T001038,Total male and female,GM0986,Voerendaal,2013JJ00,2013,12617,400,94,7.5,109,8.7,-15,436,34.8,47,389,583,46.5,36,-7,547,-147,-163,-12.9,12454
92650,T001038,Total male and female,GM0986,Voerendaal,2014JJ00,2014,12454,395,102,8.2,120,9.7,-18,542,43.6,25,517,580,46.7,38,2,542,-38,-57,-4.6,12397
92651,T001038,Total male and female,GM0986,Voerendaal,2015JJ00,2015,12397,393,104,8.4,98,7.9,6,560,45,24,536,482,38.7,34,-1,448,78,85,6.9,12482
92652,T001038,Total male and female,GM0986,Voerendaal,2016JJ00,2016,12482,396,102,8.2,114,9.1,-12,555,44.5,34,521,562,45.1,38,-3,524,-7,-20,-1.6,12462
92653,T001038,Total male and female,GM0986,Voerendaal,2017JJ00,2017,12462,395,79,6.4,128,10.3,-49,642,51.7,42,600,666,53.6,38,-2,628,-24,-72,-5.8,12390
92654,T001038,Total male and female,GM0986,Voerendaal,2018JJ00,2018,12390,393,114,9.2,109,8.8,5,648,52.2,62,586,591,47.6,26,1,565,57,62,5,12452
92655,T001038,Total male and female,GM0986,Voerendaal,2019JJ00,2019,12452,395,111,8.9,121,9.7,-10,640,51.3,49,591,610,48.9,25,6,585,30,23,1.8,12475
92656,T001038,Total male and female,GM0986,Voerendaal,2020JJ00,2020,12475,396,83,6.7,147,11.8,-64,644,51.6,51,593,587,47.1,27,-3,560,57,-9,-0.7,12466
92657,T001038,Total male and female,GM0986,Voerendaal,2021JJ00,2021,12466,396,124,10,124,10,0,574,46.1,37,537,614,49.3,41,3,573,-40,-40,-3.2,12426
92658,T001038,Total male and female,GM0986,Voerendaal,2022JJ00,2022,12426,394,101,8.1,147,11.8,-46,584,47,113,471,559,45,37,0,522,25,-21,-1.7,12405
92659,T001038,Total male and female,GM0986,Voerendaal,2023JJ00,2023,12405,394,97,7.8,136,11,-39,593,47.9,76,517,584,47.1,47,1,537,9,-30,-2.4,12375
93069,T001038,Total male and female,GM1992,Voorne aan Zee,2023JJ00,2023,73945,607,571,7.7,782,10.5,-211,3394,45.8,634,2760,2820,38,402,-93,2418,574,359,4.9,74304
93140,T001038,Total male and female,GM0626,Voorschoten,2012JJ00,2012,24310,2178,255,10.4,214,8.7,41,1342,54.8,149,1193,1038,42.4,166,-5,872,304,348,14.3,24658
93141,T001038,Total male and female,GM0626,Voorschoten,2013JJ00,2013,24658,2209,253,10.2,231,9.3,22,1332,53.7,210,1122,1071,43.2,225,-23,846,261,293,11.9,24951
93142,T001038,Total male and female,GM0626,Voorschoten,2014JJ00,2014,24951,2236,235,9.4,217,8.7,18,1367,54.6,188,1179,1186,47.3,210,-2,976,181,199,8,25150
93143,T001038,Total male and female,GM0626,Voorschoten,2015JJ00,2015,25150,2254,239,9.5,213,8.5,26,1393,55.3,234,1159,1356,53.9,273,-21,1083,37,61,2.4,25211
93144,T001038,Total male and female,GM0626,Voorschoten,2016JJ00,2016,25211,2257,233,9.2,241,9.5,-8,1585,62.7,181,1404,1472,58.3,233,-20,1239,113,104,4.1,25315
93145,T001038,Total male and female,GM0626,Voorschoten,2017JJ00,2017,25315,2266,229,9,215,8.5,14,1521,59.9,205,1316,1396,55,246,-33,1150,125,138,5.5,25453
93146,T001038,Total male and female,GM0626,Voorschoten,2018JJ00,2018,25453,2285,229,9,266,10.4,-37,1397,54.9,253,1144,1334,52.4,164,-6,1170,63,26,1,25479
93147,T001038,Total male and female,GM0626,Voorschoten,2019JJ00,2019,25479,2287,234,9.2,235,9.2,-1,1451,56.8,321,1130,1335,52.3,180,-18,1155,116,117,4.6,25596
93148,T001038,Total male and female,GM0626,Voorschoten,2020JJ00,2020,25596,2298,207,8.1,283,11,-76,1440,56.2,244,1196,1310,51.1,189,-25,1121,130,54,2.1,25650
93149,T001038,Total male and female,GM0626,Voorschoten,2021JJ00,2021,25650,2303,229,8.9,252,9.8,-23,1441,56.2,295,1146,1440,56.2,201,-19,1239,1,-23,-0.9,25627
93150,T001038,Total male and female,GM0626,Voorschoten,2022JJ00,2022,25627,2307,210,8.2,286,11.2,-76,1737,67.7,447,1290,1623,63.3,256,-16,1367,114,38,1.5,25665
93151,T001038,Total male and female,GM0626,Voorschoten,2023JJ00,2023,25665,2310,178,6.9,269,10.5,-91,1740,67.8,382,1358,1688,65.8,268,-14,1420,52,-40,-1.6,25625
93222,T001038,Total male and female,GM0285,Voorst,2012JJ00,2012,23719,193,221,9.3,230,9.7,-9,929,39.2,44,885,917,38.7,60,-15,857,12,5,0.2,23724
93223,T001038,Total male and female,GM0285,Voorst,2013JJ00,2013,23724,193,210,8.8,225,9.5,-15,955,40.2,39,916,898,37.8,39,7,859,57,43,1.8,23767
93224,T001038,Total male and female,GM0285,Voorst,2014JJ00,2014,23767,193,225,9.4,206,8.6,19,1041,43.7,63,978,913,38.3,53,-8,860,128,146,6.1,23913
93225,T001038,Total male and female,GM0285,Voorst,2015JJ00,2015,23913,194,213,8.9,224,9.4,-11,1041,43.5,58,983,958,40,48,-12,910,83,71,3,23984
93226,T001038,Total male and female,GM0285,Voorst,2016JJ00,2016,23984,195,204,8.5,231,9.6,-27,1247,51.8,58,1189,1003,41.6,45,4,958,244,215,9,24199
93227,T001038,Total male and female,GM0285,Voorst,2017JJ00,2017,24199,197,191,7.9,227,9.4,-36,1274,52.5,51,1223,1127,46.5,55,-11,1072,147,111,4.6,24310
93228,T001038,Total male and female,GM0285,Voorst,2018JJ00,2018,24310,198,209,8.6,257,10.5,-48,1215,49.9,54,1161,1060,43.5,49,-5,1011,155,107,4.4,24417
93229,T001038,Total male and female,GM0285,Voorst,2019JJ00,2019,24417,199,199,8.1,251,10.3,-52,1189,48.6,60,1129,1002,40.9,55,0,947,187,135,5.5,24552
93230,T001038,Total male and female,GM0285,Voorst,2020JJ00,2020,24552,200,234,9.5,243,9.8,-9,1302,52.8,87,1215,1053,42.7,35,3,1018,249,238,9.7,24790
93231,T001038,Total male and female,GM0285,Voorst,2021JJ00,2021,24790,202,206,8.3,251,10.1,-45,1222,49.1,59,1163,973,39.1,53,-4,920,249,204,8.2,24994
93232,T001038,Total male and female,GM0285,Voorst,2022JJ00,2022,24994,203,233,9.3,279,11.1,-46,1131,45.1,158,973,864,34.4,75,-19,789,267,221,8.8,25215
93233,T001038,Total male and female,GM0285,Voorst,2023JJ00,2023,25215,205,228,9,252,10,-24,1209,47.8,132,1077,1023,40.4,98,-3,925,186,162,6.4,25377
93796,T001038,Total male and female,GM0865,Vught,2012JJ00,2012,25789,770,237,9.2,317,12.3,-80,1702,66.3,119,1583,1846,71.9,215,-55,1631,-144,-225,-8.7,25564
93797,T001038,Total male and female,GM0865,Vught,2013JJ00,2013,25564,763,240,9.4,303,11.8,-63,1638,64,123,1515,1501,58.6,28,43,1473,137,74,2.9,25638
93798,T001038,Total male and female,GM0865,Vught,2014JJ00,2014,25638,766,233,9.1,296,11.5,-63,1772,68.8,118,1654,1494,58,69,3,1425,278,215,8.4,25853
93799,T001038,Total male and female,GM0865,Vught,2015JJ00,2015,25853,772,233,9,341,13.2,-108,1884,72.7,115,1769,1656,63.9,85,25,1571,228,120,4.6,25973
93800,T001038,Total male and female,GM0865,Vught,2016JJ00,2016,25973,775,261,10,298,11.4,-37,1808,69.3,132,1676,1561,59.9,29,50,1532,247,210,8.1,26183
93801,T001038,Total male and female,GM0865,Vught,2017JJ00,2017,26183,782,264,10,301,11.4,-37,1965,74.7,142,1823,1693,64.4,35,46,1658,272,235,9,26418
93802,T001038,Total male and female,GM0865,Vught,2018JJ00,2018,26418,789,292,11.1,302,11.4,-10,1780,67.4,126,1654,1791,67.8,51,35,1740,-11,-22,-0.8,26396
93803,T001038,Total male and female,GM0865,Vught,2019JJ00,2019,26396,782,255,9.6,295,11.1,-40,1869,70.6,177,1692,1666,62.9,65,34,1601,203,162,6.1,26558
93804,T001038,Total male and female,GM0865,Vught,2020JJ00,2020,26558,787,232,8.7,370,13.9,-138,2090,78.4,220,1870,1747,65.5,75,4,1672,343,208,7.8,26766
93805,T001038,Total male and female,GM0865,Vught,2021JJ00,2021,31669,527,310,9.8,368,11.6,-58,2095,66,214,1881,1924,60.6,112,-2,1812,171,114,3.6,31783
93806,T001038,Total male and female,GM0865,Vught,2022JJ00,2022,31783,530,299,9.4,385,12.1,-86,2114,66.2,364,1750,1698,53.1,160,-4,1538,416,330,10.4,32113
93807,T001038,Total male and female,GM0865,Vught,2023JJ00,2023,32113,535,283,8.8,395,12.3,-112,2119,65.7,329,1790,1762,54.7,147,-2,1615,357,243,7.6,32356
93966,T001038,Total male and female,GM1949,Waadhoeke,2018JJ00,2018,46101,161,404,8.8,465,10.1,-61,2302,50,378,1924,2307,50.1,158,-30,2149,-5,-62,-1.3,46039
93967,T001038,Total male and female,GM1949,Waadhoeke,2019JJ00,2019,46039,162,410,8.9,439,9.5,-29,2271,49.3,378,1893,2191,47.6,143,-23,2048,80,51,1.1,46090
93968,T001038,Total male and female,GM1949,Waadhoeke,2020JJ00,2020,46090,162,391,8.5,450,9.8,-59,2204,47.8,218,1986,2089,45.3,170,-51,1919,115,59,1.3,46149
93969,T001038,Total male and female,GM1949,Waadhoeke,2021JJ00,2021,46149,162,436,9.4,519,11.2,-83,2420,52.3,181,2239,2178,47.1,160,-31,2018,242,160,3.5,46309
93970,T001038,Total male and female,GM1949,Waadhoeke,2022JJ00,2022,46309,162,425,9.1,505,10.9,-80,2526,54.3,501,2025,2034,43.7,208,-46,1826,492,409,8.8,46718
93971,T001038,Total male and female,GM1949,Waadhoeke,2023JJ00,2023,46718,164,372,7.9,462,9.9,-90,2410,51.5,455,1955,2136,45.6,291,-76,1845,274,193,4.1,46911
94042,T001038,Total male and female,GM0866,Waalre,2012JJ00,2012,16503,737,141,8.5,152,9.1,-11,901,54.2,78,823,667,40.1,61,3,606,234,222,13.5,16725
94043,T001038,Total male and female,GM0866,Waalre,2013JJ00,2013,16725,747,134,8,154,9.2,-20,861,51.4,96,765,802,47.9,94,-8,708,59,40,2.4,16765
94044,T001038,Total male and female,GM0866,Waalre,2014JJ00,2014,16765,749,146,8.7,152,9,-6,917,54.5,80,837,802,47.7,94,5,708,115,109,6.5,16874
94045,T001038,Total male and female,GM0866,Waalre,2015JJ00,2015,16874,754,153,9,159,9.4,-6,1007,59.4,81,926,853,50.3,99,-8,754,154,149,8.8,17023
94046,T001038,Total male and female,GM0866,Waalre,2016JJ00,2016,17023,760,156,9.2,178,10.5,-22,854,50.4,106,748,957,56.4,126,-6,831,-103,-125,-7.3,16898
94047,T001038,Total male and female,GM0866,Waalre,2017JJ00,2017,16898,755,139,8.2,136,8,3,1054,62,104,950,878,51.7,81,-5,797,176,177,10.5,17075
94048,T001038,Total male and female,GM0866,Waalre,2018JJ00,2018,17075,763,160,9.3,154,9,6,1074,62.6,126,948,909,53,77,6,832,165,172,10.1,17247
94049,T001038,Total male and female,GM0866,Waalre,2019JJ00,2019,17247,770,164,9.5,172,9.9,-8,1134,65.4,144,990,917,52.8,78,0,839,217,209,12.1,17456
94050,T001038,Total male and female,GM0866,Waalre,2020JJ00,2020,17456,780,161,9.2,179,10.2,-18,1073,61.3,139,934,967,55.3,95,-9,872,106,88,5,17544
94051,T001038,Total male and female,GM0866,Waalre,2021JJ00,2021,17544,784,153,8.7,166,9.4,-13,1085,61.7,136,949,988,56.2,112,-8,876,97,82,4.7,17626
94052,T001038,Total male and female,GM0866,Waalre,2022JJ00,2022,17626,788,145,8.1,184,10.3,-39,1316,73.9,291,1025,923,51.8,110,-1,813,393,354,20.1,17980
94053,T001038,Total male and female,GM0866,Waalre,2023JJ00,2023,17980,803,132,7.3,177,9.8,-45,1100,61.2,167,933,1046,58.2,145,-8,901,54,8,0.4,17988
94124,T001038,Total male and female,GM0867,Waalwijk,2012JJ00,2012,46422,719,454,9.8,380,8.2,74,1767,38.1,369,1398,1827,39.3,260,-65,1567,-60,16,0.3,46438
94125,T001038,Total male and female,GM0867,Waalwijk,2013JJ00,2013,46438,719,446,9.6,401,8.6,45,1786,38.4,335,1451,1774,38.2,216,-31,1558,12,60,1.3,46498
94126,T001038,Total male and female,GM0867,Waalwijk,2014JJ00,2014,46498,720,467,10,422,9.1,45,1936,41.5,367,1569,1765,37.9,205,-65,1560,171,215,4.6,46713
94127,T001038,Total male and female,GM0867,Waalwijk,2015JJ00,2015,46713,723,449,9.6,405,8.6,44,2145,45.8,407,1738,1884,40.2,212,-29,1672,261,308,6.6,47021
94128,T001038,Total male and female,GM0867,Waalwijk,2016JJ00,2016,47021,728,468,9.9,407,8.6,61,2341,49.6,464,1877,2014,42.7,268,-87,1746,327,389,8.3,47410
94129,T001038,Total male and female,GM0867,Waalwijk,2017JJ00,2017,47410,734,471,9.9,440,9.3,31,2550,53.6,503,2047,2258,47.5,340,-114,1918,292,315,6.6,47725
94130,T001038,Total male and female,GM0867,Waalwijk,2018JJ00,2018,47725,739,468,9.8,528,11,-60,2718,56.6,612,2106,2142,44.6,291,-93,1851,576,515,10.8,48240
94131,T001038,Total male and female,GM0867,Waalwijk,2019JJ00,2019,48240,747,480,9.9,438,9,42,2705,55.8,593,2112,2352,48.6,339,-107,2013,353,397,8.2,48637
94132,T001038,Total male and female,GM0867,Waalwijk,2020JJ00,2020,48637,753,454,9.3,550,11.3,-96,2775,57,741,2034,2500,51.3,376,-85,2124,275,178,3.7,48815
94133,T001038,Total male and female,GM0867,Waalwijk,2021JJ00,2021,48815,756,478,9.7,488,9.9,-10,3178,64.8,1045,2133,2635,53.7,597,-88,2038,543,527,10.8,49342
94134,T001038,Total male and female,GM0867,Waalwijk,2022JJ00,2022,49342,765,484,9.7,527,10.6,-43,3398,68.4,1247,2151,2745,55.3,757,-111,1988,653,610,12.4,49952
94135,T001038,Total male and female,GM0867,Waalwijk,2023JJ00,2023,49952,774,451,9,488,9.7,-37,3061,61.1,1000,2061,2675,53.4,604,-45,2071,386,350,7,50302
94452,T001038,Total male and female,GM0627,Waddinxveen,2012JJ00,2012,25280,906,226,9,174,6.9,52,893,35.4,85,808,1008,39.9,97,-28,911,-115,-63,-2.5,25217
94453,T001038,Total male and female,GM0627,Waddinxveen,2013JJ00,2013,25217,902,272,10.7,170,6.7,102,1113,43.9,103,1010,925,36.5,83,-5,842,188,291,11.5,25508
94454,T001038,Total male and female,GM0627,Waddinxveen,2014JJ00,2014,25508,912,289,11.3,180,7,109,1053,41.2,129,924,1016,39.7,87,-11,929,37,149,5.8,25657
94455,T001038,Total male and female,GM0627,Waddinxveen,2015JJ00,2015,25657,917,273,10.6,198,7.7,75,1340,51.8,150,1190,998,38.6,68,-16,930,342,415,16.2,26072
94456,T001038,Total male and female,GM0627,Waddinxveen,2016JJ00,2016,26072,932,287,10.9,168,6.4,119,1435,54.6,133,1302,1089,41.4,116,-22,973,346,464,17.8,26536
94457,T001038,Total male and female,GM0627,Waddinxveen,2017JJ00,2017,26536,949,325,12,163,6,162,2074,76.7,161,1913,1189,43.9,134,-33,1055,885,1042,39.3,27578
94458,T001038,Total male and female,GM0627,Waddinxveen,2018JJ00,2018,27578,993,355,12.7,196,7,159,1747,62.5,129,1618,1172,41.9,111,-27,1061,575,738,26.8,28316
94459,T001038,Total male and female,GM0627,Waddinxveen,2019JJ00,2019,28316,1020,365,12.7,194,6.7,171,2065,71.7,144,1921,1260,43.7,113,-32,1147,805,975,34.4,29291
94460,T001038,Total male and female,GM0627,Waddinxveen,2020JJ00,2020,29291,1055,415,13.9,194,6.5,221,2259,75.6,161,2098,1296,43.4,100,-10,1196,963,1188,40.6,30479
94461,T001038,Total male and female,GM0627,Waddinxveen,2021JJ00,2021,30479,1098,472,15.3,214,6.9,258,1947,63,175,1772,1342,43.4,147,-10,1195,605,863,28.3,31342
94462,T001038,Total male and female,GM0627,Waddinxveen,2022JJ00,2022,31342,1129,444,13.9,210,6.6,234,2527,79,413,2114,1503,47,217,-22,1286,1024,1259,40.2,32601
94463,T001038,Total male and female,GM0627,Waddinxveen,2023JJ00,2023,32601,1175,477,14.3,216,6.5,261,2691,80.8,299,2392,1551,46.6,230,-21,1321,1140,1399,42.9,34000
94616,T001038,Total male and female,GM0289,Wageningen,2012JJ00,2012,37049,1215,316,8.5,374,10,-58,3884,104.3,1271,2613,3513,94.4,1249,-328,2264,371,359,9.7,37408
94617,T001038,Total male and female,GM0289,Wageningen,2013JJ00,2013,37408,1228,276,7.4,371,9.9,-95,4459,119.2,1453,3006,4346,116.1,2078,-1026,2268,113,21,0.6,37429
94618,T001038,Total male and female,GM0289,Wageningen,2014JJ00,2014,37429,1228,299,8,351,9.3,-52,4377,116.4,1452,2925,3965,105.4,1445,-236,2520,412,357,9.5,37786
94619,T001038,Total male and female,GM0289,Wageningen,2015JJ00,2015,37786,1240,304,8,374,9.9,-70,4422,116.9,1727,2695,4315,114.1,1536,-389,2779,107,51,1.3,37837
94620,T001038,Total male and female,GM0289,Wageningen,2016JJ00,2016,37837,1244,326,8.5,362,9.5,-36,4995,130.9,1925,3070,4354,114.1,1559,-338,2795,641,621,16.4,38458
94621,T001038,Total male and female,GM0289,Wageningen,2017JJ00,2017,38458,1264,276,7.2,343,8.9,-67,4609,119.9,1891,2718,4552,118.4,1718,-459,2834,57,-46,-1.2,38412
94622,T001038,Total male and female,GM0289,Wageningen,2018JJ00,2018,38412,1263,298,7.7,415,10.8,-117,4965,128.7,1940,3025,4485,116.2,1519,-221,2966,480,362,9.4,38774
94623,T001038,Total male and female,GM0289,Wageningen,2019JJ00,2019,38774,1275,306,7.8,395,10.1,-89,5708,145.5,2191,3517,4728,120.6,1416,-174,3312,980,890,23,39664
94624,T001038,Total male and female,GM0289,Wageningen,2020JJ00,2020,39664,1304,303,7.6,437,11,-134,4839,122,1613,3226,4731,119.3,1402,-159,3329,108,-29,-0.7,39635
94625,T001038,Total male and female,GM0289,Wageningen,2021JJ00,2021,39635,1303,253,6.4,429,10.8,-176,4893,123,2045,2848,4414,110.9,1150,-150,3264,479,304,7.7,39939
94626,T001038,Total male and female,GM0289,Wageningen,2022JJ00,2022,39939,1313,291,7.2,441,10.9,-150,5623,139,2485,3138,4454,110.1,1200,-102,3254,1169,1021,25.6,40960
94627,T001038,Total male and female,GM0289,Wageningen,2023JJ00,2023,40960,1346,247,5.9,422,10.1,-175,6995,167.5,2414,4581,5197,124.4,1531,-155,3666,1798,1619,39.5,42579
95518,T001038,Total male and female,GM0629,Wassenaar,2012JJ00,2012,25762,506,158,6.1,327,12.7,-169,1764,68.6,690,1074,1704,66.3,774,-15,930,60,-106,-4.1,25656
95519,T001038,Total male and female,GM0629,Wassenaar,2013JJ00,2013,25656,504,136,5.3,282,11,-146,1858,72.4,707,1151,1696,66.1,688,-4,1008,162,19,0.7,25675
95520,T001038,Total male and female,GM0629,Wassenaar,2014JJ00,2014,25675,504,166,6.5,309,12,-143,2220,86.4,815,1405,2024,78.7,750,-24,1274,196,56,2.2,25731
95521,T001038,Total male and female,GM0629,Wassenaar,2015JJ00,2015,25731,505,186,7.2,307,11.9,-121,2056,79.7,658,1398,1778,68.9,745,22,1033,278,154,6,25885
95522,T001038,Total male and female,GM0629,Wassenaar,2016JJ00,2016,25885,506,161,6.2,321,12.4,-160,2148,82.7,654,1494,1816,69.9,698,41,1118,332,170,6.6,26055
95523,T001038,Total male and female,GM0629,Wassenaar,2017JJ00,2017,26055,509,201,7.7,341,13.1,-140,2030,77.9,617,1413,1861,71.4,698,34,1163,169,29,1.1,26084
95524,T001038,Total male and female,GM0629,Wassenaar,2018JJ00,2018,26084,510,153,5.9,325,12.4,-172,1976,75.6,626,1350,1675,64.1,665,27,1010,301,127,4.9,26211
95525,T001038,Total male and female,GM0629,Wassenaar,2019JJ00,2019,26211,513,159,6.1,345,13.1,-186,2052,78.1,592,1460,1771,67.4,672,19,1099,281,94,3.6,26305
95526,T001038,Total male and female,GM0629,Wassenaar,2020JJ00,2020,26305,515,164,6.2,362,13.6,-198,2861,107.4,649,2212,2017,75.8,562,8,1455,844,644,24.5,26949
95527,T001038,Total male and female,GM0629,Wassenaar,2021JJ00,2021,26949,527,162,6,379,14,-217,2772,102.5,713,2059,2391,88.5,464,92,1927,381,166,6.2,27115
95528,T001038,Total male and female,GM0629,Wassenaar,2022JJ00,2022,27115,530,155,5.7,415,15.3,-260,2552,94.2,836,1716,2310,85.2,730,-53,1580,242,-22,-0.8,27093
95529,T001038,Total male and female,GM0629,Wassenaar,2023JJ00,2023,27093,529,160,5.9,388,14.3,-228,2914,107.5,657,2257,2679,98.9,669,-51,2010,235,7,0.3,27100
95682,T001038,Total male and female,GM0852,Waterland,2012JJ00,2012,17010,326,115,6.7,122,7.2,-7,601,35.2,67,534,512,30,47,2,465,89,81,4.8,17091
95683,T001038,Total male and female,GM0852,Waterland,2013JJ00,2013,17091,328,135,7.9,116,6.8,19,597,34.9,70,527,574,33.5,64,-10,510,23,43,2.5,17134
95684,T001038,Total male and female,GM0852,Waterland,2014JJ00,2014,17134,329,159,9.3,123,7.2,36,571,33.3,61,510,599,35,52,7,547,-28,9,0.5,17143
95685,T001038,Total male and female,GM0852,Waterland,2015JJ00,2015,17143,329,126,7.3,139,8.1,-13,788,45.8,95,693,614,35.6,51,-4,563,174,161,9.4,17304
95686,T001038,Total male and female,GM0852,Waterland,2016JJ00,2016,17304,332,137,7.9,140,8.1,-3,677,39.1,82,595,688,39.8,71,-4,617,-11,-14,-0.8,17290
95687,T001038,Total male and female,GM0852,Waterland,2017JJ00,2017,17290,332,143,8.3,134,7.8,9,655,37.9,69,586,695,40.2,66,-4,629,-40,-31,-1.8,17259
95688,T001038,Total male and female,GM0852,Waterland,2018JJ00,2018,17259,331,130,7.5,163,9.4,-33,784,45.4,81,703,695,40.2,65,-4,630,89,56,3.2,17315
95689,T001038,Total male and female,GM0852,Waterland,2019JJ00,2019,17315,332,133,7.7,156,9,-23,759,43.7,77,682,632,36.4,63,-8,569,127,109,6.3,17424
95690,T001038,Total male and female,GM0852,Waterland,2020JJ00,2020,17424,334,128,7.4,182,10.5,-54,661,38.1,90,571,719,41.4,51,-9,668,-58,-112,-6.4,17312
95691,T001038,Total male and female,GM0852,Waterland,2021JJ00,2021,17312,332,147,8.5,176,10.2,-29,757,43.7,51,706,698,40.3,32,6,666,59,31,1.8,17343
95692,T001038,Total male and female,GM0852,Waterland,2022JJ00,2022,17343,334,120,6.9,166,9.5,-46,1031,59,324,707,719,41.1,111,-32,608,312,266,15.3,17609
95693,T001038,Total male and female,GM0852,Waterland,2023JJ00,2023,17609,339,125,7.1,174,9.9,-49,773,44,135,638,806,45.9,110,-12,696,-33,-84,-4.8,17525
96010,T001038,Total male and female,GM0988,Weert,2012JJ00,2012,48668,466,437,9,436,9,1,1489,30.6,297,1192,1567,32.2,333,-112,1234,-78,-81,-1.7,48587
96011,T001038,Total male and female,GM0988,Weert,2013JJ00,2013,48587,465,419,8.6,475,9.8,-56,1537,31.6,329,1208,1348,27.7,223,-27,1125,189,134,2.8,48721
96012,T001038,Total male and female,GM0988,Weert,2014JJ00,2014,48721,466,451,9.2,452,9.3,-1,1644,33.7,402,1242,1445,29.6,271,-38,1174,199,193,4,48914
96013,T001038,Total male and female,GM0988,Weert,2015JJ00,2015,48914,468,475,9.7,466,9.5,9,1734,35.4,352,1382,1553,31.7,348,-54,1205,181,186,3.8,49100
96014,T001038,Total male and female,GM0988,Weert,2016JJ00,2016,49100,470,457,9.3,458,9.3,-1,2839,57.5,575,2264,2349,47.6,329,-72,2020,490,474,9.7,49574
96015,T001038,Total male and female,GM0988,Weert,2017JJ00,2017,49574,475,419,8.4,481,9.7,-62,2509,50.5,456,2053,2158,43.4,283,-15,1875,351,281,5.7,49855
96016,T001038,Total male and female,GM0988,Weert,2018JJ00,2018,49855,478,394,7.9,473,9.5,-79,2258,45.3,522,1736,2188,43.9,329,-61,1859,70,-13,-0.3,49842
96017,T001038,Total male and female,GM0988,Weert,2019JJ00,2019,49842,478,434,8.7,504,10.1,-70,2533,50.7,771,1762,2196,43.9,453,-147,1743,337,263,5.3,50105
96018,T001038,Total male and female,GM0988,Weert,2020JJ00,2020,50105,480,372,7.4,579,11.6,-207,2517,50.3,533,1984,2392,47.8,457,-150,1935,125,-94,-1.9,50011
96019,T001038,Total male and female,GM0988,Weert,2021JJ00,2021,50011,479,467,9.3,607,12.1,-140,2395,47.7,686,1709,1911,38.1,453,-156,1458,484,335,6.7,50346
96020,T001038,Total male and female,GM0988,Weert,2022JJ00,2022,50346,483,433,8.6,566,11.2,-133,2827,55.9,1199,1628,2162,42.7,695,-257,1467,665,526,10.4,50872
96021,T001038,Total male and female,GM0988,Weert,2023JJ00,2023,50872,488,424,8.3,561,11,-137,2770,54.3,1023,1747,2416,47.4,971,-429,1445,354,207,4.1,51079
96092,T001038,Total male and female,GM0457,Weesp,2012JJ00,2012,18022,879,196,10.8,168,9.3,28,989,54.7,124,865,887,49,128,-23,759,102,129,7.2,18151
96093,T001038,Total male and female,GM0457,Weesp,2013JJ00,2013,18151,885,164,9,171,9.4,-7,994,54.7,123,871,969,53.4,127,-25,842,25,21,1.2,18172
96094,T001038,Total male and female,GM0457,Weesp,2014JJ00,2014,18172,886,185,10.1,179,9.8,6,1126,61.7,153,973,954,52.2,146,-11,808,172,176,9.7,18348
96095,T001038,Total male and female,GM0457,Weesp,2015JJ00,2015,18348,895,189,10.2,185,10,4,1196,64.8,127,1069,977,52.9,117,-30,860,219,224,12.2,18572
96096,T001038,Total male and female,GM0457,Weesp,2016JJ00,2016,18572,815,198,10.6,194,10.4,4,1189,63.7,147,1042,1023,54.8,148,-30,875,166,179,9.6,18751
96097,T001038,Total male and female,GM0457,Weesp,2017JJ00,2017,18751,822,212,11.2,185,9.8,27,1517,80.1,187,1330,1145,60.4,106,-21,1039,372,396,21.1,19147
96098,T001038,Total male and female,GM0457,Weesp,2018JJ00,2018,19147,840,220,11.4,181,9.4,39,1293,67.2,189,1104,1144,59.5,126,-8,1018,149,187,9.8,19334
96099,T001038,Total male and female,GM0457,Weesp,2019JJ00,2019,19334,848,222,11.4,225,11.5,-3,1615,82.7,197,1418,1208,61.8,126,-18,1082,407,404,20.9,19738
96100,T001038,Total male and female,GM0457,Weesp,2020JJ00,2020,19738,866,250,12.4,227,11.3,23,1868,93,145,1723,1183,58.9,92,5,1091,685,707,35.8,20445
96101,T001038,Total male and female,GM0457,Weesp,2021JJ00,2021,20445,897,267,13,240,11.6,27,1668,80.9,202,1466,1374,66.7,148,-20,1226,294,321,15.7,20766
96102,T001038,Total male and female,GM0457,Weesp,2022JJ00,2022,20766,914,,,,,,,,,,,,,,,,,,
96502,T001038,Total male and female,GM0870,Werkendam,2012JJ00,2012,26423,253,265,10,184,7,81,646,24.5,47,599,744,28.2,36,7,708,-98,-18,-0.7,26405
96503,T001038,Total male and female,GM0870,Werkendam,2013JJ00,2013,26405,253,271,10.3,174,6.6,97,660,25,69,591,775,29.4,53,-4,722,-115,-18,-0.7,26387
96504,T001038,Total male and female,GM0870,Werkendam,2014JJ00,2014,26387,253,266,10.1,208,7.9,58,797,30.2,65,732,790,29.9,43,4,747,7,65,2.5,26452
96505,T001038,Total male and female,GM0870,Werkendam,2015JJ00,2015,26452,253,258,9.7,227,8.6,31,846,31.9,58,788,802,30.3,55,-10,747,44,75,2.8,26527
96506,T001038,Total male and female,GM0870,Werkendam,2016JJ00,2016,26527,260,289,10.8,178,6.7,111,1049,39.3,75,974,845,31.7,48,4,797,204,317,12,26844
96507,T001038,Total male and female,GM0870,Werkendam,2017JJ00,2017,26844,263,284,10.6,224,8.3,60,1013,37.6,93,920,936,34.8,51,-10,885,77,135,5,26979
96508,T001038,Total male and female,GM0870,Werkendam,2018JJ00,2018,26979,267,302,11.1,197,7.3,105,1145,42.2,106,1039,926,34.1,52,-2,874,219,316,11.7,27295
96837,T001038,Total male and female,GM1960,West Betuwe,2019JJ00,2019,50697,235,520,10.2,368,7.2,152,2193,43.1,270,1923,1901,37.3,147,-16,1754,292,431,8.5,51128
96838,T001038,Total male and female,GM1960,West Betuwe,2020JJ00,2020,51128,237,519,10.1,502,9.8,17,2404,46.9,274,2130,2053,40,157,-11,1896,351,368,7.2,51496
96839,T001038,Total male and female,GM1960,West Betuwe,2021JJ00,2021,51496,238,552,10.7,494,9.5,58,2523,48.8,193,2330,2108,40.7,155,-14,1953,415,475,9.2,51971
96840,T001038,Total male and female,GM1960,West Betuwe,2022JJ00,2022,51971,241,542,10.4,498,9.5,44,2796,53.4,725,2071,2092,40,295,-63,1797,704,749,14.4,52720
96841,T001038,Total male and female,GM1960,West Betuwe,2023JJ00,2023,52720,244,527,10,418,7.9,109,2448,46.3,350,2098,2331,44.1,295,-61,2036,117,228,4.3,52948
96912,T001038,Total male and female,GM0668,West Maas en Waal,2012JJ00,2012,18325,237,143,7.8,166,9,-23,706,38.4,76,630,598,32.6,25,8,573,108,85,4.6,18410
96913,T001038,Total male and female,GM0668,West Maas en Waal,2013JJ00,2013,18410,238,140,7.6,163,8.9,-23,680,36.9,59,621,647,35.1,42,8,605,33,9,0.5,18419
96914,T001038,Total male and female,GM0668,West Maas en Waal,2014JJ00,2014,18419,238,171,9.2,172,9.3,-1,798,43.1,89,709,647,35,41,2,606,151,151,8.2,18570
96915,T001038,Total male and female,GM0668,West Maas en Waal,2015JJ00,2015,18570,240,155,8.3,187,10,-32,857,46,76,781,702,37.7,51,-6,651,155,123,6.6,18693
96916,T001038,Total male and female,GM0668,West Maas en Waal,2016JJ00,2016,18693,242,146,7.8,153,8.2,-7,906,48.3,68,838,768,40.9,36,2,732,138,127,6.8,18820
96917,T001038,Total male and female,GM0668,West Maas en Waal,2017JJ00,2017,18820,244,159,8.4,183,9.7,-24,899,47.7,65,834,801,42.5,42,-6,759,98,71,3.8,18891
96918,T001038,Total male and female,GM0668,West Maas en Waal,2018JJ00,2018,18891,246,166,8.7,185,9.7,-19,1018,53.6,91,927,817,43,49,-2,768,201,185,9.8,19076
96919,T001038,Total male and female,GM0668,West Maas en Waal,2019JJ00,2019,19076,249,163,8.5,177,9.2,-14,1033,53.8,80,953,770,40.1,30,-6,740,263,248,13,19324
96920,T001038,Total male and female,GM0668,West Maas en Waal,2020JJ00,2020,19324,252,189,9.7,212,10.9,-23,1114,57.3,61,1053,834,42.9,58,-22,776,280,257,13.3,19581
96921,T001038,Total male and female,GM0668,West Maas en Waal,2021JJ00,2021,19581,255,213,10.9,195,9.9,18,939,47.8,83,856,863,44,48,-3,815,76,94,4.8,19675
96922,T001038,Total male and female,GM0668,West Maas en Waal,2022JJ00,2022,19675,258,187,9.4,199,10,-12,1240,62.4,271,969,837,42.1,100,-20,737,403,390,19.8,20065
96923,T001038,Total male and female,GM0668,West Maas en Waal,2023JJ00,2023,20065,263,188,9.3,225,11.1,-37,1152,57,145,1007,847,41.9,102,-9,745,305,265,13.2,20330
97493,T001038,Total male and female,GM1969,Westerkwartier,2019JJ00,2019,63031,174,621,9.8,562,8.9,59,2733,43.3,184,2549,2492,39.4,127,-17,2365,241,298,4.7,63329
97494,T001038,Total male and female,GM1969,Westerkwartier,2020JJ00,2020,63329,175,614,9.7,592,9.3,22,2757,43.4,135,2622,2427,38.2,85,10,2342,330,349,5.5,63678
97495,T001038,Total male and female,GM1969,Westerkwartier,2021JJ00,2021,63678,176,675,10.5,646,10.1,29,2721,42.5,115,2606,2124,33.2,112,-17,2012,597,628,9.9,64306
97496,T001038,Total male and female,GM1969,Westerkwartier,2022JJ00,2022,64306,177,659,10.2,646,10,13,3001,46.4,700,2301,2371,36.7,243,-61,2128,630,640,10,64946
97497,T001038,Total male and female,GM1969,Westerkwartier,2023JJ00,2023,64946,179,642,9.9,644,9.9,-2,2668,41.1,511,2157,2718,41.9,379,-149,2339,-50,-50,-0.8,64896
97650,T001038,Total male and female,GM1701,Westerveld,2012JJ00,2012,19198,69,133,6.9,229,12,-96,861,45,70,791,872,45.5,33,11,839,-11,-107,-5.6,19091
97651,T001038,Total male and female,GM1701,Westerveld,2013JJ00,2013,19091,69,128,6.7,234,12.3,-106,870,45.8,66,804,923,48.5,63,-15,860,-53,-158,-8.3,18933
97652,T001038,Total male and female,GM1701,Westerveld,2014JJ00,2014,18933,68,148,7.8,227,11.9,-79,1209,63.6,224,985,984,51.8,66,3,918,225,152,8,19085
97653,T001038,Total male and female,GM1701,Westerveld,2015JJ00,2015,19085,69,134,7,236,12.4,-102,1183,62.2,258,925,1227,64.5,39,7,1188,-44,-145,-7.6,18940
97654,T001038,Total male and female,GM1701,Westerveld,2016JJ00,2016,18940,68,122,6.4,219,11.5,-97,1553,81.7,219,1334,1314,69.1,43,5,1271,239,144,7.6,19084
97655,T001038,Total male and female,GM1701,Westerveld,2017JJ00,2017,19084,69,135,7.1,237,12.4,-102,1284,67.2,86,1198,1113,58.2,50,0,1063,171,68,3.6,19152
97656,T001038,Total male and female,GM1701,Westerveld,2018JJ00,2018,19152,69,141,7.3,216,11.2,-75,1304,67.7,76,1228,1033,53.7,43,4,990,271,196,10.2,19348
97657,T001038,Total male and female,GM1701,Westerveld,2019JJ00,2019,19348,70,120,6.2,234,12.1,-114,1224,63.1,84,1140,998,51.4,55,6,943,226,112,5.8,19460
97658,T001038,Total male and female,GM1701,Westerveld,2020JJ00,2020,19460,70,150,7.7,242,12.4,-92,1340,68.5,69,1271,1050,53.7,38,7,1012,290,201,10.3,19661
97659,T001038,Total male and female,GM1701,Westerveld,2021JJ00,2021,19661,71,129,6.5,245,12.4,-116,1259,63.7,66,1193,949,48,41,-3,908,310,193,9.8,19854
97660,T001038,Total male and female,GM1701,Westerveld,2022JJ00,2022,19854,71,140,7.1,275,13.8,-135,1087,54.7,144,943,948,47.7,86,2,862,139,6,0.3,19860
97661,T001038,Total male and female,GM1701,Westerveld,2023JJ00,2023,19860,71,131,6.6,243,12.2,-112,1317,66.1,179,1138,1063,53.3,73,-2,990,254,143,7.2,20003
97732,T001038,Total male and female,GM0293,Westervoort,2012JJ00,2012,15294,2169,131,8.6,118,7.7,13,740,48.5,62,678,849,55.7,51,2,798,-109,-95,-6.2,15199
97733,T001038,Total male and female,GM0293,Westervoort,2013JJ00,2013,15199,2168,119,7.8,113,7.4,6,827,54.5,47,780,895,59,61,-12,834,-68,-61,-4,15138
97734,T001038,Total male and female,GM0293,Westervoort,2014JJ00,2014,15138,2159,127,8.4,107,7.1,20,711,47.2,51,660,875,58.1,44,-1,831,-164,-146,-9.6,14992
97735,T001038,Total male and female,GM0293,Westervoort,2015JJ00,2015,14992,2139,141,9.4,138,9.2,3,808,53.9,63,745,800,53.3,66,-16,734,8,9,0.6,15001
97736,T001038,Total male and female,GM0293,Westervoort,2016JJ00,2016,15001,2134,126,8.4,127,8.5,-1,911,60.7,65,846,920,61.3,57,-14,863,-9,-10,-0.7,14991
97737,T001038,Total male and female,GM0293,Westervoort,2017JJ00,2017,14991,2132,146,9.7,143,9.5,3,986,65.7,49,937,963,64.2,72,-10,891,23,24,1.6,15015
97738,T001038,Total male and female,GM0293,Westervoort,2018JJ00,2018,15015,2136,143,9.5,121,8.1,22,838,55.9,77,761,931,62.2,82,-27,849,-93,-71,-4.7,14944
97739,T001038,Total male and female,GM0293,Westervoort,2019JJ00,2019,14944,2126,136,9.1,105,7,31,813,54.4,55,758,816,54.6,39,5,777,-3,27,1.8,14971
97740,T001038,Total male and female,GM0293,Westervoort,2020JJ00,2020,14971,2130,137,9.1,139,9.3,-2,884,59,52,832,839,56,24,3,815,45,43,2.9,15014
97741,T001038,Total male and female,GM0293,Westervoort,2021JJ00,2021,15014,2136,157,10.5,136,9.1,21,808,53.9,48,760,898,60,57,-10,841,-90,-70,-4.7,14944
97742,T001038,Total male and female,GM0293,Westervoort,2022JJ00,2022,14944,2132,146,9.7,131,8.7,15,934,62.1,156,778,780,51.9,71,1,709,154,170,11.4,15114
97743,T001038,Total male and female,GM0293,Westervoort,2023JJ00,2023,15114,2156,130,8.6,150,9.9,-20,857,56.6,94,763,800,52.9,73,-10,727,57,37,2.4,15151
97820,T001038,Total male and female,GM1950,Westerwolde,2018JJ00,2018,24684,90,215,8.6,318,12.7,-103,10252,411,8957,1295,9644,386.7,50,16,9594,608,515,20.9,25199
97821,T001038,Total male and female,GM1950,Westerwolde,2019JJ00,2019,25199,91,192,7.5,293,11.5,-101,9533,374.3,7834,1699,8948,351.4,175,-96,8773,585,534,21.2,25733
97822,T001038,Total male and female,GM1950,Westerwolde,2020JJ00,2020,25733,93,177,6.8,306,11.8,-129,8659,333.4,6639,2020,8087,311.3,168,-71,7919,572,482,18.7,26215
97823,T001038,Total male and female,GM1950,Westerwolde,2021JJ00,2021,26215,95,219,8.3,406,15.4,-187,15430,584.6,13915,1515,14973,567.3,93,-40,14880,457,356,13.6,26571
97824,T001038,Total male and female,GM1950,Westerwolde,2022JJ00,2022,26571,96,194,7.3,326,12.3,-132,16757,631.1,15443,1314,16705,629.1,177,-73,16528,52,-34,-1.3,26537
97825,T001038,Total male and female,GM1950,Westerwolde,2023JJ00,2023,26537,96,176,6.6,361,13.6,-185,17332,654,16109,1223,17324,653.7,146,-47,17178,8,-72,-2.7,26465
97978,T001038,Total male and female,GM1783,Westland,2012JJ00,2012,101980,1282,973,9.5,700,6.8,273,4709,46,2297,2412,4264,41.7,1905,-538,2359,445,718,7,102698
97979,T001038,Total male and female,GM1783,Westland,2013JJ00,2013,102698,1291,960,9.3,798,7.7,162,5080,49.3,2465,2615,4697,45.6,2217,-391,2480,383,543,5.3,103241
97980,T001038,Total male and female,GM1783,Westland,2014JJ00,2014,103241,1298,985,9.5,705,6.8,280,5578,53.8,2949,2629,4795,46.2,2218,-373,2577,783,1061,10.3,104302
97981,T001038,Total male and female,GM1783,Westland,2015JJ00,2015,104302,1311,1032,9.9,798,7.6,234,5780,55.2,2835,2945,5359,51.2,2657,-726,2702,421,658,6.3,104960
97982,T001038,Total male and female,GM1783,Westland,2016JJ00,2016,104960,1292,1039,9.9,772,7.3,267,6070,57.6,2822,3248,5672,53.9,2742,-687,2930,398,672,6.4,105632
97983,T001038,Total male and female,GM1783,Westland,2017JJ00,2017,105632,1300,1011,9.5,833,7.8,178,6765,63.5,2984,3781,5082,47.7,2204,-618,2878,1683,1860,17.6,107492
97984,T001038,Total male and female,GM1783,Westland,2018JJ00,2018,107492,1323,1044,9.7,782,7.2,262,6664,61.7,2851,3813,5817,53.8,2934,-515,2883,847,1111,10.3,108603
97985,T001038,Total male and female,GM1783,Westland,2019JJ00,2019,108603,1336,1154,10.5,775,7.1,379,6842,62.5,2891,3951,5446,49.7,2514,-467,2932,1396,1772,16.3,110375
97986,T001038,Total male and female,GM1783,Westland,2020JJ00,2020,110375,1358,1109,10,962,8.7,147,5987,54,2161,3826,5132,46.3,2093,-202,3039,855,1007,9.1,111382
97987,T001038,Total male and female,GM1783,Westland,2021JJ00,2021,111382,1371,1232,11,933,8.3,299,5780,51.6,2102,3678,5015,44.8,1672,-378,3343,765,1066,9.6,112448
97988,T001038,Total male and female,GM1783,Westland,2022JJ00,2022,112448,1392,1177,10.4,963,8.5,214,7396,65.1,3778,3618,5169,45.5,1965,-642,3204,2227,2439,21.7,114887
97989,T001038,Total male and female,GM1783,Westland,2023JJ00,2023,114887,1423,1118,9.7,957,8.3,161,6837,59.2,2885,3952,5937,51.4,2418,-782,3519,900,1054,9.2,115941
98142,T001038,Total male and female,GM0098,Weststellingwerf,2012JJ00,2012,25780,117,221,8.6,271,10.5,-50,753,29.3,49,704,889,34.6,67,-15,822,-136,-185,-7.2,25595
98143,T001038,Total male and female,GM0098,Weststellingwerf,2013JJ00,2013,25595,116,214,8.4,304,11.9,-90,814,31.9,54,760,863,33.8,50,-10,813,-49,-141,-5.5,25454
98144,T001038,Total male and female,GM0098,Weststellingwerf,2014JJ00,2014,25454,115,246,9.7,260,10.2,-14,925,36.3,60,865,844,33.1,80,-18,764,81,71,2.8,25525
98145,T001038,Total male and female,GM0098,Weststellingwerf,2015JJ00,2015,25525,116,235,9.2,282,11,-47,961,37.7,75,886,924,36.2,73,5,851,37,-5,-0.2,25520
98146,T001038,Total male and female,GM0098,Weststellingwerf,2016JJ00,2016,25520,116,211,8.3,305,11.9,-94,1141,44.6,87,1054,959,37.5,95,-23,864,182,88,3.4,25608
98147,T001038,Total male and female,GM0098,Weststellingwerf,2017JJ00,2017,25608,116,226,8.8,283,11,-57,1156,45,75,1081,986,38.4,63,-5,923,170,112,4.4,25720
98148,T001038,Total male and female,GM0098,Weststellingwerf,2018JJ00,2018,25720,117,243,9.4,296,11.5,-53,1117,43.3,81,1036,943,36.6,45,-4,898,174,120,4.7,25840
98149,T001038,Total male and female,GM0098,Weststellingwerf,2019JJ00,2019,25840,117,234,9,286,11.1,-52,1102,42.6,95,1007,976,37.7,69,-9,907,126,74,2.9,25914
98150,T001038,Total male and female,GM0098,Weststellingwerf,2020JJ00,2020,25914,118,227,8.7,330,12.7,-103,1286,49.4,93,1193,966,37.1,45,-8,921,320,216,8.3,26130
98151,T001038,Total male and female,GM0098,Weststellingwerf,2021JJ00,2021,26130,119,258,9.8,302,11.5,-44,1189,45.4,90,1099,997,38,50,-19,947,192,148,5.7,26278
98152,T001038,Total male and female,GM0098,Weststellingwerf,2022JJ00,2022,26278,119,235,8.9,351,13.3,-116,1243,47.1,200,1043,938,35.6,109,-18,829,305,189,7.2,26467
98153,T001038,Total male and female,GM0098,Weststellingwerf,2023JJ00,2023,26467,120,244,9.2,345,13,-101,1113,42,135,978,990,37.4,82,-18,908,123,20,0.8,26487
98224,T001038,Total male and female,GM0614,Westvoorne,2012JJ00,2012,13901,261,72,5.2,151,10.9,-79,666,47.9,99,567,600,43.2,103,-31,497,66,-11,-0.8,13890
98225,T001038,Total male and female,GM0614,Westvoorne,2013JJ00,2013,13890,261,71,5.1,156,11.2,-85,745,53.5,97,648,589,42.3,90,-15,499,156,74,5.3,13964
98226,T001038,Total male and female,GM0614,Westvoorne,2014JJ00,2014,13964,262,89,6.3,152,10.8,-63,763,54.4,87,676,581,41.4,85,-13,496,182,119,8.5,14083
98227,T001038,Total male and female,GM0614,Westvoorne,2015JJ00,2015,14083,265,101,7.1,159,11.2,-58,758,53.6,77,681,586,41.4,65,-9,521,172,114,8.1,14197
98228,T001038,Total male and female,GM0614,Westvoorne,2016JJ00,2016,14197,267,82,5.8,179,12.6,-97,805,56.6,69,736,649,45.6,79,-13,570,156,60,4.2,14257
98229,T001038,Total male and female,GM0614,Westvoorne,2017JJ00,2017,14257,268,98,6.8,146,10.2,-48,936,65.1,63,873,636,44.2,46,0,590,300,251,17.6,14508
98230,T001038,Total male and female,GM0614,Westvoorne,2018JJ00,2018,14508,273,86,5.9,163,11.2,-77,960,65.9,81,879,766,52.6,60,-8,706,194,118,8.1,14626
98231,T001038,Total male and female,GM0614,Westvoorne,2019JJ00,2019,14626,275,75,5.1,160,10.9,-85,848,57.8,68,780,658,44.8,69,-9,589,190,105,7.2,14731
98232,T001038,Total male and female,GM0614,Westvoorne,2020JJ00,2020,14731,277,100,6.7,175,11.8,-75,922,62.2,92,830,678,45.8,52,-13,626,244,169,11.5,14900
98233,T001038,Total male and female,GM0614,Westvoorne,2021JJ00,2021,14900,280,110,7.4,197,13.2,-87,795,53.2,84,711,648,43.4,56,-8,592,147,60,4,14960
98234,T001038,Total male and female,GM0614,Westvoorne,2022JJ00,2022,14960,281,99,6.6,213,14.2,-114,820,54.8,182,638,649,43.3,66,5,583,171,31,2.1,14991
98470,T001038,Total male and female,GM0189,Wierden,2012JJ00,2012,23824,251,242,10.2,174,7.3,68,612,25.7,43,569,697,29.3,52,2,645,-85,-17,-0.7,23807
98471,T001038,Total male and female,GM0189,Wierden,2013JJ00,2013,23807,251,276,11.6,192,8,84,727,30.5,63,664,710,29.8,29,-6,681,17,102,4.3,23909
98472,T001038,Total male and female,GM0189,Wierden,2014JJ00,2014,23909,252,249,10.4,198,8.3,51,693,29,39,654,780,32.6,59,-10,721,-87,-35,-1.5,23874
98473,T001038,Total male and female,GM0189,Wierden,2015JJ00,2015,23874,252,233,9.7,193,8.1,40,775,32.4,41,734,736,30.8,60,-14,676,39,78,3.3,23952
98474,T001038,Total male and female,GM0189,Wierden,2016JJ00,2016,23952,253,258,10.7,201,8.3,57,1006,41.8,67,939,790,32.8,52,1,738,216,273,11.4,24225
98475,T001038,Total male and female,GM0189,Wierden,2017JJ00,2017,24225,256,220,9.1,189,7.8,31,968,39.9,73,895,966,39.8,53,-10,913,2,33,1.4,24258
98476,T001038,Total male and female,GM0189,Wierden,2018JJ00,2018,24258,256,258,10.6,215,8.8,43,881,36.2,62,819,831,34.2,39,2,792,50,93,3.8,24351
98477,T001038,Total male and female,GM0189,Wierden,2019JJ00,2019,24351,257,228,9.3,222,9.1,6,983,40.3,70,913,893,36.6,64,-10,829,90,95,3.9,24446
98478,T001038,Total male and female,GM0189,Wierden,2020JJ00,2020,24446,258,223,9.1,220,9,3,914,37.3,72,842,825,33.7,32,-2,793,89,92,3.8,24538
98479,T001038,Total male and female,GM0189,Wierden,2021JJ00,2021,24538,259,245,10,244,9.9,1,951,38.7,37,914,847,34.4,39,-8,808,104,105,4.3,24643
98480,T001038,Total male and female,GM0189,Wierden,2022JJ00,2022,24643,260,247,10,255,10.3,-8,979,39.6,222,757,754,30.5,67,-3,687,225,219,8.9,24862
98481,T001038,Total male and female,GM0189,Wierden,2023JJ00,2023,24862,263,237,9.5,217,8.7,20,915,36.8,70,845,866,34.8,56,-10,810,49,69,2.8,24931
98798,T001038,Total male and female,GM0296,Wijchen,2012JJ00,2012,40734,613,350,8.6,333,8.1,17,1567,38.3,135,1432,1320,32.3,115,-10,1205,247,270,6.6,41004
98799,T001038,Total male and female,GM0296,Wijchen,2013JJ00,2013,41004,619,378,9.2,312,7.6,66,1342,32.7,115,1227,1372,33.4,115,-2,1257,-30,39,1,41043
98800,T001038,Total male and female,GM0296,Wijchen,2014JJ00,2014,41043,619,332,8.1,294,7.2,38,1349,32.9,127,1222,1545,37.7,116,-24,1429,-196,-157,-3.8,40886
98801,T001038,Total male and female,GM0296,Wijchen,2015JJ00,2015,40886,617,350,8.6,334,8.2,16,1426,34.9,153,1273,1516,37.1,92,-27,1424,-90,-72,-1.8,40814
98802,T001038,Total male and female,GM0296,Wijchen,2016JJ00,2016,40814,616,370,9.1,337,8.3,33,1591,39,136,1455,1561,38.2,111,-12,1450,30,62,1.5,40876
98803,T001038,Total male and female,GM0296,Wijchen,2017JJ00,2017,40876,617,332,8.1,359,8.8,-27,1642,40.2,116,1526,1644,40.2,111,-6,1533,-2,-29,-0.7,40847
98804,T001038,Total male and female,GM0296,Wijchen,2018JJ00,2018,40847,617,326,8,342,8.4,-16,1610,39.4,136,1474,1490,36.4,106,-14,1384,120,104,2.5,40951
98805,T001038,Total male and female,GM0296,Wijchen,2019JJ00,2019,40951,619,323,7.9,346,8.4,-23,1639,39.9,182,1457,1458,35.5,129,-13,1329,181,159,3.9,41110
98806,T001038,Total male and female,GM0296,Wijchen,2020JJ00,2020,41110,621,360,8.7,410,10,-50,1665,40.4,173,1492,1464,35.5,85,-11,1379,201,151,3.7,41261
98807,T001038,Total male and female,GM0296,Wijchen,2021JJ00,2021,41261,623,354,8.6,393,9.5,-39,1577,38.2,148,1429,1453,35.2,99,-12,1354,124,83,2,41344
98808,T001038,Total male and female,GM0296,Wijchen,2022JJ00,2022,41344,626,339,8.2,394,9.5,-55,1717,41.4,366,1351,1468,35.4,155,-21,1313,249,193,4.7,41537
98809,T001038,Total male and female,GM0296,Wijchen,2023JJ00,2023,41537,629,364,8.8,408,9.8,-44,1560,37.6,199,1361,1506,36.3,161,-27,1345,54,8,0.2,41545
98880,T001038,Total male and female,GM1696,Wijdemeren,2012JJ00,2012,23297,487,173,7.4,230,9.9,-57,1083,46.6,120,963,1102,47.4,99,-17,1003,-19,-76,-3.3,23221
98881,T001038,Total male and female,GM1696,Wijdemeren,2013JJ00,2013,23221,485,162,7,248,10.7,-86,1016,43.8,91,925,964,41.5,71,1,893,52,-34,-1.5,23187
98882,T001038,Total male and female,GM1696,Wijdemeren,2014JJ00,2014,23187,484,176,7.6,215,9.3,-39,1140,49.2,110,1030,1114,48.1,108,1,1006,26,-11,-0.5,23176
98883,T001038,Total male and female,GM1696,Wijdemeren,2015JJ00,2015,23176,484,160,6.9,237,10.2,-77,1366,58.8,121,1245,1190,51.2,114,-2,1076,176,99,4.3,23275
98884,T001038,Total male and female,GM1696,Wijdemeren,2016JJ00,2016,23275,489,177,7.6,258,11,-81,1545,66.1,112,1433,1293,55.3,114,-7,1179,252,172,7.4,23447
98885,T001038,Total male and female,GM1696,Wijdemeren,2017JJ00,2017,23447,492,186,7.9,253,10.7,-67,1538,65.3,141,1397,1264,53.7,85,-1,1179,274,212,9,23659
98886,T001038,Total male and female,GM1696,Wijdemeren,2018JJ00,2018,23659,497,212,8.9,252,10.6,-40,1524,63.9,157,1367,1133,47.5,105,-13,1028,391,354,15,24013
98887,T001038,Total male and female,GM1696,Wijdemeren,2019JJ00,2019,24013,504,217,9,270,11.2,-53,1679,69.4,168,1511,1282,53,92,0,1190,397,345,14.4,24358
98888,T001038,Total male and female,GM1696,Wijdemeren,2020JJ00,2020,24358,512,186,7.6,251,10.3,-65,1524,62.4,127,1397,1352,55.4,82,-5,1270,172,105,4.3,24463
98889,T001038,Total male and female,GM1696,Wijdemeren,2021JJ00,2021,24463,514,228,9.3,269,11,-41,1330,54.3,92,1238,1257,51.4,72,-8,1185,73,31,1.3,24494
98890,T001038,Total male and female,GM1696,Wijdemeren,2022JJ00,2022,24494,515,187,7.6,253,10.3,-66,1491,60.7,287,1204,1260,51.3,139,-7,1121,231,165,6.7,24659
98891,T001038,Total male and female,GM1696,Wijdemeren,2023JJ00,2023,24659,519,192,7.8,279,11.3,-87,1399,56.8,164,1235,1366,55.5,117,4,1249,33,-54,-2.2,24605
99290,T001038,Total male and female,GM0352,Wijk bij Duurstede,2012JJ00,2012,23064,485,188,8.2,132,5.7,56,734,31.8,43,691,818,35.5,67,-7,751,-84,-29,-1.3,23035
99291,T001038,Total male and female,GM0352,Wijk bij Duurstede,2013JJ00,2013,23035,484,209,9.1,156,6.8,53,792,34.4,43,749,837,36.3,68,-12,769,-45,8,0.3,23043
99292,T001038,Total male and female,GM0352,Wijk bij Duurstede,2014JJ00,2014,23043,485,224,9.7,156,6.7,68,873,37.7,64,809,761,32.9,60,-4,701,112,179,7.8,23222
99293,T001038,Total male and female,GM0352,Wijk bij Duurstede,2015JJ00,2015,23222,488,213,9.1,138,5.9,75,924,39.7,71,853,837,35.9,51,6,786,87,162,7,23384
99294,T001038,Total male and female,GM0352,Wijk bij Duurstede,2016JJ00,2016,23384,491,212,9,160,6.8,52,1034,44.1,96,938,968,41.3,49,-6,919,66,118,5,23502
99295,T001038,Total male and female,GM0352,Wijk bij Duurstede,2017JJ00,2017,23502,494,225,9.5,157,6.7,68,1068,45.3,68,1000,960,40.7,69,-2,891,108,176,7.5,23678
99296,T001038,Total male and female,GM0352,Wijk bij Duurstede,2018JJ00,2018,23678,497,221,9.3,193,8.1,28,954,40.2,69,885,898,37.9,59,1,839,56,84,3.5,23762
99297,T001038,Total male and female,GM0352,Wijk bij Duurstede,2019JJ00,2019,23762,499,220,9.2,166,7,54,1007,42.2,87,920,910,38.2,67,-10,843,97,152,6.4,23914
99298,T001038,Total male and female,GM0352,Wijk bij Duurstede,2020JJ00,2020,23914,502,214,8.9,183,7.7,31,975,40.8,87,888,992,41.5,39,1,953,-17,11,0.5,23925
99299,T001038,Total male and female,GM0352,Wijk bij Duurstede,2021JJ00,2021,23925,502,232,9.7,183,7.6,49,893,37.3,55,838,946,39.5,81,-11,865,-53,-4,-0.2,23921
99300,T001038,Total male and female,GM0352,Wijk bij Duurstede,2022JJ00,2022,23921,503,215,9,199,8.3,16,946,39.5,153,793,889,37.1,93,-6,796,57,74,3.1,23995
99301,T001038,Total male and female,GM0352,Wijk bij Duurstede,2023JJ00,2023,23995,504,204,8.5,180,7.5,24,888,37,112,776,962,40.1,82,-12,880,-74,-50,-2.1,23945
100274,T001038,Total male and female,GM0053,Winsum,2012JJ00,2012,13987,138,120,8.6,131,9.4,-11,473,33.9,40,433,544,39,34,-2,510,-71,-81,-5.8,13906
100275,T001038,Total male and female,GM0053,Winsum,2013JJ00,2013,13906,138,116,8.4,134,9.7,-18,544,39.2,20,524,581,41.9,32,-11,549,-37,-56,-4,13850
100276,T001038,Total male and female,GM0053,Winsum,2014JJ00,2014,13850,137,113,8.2,137,9.9,-24,536,38.8,30,506,585,42.4,32,-9,553,-49,-76,-5.5,13774
100277,T001038,Total male and female,GM0053,Winsum,2015JJ00,2015,13774,136,106,7.7,143,10.4,-37,512,37.4,48,464,617,45,37,-5,580,-105,-141,-10.2,13633
100278,T001038,Total male and female,GM0053,Winsum,2016JJ00,2016,13633,135,111,8.2,148,10.9,-37,623,45.8,33,590,622,45.7,37,-6,585,1,-37,-2.7,13596
100279,T001038,Total male and female,GM0053,Winsum,2017JJ00,2017,13596,134,110,8.1,145,10.7,-35,653,48.1,39,614,655,48.2,19,-1,636,-2,-36,-2.6,13560
100280,T001038,Total male and female,GM0053,Winsum,2018JJ00,2018,13560,134,114,8.4,144,10.6,-30,635,46.9,29,606,656,48.5,31,-3,625,-21,-55,-4.1,13505
100356,T001038,Total male and female,GM0294,Winterswijk,2012JJ00,2012,28946,210,247,8.5,287,9.9,-40,1218,42.1,470,748,1159,40,153,-72,1006,59,21,0.7,28967
100357,T001038,Total male and female,GM0294,Winterswijk,2013JJ00,2013,28967,210,265,9.2,284,9.8,-19,1216,42,537,679,1282,44.3,139,-71,1143,-66,-86,-3,28881
100358,T001038,Total male and female,GM0294,Winterswijk,2014JJ00,2014,28881,209,257,8.9,299,10.3,-42,1539,53.2,742,797,1405,48.6,113,-37,1292,134,96,3.3,28977
100359,T001038,Total male and female,GM0294,Winterswijk,2015JJ00,2015,28977,210,210,7.3,301,10.4,-91,1625,56.1,761,864,1570,54.2,135,-36,1435,55,-38,-1.3,28939
100360,T001038,Total male and female,GM0294,Winterswijk,2016JJ00,2016,28939,210,246,8.5,289,10,-43,1513,52.3,468,1045,1495,51.7,128,-17,1367,18,-27,-0.9,28912
100361,T001038,Total male and female,GM0294,Winterswijk,2017JJ00,2017,28912,210,240,8.3,340,11.7,-100,1533,53,210,1323,1352,46.7,137,-40,1215,181,75,2.6,28987
100362,T001038,Total male and female,GM0294,Winterswijk,2018JJ00,2018,28987,210,248,8.6,302,10.4,-54,1249,43.2,244,1005,1279,44.2,137,-40,1142,-30,-84,-2.9,28903
100363,T001038,Total male and female,GM0294,Winterswijk,2019JJ00,2019,28903,209,239,8.3,299,10.4,-60,1214,42,236,978,1201,41.6,205,-101,996,13,-49,-1.7,28854
100364,T001038,Total male and female,GM0294,Winterswijk,2020JJ00,2020,28854,209,259,9,314,10.9,-55,1289,44.5,138,1151,1063,36.7,119,-34,944,226,168,5.8,29022
100365,T001038,Total male and female,GM0294,Winterswijk,2021JJ00,2021,29022,210,251,8.6,353,12.1,-102,1499,51.5,103,1396,1223,42,86,-9,1137,276,163,5.6,29185
100366,T001038,Total male and female,GM0294,Winterswijk,2022JJ00,2022,29185,211,207,7.1,372,12.7,-165,1551,53.1,296,1255,1317,45.1,145,-28,1172,234,68,2.3,29253
100367,T001038,Total male and female,GM0294,Winterswijk,2023JJ00,2023,29253,212,266,9.1,375,12.8,-109,1384,47.3,194,1190,1296,44.3,192,-41,1104,88,-22,-0.8,29231
100766,T001038,Total male and female,GM0873,Woensdrecht,2012JJ00,2012,21675,237,175,8.1,200,9.2,-25,808,37.3,264,544,810,37.4,145,-8,665,-2,-27,-1.2,21648
100767,T001038,Total male and female,GM0873,Woensdrecht,2013JJ00,2013,21648,236,147,6.8,193,8.9,-46,849,39.2,239,610,830,38.4,145,-16,685,19,-27,-1.2,21621
100768,T001038,Total male and female,GM0873,Woensdrecht,2014JJ00,2014,21621,236,175,8.1,200,9.2,-25,913,42.2,309,604,864,39.9,179,-27,685,49,23,1.1,21644
100769,T001038,Total male and female,GM0873,Woensdrecht,2015JJ00,2015,21644,236,174,8,214,9.9,-40,976,45.1,330,646,900,41.5,166,-26,734,76,38,1.8,21682
100770,T001038,Total male and female,GM0873,Woensdrecht,2016JJ00,2016,21682,236,165,7.6,201,9.2,-36,1229,56.5,436,793,1036,47.6,230,-33,806,193,155,7.1,21837
100771,T001038,Total male and female,GM0873,Woensdrecht,2017JJ00,2017,21837,238,173,7.9,193,8.8,-20,1039,47.6,351,688,1051,48.2,234,-40,817,-12,-37,-1.7,21800
100772,T001038,Total male and female,GM0873,Woensdrecht,2018JJ00,2018,21800,238,173,7.9,186,8.5,-13,1075,49.2,377,698,994,45.5,202,-14,792,81,66,3,21866
100773,T001038,Total male and female,GM0873,Woensdrecht,2019JJ00,2019,21866,239,179,8.2,213,9.7,-34,1078,49.3,386,692,1037,47.4,209,-8,828,41,10,0.5,21876
100774,T001038,Total male and female,GM0873,Woensdrecht,2020JJ00,2020,21876,239,169,7.7,226,10.3,-57,1171,53.3,379,792,961,43.8,161,-11,800,210,152,6.9,22028
100775,T001038,Total male and female,GM0873,Woensdrecht,2021JJ00,2021,22028,240,179,8.1,255,11.6,-76,1113,50.4,338,775,952,43.1,299,-56,653,161,84,3.8,22112
100776,T001038,Total male and female,GM0873,Woensdrecht,2022JJ00,2022,22112,241,153,6.9,222,10,-69,1106,49.9,381,725,959,43.3,261,-40,698,147,79,3.6,22191
100777,T001038,Total male and female,GM0873,Woensdrecht,2023JJ00,2023,22191,242,155,7,209,9.4,-54,1096,49.4,321,775,1025,46.2,290,-38,735,71,17,0.8,22208
100848,T001038,Total male and female,GM0632,Woerden,2012JJ00,2012,50052,560,600,12,342,6.8,258,1534,30.6,131,1403,1498,29.8,188,-55,1310,36,294,5.9,50346
100849,T001038,Total male and female,GM0632,Woerden,2013JJ00,2013,50346,564,533,10.6,325,6.4,208,1538,30.5,160,1378,1516,30,152,-11,1364,22,231,4.6,50577
100850,T001038,Total male and female,GM0632,Woerden,2014JJ00,2014,50577,566,530,10.5,363,7.2,167,1665,32.9,168,1497,1779,35.2,161,-30,1618,-114,54,1.1,50631
100851,T001038,Total male and female,GM0632,Woerden,2015JJ00,2015,50631,567,600,11.8,362,7.1,238,1993,39.2,205,1788,1700,33.4,145,-4,1555,293,530,10.5,51161
100852,T001038,Total male and female,GM0632,Woerden,2016JJ00,2016,51161,573,528,10.3,380,7.4,148,2087,40.7,213,1874,1875,36.5,146,-7,1729,212,352,6.9,51513
100853,T001038,Total male and female,GM0632,Woerden,2017JJ00,2017,51513,577,536,10.4,386,7.5,150,2020,39.1,205,1815,1929,37.4,187,-19,1742,91,245,4.8,51758
100854,T001038,Total male and female,GM0632,Woerden,2018JJ00,2018,51758,584,535,10.3,376,7.2,159,2106,40.5,244,1862,1824,35.1,126,2,1698,282,439,8.5,52197
100855,T001038,Total male and female,GM0632,Woerden,2019JJ00,2019,52197,589,486,9.3,402,7.7,84,1928,36.9,236,1692,1910,36.6,173,-27,1737,18,102,2,52299
100856,T001038,Total male and female,GM0632,Woerden,2020JJ00,2020,52299,590,525,10,439,8.4,86,2268,43.2,238,2030,1959,37.3,117,4,1842,309,395,7.6,52694
100857,T001038,Total male and female,GM0632,Woerden,2021JJ00,2021,52694,595,580,11,459,8.7,121,2104,39.9,236,1868,2036,38.6,137,1,1899,68,188,3.6,52882
100858,T001038,Total male and female,GM0632,Woerden,2022JJ00,2022,52882,597,461,8.7,504,9.5,-43,2424,45.7,445,1979,2027,38.2,196,8,1831,397,362,6.8,53244
100859,T001038,Total male and female,GM0632,Woerden,2023JJ00,2023,53244,601,515,9.6,472,8.8,43,2524,47.2,320,2204,2085,39,222,-16,1863,439,480,9,53724
101012,T001038,Total male and female,GM1690,De Wolden,2012JJ00,2012,23753,106,204,8.6,225,9.5,-21,973,41,58,915,948,39.9,42,-1,906,25,8,0.3,23761
101013,T001038,Total male and female,GM1690,De Wolden,2013JJ00,2013,23761,106,182,7.7,265,11.2,-83,817,34.5,46,771,914,38.6,46,0,868,-97,-178,-7.5,23583
101014,T001038,Total male and female,GM1690,De Wolden,2014JJ00,2014,23583,105,181,7.7,220,9.3,-39,979,41.4,39,940,864,36.6,51,-4,813,115,78,3.3,23661
101015,T001038,Total male and female,GM1690,De Wolden,2015JJ00,2015,23661,105,185,7.8,217,9.2,-32,1018,43,57,961,927,39.1,54,-1,873,91,61,2.6,23722
101016,T001038,Total male and female,GM1690,De Wolden,2016JJ00,2016,23722,106,194,8.2,269,11.3,-75,1137,47.9,64,1073,1040,43.8,44,0,996,97,22,0.9,23744
101017,T001038,Total male and female,GM1690,De Wolden,2017JJ00,2017,23744,106,195,8.2,245,10.3,-50,1364,57.2,48,1316,1143,48,50,4,1093,221,173,7.3,23917
101018,T001038,Total male and female,GM1690,De Wolden,2018JJ00,2018,23917,107,211,8.8,275,11.5,-64,1317,54.8,82,1235,1061,44.2,49,-6,1012,256,193,8.1,24110
101019,T001038,Total male and female,GM1690,De Wolden,2019JJ00,2019,24110,107,216,8.9,226,9.3,-10,1249,51.6,74,1175,1018,42,33,0,985,231,220,9.1,24330
101020,T001038,Total male and female,GM1690,De Wolden,2020JJ00,2020,24330,108,204,8.4,268,11,-64,1229,50.5,102,1127,1125,46.2,47,-10,1078,104,44,1.8,24374
101021,T001038,Total male and female,GM1690,De Wolden,2021JJ00,2021,24374,109,229,9.4,303,12.4,-74,1252,51.2,90,1162,1042,42.6,75,-12,967,210,137,5.6,24511
101022,T001038,Total male and female,GM1690,De Wolden,2022JJ00,2022,24511,109,174,7.1,311,12.7,-137,1251,50.9,198,1053,1020,41.5,70,-1,950,231,91,3.7,24602
101023,T001038,Total male and female,GM1690,De Wolden,2023JJ00,2023,24602,110,172,7,256,10.4,-84,1166,47.4,128,1038,1103,44.9,93,-32,1010,63,-22,-0.9,24580
101422,T001038,Total male and female,GM0880,Wormerland,2012JJ00,2012,15781,407,102,6.5,136,8.6,-34,642,40.7,66,576,647,41.1,51,-10,596,-5,-41,-2.6,15740
101423,T001038,Total male and female,GM0880,Wormerland,2013JJ00,2013,15740,407,98,6.2,104,6.6,-6,638,40.5,57,581,596,37.8,57,-2,539,42,37,2.4,15777
101424,T001038,Total male and female,GM0880,Wormerland,2014JJ00,2014,15777,408,118,7.5,111,7,7,601,38.1,52,549,645,40.9,82,-15,563,-44,-37,-2.3,15740
101425,T001038,Total male and female,GM0880,Wormerland,2015JJ00,2015,15740,407,127,8.1,147,9.4,-20,668,42.5,64,604,725,46.2,78,-17,647,-57,-76,-4.8,15664
101426,T001038,Total male and female,GM0880,Wormerland,2016JJ00,2016,15664,406,111,7.1,136,8.6,-25,972,61.7,61,911,792,50.3,53,-12,739,180,156,10,15820
101427,T001038,Total male and female,GM0880,Wormerland,2017JJ00,2017,15820,410,124,7.8,148,9.3,-24,829,52.1,45,784,630,39.6,51,-10,579,199,175,11.1,15995
101428,T001038,Total male and female,GM0880,Wormerland,2018JJ00,2018,15995,414,141,8.7,149,9.2,-8,965,59.7,51,914,624,38.6,36,7,588,341,334,20.9,16329
101429,T001038,Total male and female,GM0880,Wormerland,2019JJ00,2019,16329,423,141,8.7,123,7.5,18,671,41.2,74,597,748,45.9,52,-4,696,-77,-59,-3.6,16270
101430,T001038,Total male and female,GM0880,Wormerland,2020JJ00,2020,16270,422,137,8.4,155,9.5,-18,813,49.9,67,746,734,45,36,-12,698,79,63,3.9,16333
101431,T001038,Total male and female,GM0880,Wormerland,2021JJ00,2021,16333,423,133,8.1,175,10.7,-42,822,50.3,45,777,731,44.7,44,-14,687,91,48,2.9,16381
101432,T001038,Total male and female,GM0880,Wormerland,2022JJ00,2022,16381,425,136,8.2,167,10.1,-31,1003,60.8,165,838,741,44.9,66,-9,675,262,231,14.1,16612
101433,T001038,Total male and female,GM0880,Wormerland,2023JJ00,2023,16612,431,132,8,171,10.3,-39,767,46.3,110,657,782,47.2,74,-15,708,-15,-60,-3.6,16552
101668,T001038,Total male and female,GM0351,Woudenberg,2012JJ00,2012,12034,329,150,12.3,74,6.1,76,582,47.8,29,553,371,30.5,37,-12,334,211,287,23.8,12321
101669,T001038,Total male and female,GM0351,Woudenberg,2013JJ00,2013,12321,337,162,13.1,78,6.3,84,409,33.1,38,371,395,31.9,31,6,364,14,101,8.2,12422
101670,T001038,Total male and female,GM0351,Woudenberg,2014JJ00,2014,12422,340,143,11.5,103,8.3,40,485,38.9,45,440,439,35.2,35,-10,404,46,65,5.2,12487
101671,T001038,Total male and female,GM0351,Woudenberg,2015JJ00,2015,12487,342,141,11.3,103,8.2,38,516,41.2,24,492,490,39.1,28,-15,462,26,63,5,12550
101672,T001038,Total male and female,GM0351,Woudenberg,2016JJ00,2016,12550,344,147,11.6,113,9,34,665,52.7,42,623,546,43.2,19,3,527,119,151,12,12701
101673,T001038,Total male and female,GM0351,Woudenberg,2017JJ00,2017,12701,348,166,12.9,91,7.1,75,778,60.5,38,740,533,41.4,35,-5,498,245,320,25.2,13021
101674,T001038,Total male and female,GM0351,Woudenberg,2018JJ00,2018,13021,356,150,11.5,134,10.2,16,655,50,32,623,527,40.2,35,-2,492,128,145,11.1,13166
101675,T001038,Total male and female,GM0351,Woudenberg,2019JJ00,2019,13166,360,167,12.6,106,8,61,651,49.1,37,614,516,38.9,25,-4,491,135,196,14.9,13362
101676,T001038,Total male and female,GM0351,Woudenberg,2020JJ00,2020,13362,366,165,12.2,119,8.8,46,793,58.7,17,776,561,41.6,27,-3,534,232,277,20.7,13639
101677,T001038,Total male and female,GM0351,Woudenberg,2021JJ00,2021,13639,373,173,12.6,111,8.1,62,713,51.8,39,674,541,39.3,16,0,525,172,234,17.2,13873
101678,T001038,Total male and female,GM0351,Woudenberg,2022JJ00,2022,13873,380,169,12,109,7.7,60,994,70.4,206,788,563,39.9,40,2,523,431,485,35,14358
101679,T001038,Total male and female,GM0351,Woudenberg,2023JJ00,2023,14358,393,152,10.5,125,8.6,27,864,59.6,97,767,611,42.1,68,-11,543,253,279,19.4,14637
101750,T001038,Total male and female,GM0874,Woudrichem,2012JJ00,2012,14416,292,128,8.9,141,9.8,-13,501,34.7,38,463,461,31.9,7,10,454,40,27,1.9,14443
101751,T001038,Total male and female,GM0874,Woudrichem,2013JJ00,2013,14443,293,142,9.8,124,8.6,18,432,29.9,48,384,469,32.5,44,-1,425,-37,-18,-1.2,14425
101752,T001038,Total male and female,GM0874,Woudrichem,2014JJ00,2014,14425,293,138,9.6,129,9,9,495,34.4,40,455,541,37.6,30,-1,511,-46,-37,-2.6,14388
101753,T001038,Total male and female,GM0874,Woudrichem,2015JJ00,2015,14388,292,154,10.7,105,7.3,49,596,41.2,41,555,517,35.8,23,1,494,79,130,9,14518
101754,T001038,Total male and female,GM0874,Woudrichem,2016JJ00,2016,14518,294,133,9.2,134,9.2,-1,605,41.6,45,560,583,40.1,47,-2,536,22,21,1.4,14539
101755,T001038,Total male and female,GM0874,Woudrichem,2017JJ00,2017,14539,294,158,10.8,150,10.3,8,710,48.7,50,660,623,42.7,30,-1,593,87,95,6.5,14634
101756,T001038,Total male and female,GM0874,Woudrichem,2018JJ00,2018,14634,297,142,9.7,141,9.6,1,690,46.9,42,648,543,36.9,34,-4,509,147,136,9.3,14770
102488,T001038,Total male and female,GM0479,Zaanstad,2012JJ00,2012,148281,2007,1604,10.8,1247,8.4,357,5785,38.8,1081,4704,4810,32.3,1083,-290,3727,975,1341,9,149622
102489,T001038,Total male and female,GM0479,Zaanstad,2013JJ00,2013,149622,2024,1591,10.6,1292,8.6,299,5763,38.4,1118,4645,5098,34,1203,-301,3895,665,976,6.5,150598
102490,T001038,Total male and female,GM0479,Zaanstad,2014JJ00,2014,150598,2037,1659,11,1242,8.2,417,5800,38.4,1222,4578,5402,35.8,1106,-295,4296,398,820,5.4,151418
102491,T001038,Total male and female,GM0479,Zaanstad,2015JJ00,2015,151418,2048,1638,10.8,1356,8.9,282,6460,42.5,1242,5218,5704,37.5,1064,-204,4640,756,1048,6.9,152466
102492,T001038,Total male and female,GM0479,Zaanstad,2016JJ00,2016,152466,2064,1786,11.7,1371,9,415,6876,44.9,1257,5619,6069,39.6,1172,-174,4897,807,1213,8,153679
102493,T001038,Total male and female,GM0479,Zaanstad,2017JJ00,2017,153679,2080,1673,10.8,1318,8.5,355,7243,46.9,1389,5854,6410,41.5,1024,-125,5386,833,1186,7.7,154865
102494,T001038,Total male and female,GM0479,Zaanstad,2018JJ00,2018,154865,2096,1658,10.7,1309,8.4,349,7559,48.7,1650,5909,6884,44.3,1105,-117,5779,675,1020,6.6,155885
102495,T001038,Total male and female,GM0479,Zaanstad,2019JJ00,2019,155885,2110,1705,10.9,1267,8.1,438,7630,48.8,1726,5904,7163,45.8,1167,-268,5996,467,909,5.8,156794
102496,T001038,Total male and female,GM0479,Zaanstad,2020JJ00,2020,156794,2123,1566,10,1561,10,5,7451,47.5,1600,5851,7331,46.7,1011,-143,6320,120,107,0.7,156901
102497,T001038,Total male and female,GM0479,Zaanstad,2021JJ00,2021,156901,2124,1713,10.9,1430,9.1,283,7460,47.5,1587,5873,7480,47.6,1095,-185,6385,-20,265,1.7,157166
102498,T001038,Total male and female,GM0479,Zaanstad,2022JJ00,2022,157166,2131,1575,9.9,1536,9.7,39,9972,63,2854,7118,7559,47.7,1237,-176,6322,2413,2452,15.6,159618
102499,T001038,Total male and female,GM0479,Zaanstad,2023JJ00,2023,159618,2165,1569,9.8,1472,9.2,97,9709,60.5,2520,7189,8032,50,1650,-366,6382,1677,1771,11.1,161389
102570,T001038,Total male and female,GM0297,Zaltbommel,2012JJ00,2012,26774,336,295,11,196,7.3,99,914,34,191,723,833,31,79,-10,754,81,179,6.7,26953
102571,T001038,Total male and female,GM0297,Zaltbommel,2013JJ00,2013,26953,338,328,12.1,189,7,139,903,33.4,128,775,812,30,85,-3,727,91,229,8.5,27182
102572,T001038,Total male and female,GM0297,Zaltbommel,2014JJ00,2014,27182,341,327,12,209,7.7,118,989,36.3,191,798,931,34.1,145,-28,786,58,176,6.5,27358
102573,T001038,Total male and female,GM0297,Zaltbommel,2015JJ00,2015,27358,344,316,11.5,206,7.5,110,1059,38.6,176,883,983,35.8,121,-14,862,76,185,6.8,27543
102574,T001038,Total male and female,GM0297,Zaltbommel,2016JJ00,2016,27543,346,318,11.5,202,7.3,116,1148,41.5,240,908,1079,39,162,-29,917,69,185,6.7,27728
102575,T001038,Total male and female,GM0297,Zaltbommel,2017JJ00,2017,27728,348,330,11.8,225,8.1,105,1380,49.5,306,1074,1198,43,200,-43,998,182,286,10.3,28014
102576,T001038,Total male and female,GM0297,Zaltbommel,2018JJ00,2018,28014,353,305,10.8,203,7.2,102,1638,58,539,1099,1303,46.2,266,-48,1037,335,437,15.6,28451
102577,T001038,Total male and female,GM0297,Zaltbommel,2019JJ00,2019,28451,358,341,11.9,210,7.3,131,1708,59.6,506,1202,1409,49.2,349,-101,1060,299,430,15.1,28881
102578,T001038,Total male and female,GM0297,Zaltbommel,2020JJ00,2020,28881,364,349,12,251,8.6,98,1894,64.9,486,1408,1425,48.9,333,-93,1092,469,566,19.6,29447
102579,T001038,Total male and female,GM0297,Zaltbommel,2021JJ00,2021,29447,371,356,12,234,7.9,122,1774,59.7,475,1299,1385,46.6,367,-115,1018,389,510,17.3,29957
102580,T001038,Total male and female,GM0297,Zaltbommel,2022JJ00,2022,29957,381,346,11.5,244,8.1,102,1852,61.4,708,1144,1559,51.7,478,-184,1081,293,392,13.1,30349
102581,T001038,Total male and female,GM0297,Zaltbommel,2023JJ00,2023,30349,386,340,11.2,232,7.6,108,1715,56.5,789,926,1788,58.9,624,-236,1164,-73,36,1.2,30385
102734,T001038,Total male and female,GM0473,Zandvoort,2012JJ00,2012,16651,519,121,7.3,234,14.1,-113,883,53.1,170,713,828,49.8,135,-30,693,55,-58,-3.5,16593
102735,T001038,Total male and female,GM0473,Zandvoort,2013JJ00,2013,16593,517,123,7.4,230,13.9,-107,912,55,172,740,828,49.9,145,-38,683,84,-18,-1.1,16575
102736,T001038,Total male and female,GM0473,Zandvoort,2014JJ00,2014,16575,517,124,7.5,206,12.4,-82,1087,65.4,184,903,887,53.3,141,-32,746,200,117,7.1,16692
102737,T001038,Total male and female,GM0473,Zandvoort,2015JJ00,2015,16692,520,135,8.1,236,14.1,-101,1107,66.1,158,949,906,54.1,117,-7,789,201,100,6,16792
102738,T001038,Total male and female,GM0473,Zandvoort,2016JJ00,2016,16792,523,118,7,259,15.4,-141,1204,71.5,154,1050,957,56.8,182,-40,775,247,107,6.4,16899
102739,T001038,Total male and female,GM0473,Zandvoort,2017JJ00,2017,16899,526,124,7.3,227,13.4,-103,1162,68.6,187,975,987,58.3,158,-25,829,175,71,4.2,16970
102740,T001038,Total male and female,GM0473,Zandvoort,2018JJ00,2018,16970,528,130,7.7,238,14,-108,1083,63.7,187,896,934,55,128,-21,806,149,41,2.4,17011
102741,T001038,Total male and female,GM0473,Zandvoort,2019JJ00,2019,17011,530,122,7.1,226,13.2,-104,1076,63.1,224,852,867,50.8,143,-23,724,209,105,6.2,17116
102742,T001038,Total male and female,GM0473,Zandvoort,2020JJ00,2020,17116,533,123,7.2,234,13.7,-111,1193,69.6,197,996,1031,60.1,164,-48,867,162,52,3,17168
102743,T001038,Total male and female,GM0473,Zandvoort,2021JJ00,2021,17168,534,122,7.1,224,13.1,-102,1123,65.5,175,948,1079,63,156,-14,923,44,-61,-3.6,17107
102744,T001038,Total male and female,GM0473,Zandvoort,2022JJ00,2022,17107,533,119,6.9,225,13,-106,1492,86.1,365,1127,952,55,159,-17,793,540,435,25.4,17542
102745,T001038,Total male and female,GM0473,Zandvoort,2023JJ00,2023,17542,547,117,6.7,226,12.9,-109,1176,67.2,252,924,1138,65,228,-74,910,38,-73,-4.2,17469
102816,T001038,Total male and female,GM0707,Zederik,2012JJ00,2012,13434,182,153,11.3,87,6.5,66,408,30.3,20,388,365,27.1,14,5,351,43,104,7.7,13538
102817,T001038,Total male and female,GM0707,Zederik,2013JJ00,2013,13538,184,166,12.2,108,7.9,58,424,31.2,26,398,366,26.9,25,1,341,58,118,8.7,13656
102818,T001038,Total male and female,GM0707,Zederik,2014JJ00,2014,13656,185,167,12.2,122,8.9,45,470,34.3,24,446,454,33.2,12,0,442,16,61,4.5,13717
102819,T001038,Total male and female,GM0707,Zederik,2015JJ00,2015,13717,186,144,10.5,125,9.1,19,525,38.3,31,494,544,39.7,31,-9,513,-19,1,0.1,13718
102820,T001038,Total male and female,GM0707,Zederik,2016JJ00,2016,13718,187,205,14.9,121,8.8,84,552,40.1,28,524,512,37.2,20,0,492,40,124,9,13842
102821,T001038,Total male and female,GM0707,Zederik,2017JJ00,2017,13842,188,171,12.3,121,8.7,50,686,49.3,24,662,572,41.1,25,-1,547,114,162,11.7,14004
102822,T001038,Total male and female,GM0707,Zederik,2018JJ00,2018,14004,191,191,13.6,130,9.3,61,538,38.4,35,503,578,41.3,19,2,559,-40,16,1.1,14020
102980,T001038,Total male and female,GM0478,Zeevang,2012JJ00,2012,6344,167,44,7,34,5.4,10,243,38.4,26,217,279,44.1,51,-6,228,-36,-27,-4.3,6317
102981,T001038,Total male and female,GM0478,Zeevang,2013JJ00,2013,6317,166,33,5.2,53,8.4,-20,308,48.7,73,235,266,42,25,4,241,42,24,3.8,6341
102982,T001038,Total male and female,GM0478,Zeevang,2014JJ00,2014,6341,167,38,6,43,6.8,-5,348,55,154,194,377,59.6,136,-4,241,-29,-35,-5.5,6306
102983,T001038,Total male and female,GM0478,Zeevang,2015JJ00,2015,6306,166,45,7.2,50,8,-5,325,51.8,52,273,376,59.9,102,-10,274,-51,-65,-10.3,6241
103062,T001038,Total male and female,GM0050,Zeewolde,2012JJ00,2012,21288,86,247,11.6,98,4.6,149,766,36,98,668,938,44.1,85,-13,853,-172,-26,-1.2,21262
103063,T001038,Total male and female,GM0050,Zeewolde,2013JJ00,2013,21262,86,214,10,96,4.5,118,1108,51.8,445,663,990,46.3,158,-27,832,118,237,11.1,21499
103064,T001038,Total male and female,GM0050,Zeewolde,2014JJ00,2014,21499,87,237,10.9,79,3.6,158,1585,73.1,826,759,1604,73.9,653,-16,951,-19,395,18.4,21894
103065,T001038,Total male and female,GM0050,Zeewolde,2015JJ00,2015,21894,88,225,10.2,87,4,138,2223,101,1378,845,2134,97,1109,-5,1025,89,219,10,22113
103066,T001038,Total male and female,GM0050,Zeewolde,2016JJ00,2016,22113,89,216,9.7,81,3.6,135,2768,124.2,1391,1377,2555,114.7,1069,-208,1486,213,344,15.6,22457
103067,T001038,Total male and female,GM0050,Zeewolde,2017JJ00,2017,22457,91,210,9.4,86,3.8,124,2707,120.7,1149,1558,2885,128.6,1195,-99,1690,-178,-50,-2.2,22407
103068,T001038,Total male and female,GM0050,Zeewolde,2018JJ00,2018,22407,91,232,10.4,110,4.9,122,2265,101.3,1070,1195,2478,110.8,1078,-73,1400,-213,-98,-4.4,22309
103069,T001038,Total male and female,GM0050,Zeewolde,2019JJ00,2019,22309,90,211,9.4,103,4.6,108,2705,120.3,1575,1130,2466,109.7,1326,-44,1140,239,344,15.4,22653
103070,T001038,Total male and female,GM0050,Zeewolde,2020JJ00,2020,22653,92,238,10.5,115,5.1,123,2235,98.2,861,1374,2126,93.4,932,-39,1194,109,226,10,22879
103071,T001038,Total male and female,GM0050,Zeewolde,2021JJ00,2021,22879,93,235,10.2,147,6.4,88,2442,105.7,1173,1269,2059,89.1,1008,-21,1051,383,469,20.5,23348
103072,T001038,Total male and female,GM0050,Zeewolde,2022JJ00,2022,23348,94,252,10.7,112,4.8,140,2331,99.1,1237,1094,2120,90.1,1107,-19,1013,211,344,14.7,23692
103073,T001038,Total male and female,GM0050,Zeewolde,2023JJ00,2023,23692,96,221,9.3,153,6.4,68,2417,101.6,1028,1389,2275,95.6,1019,-21,1256,142,207,8.7,23899
103226,T001038,Total male and female,GM0355,Zeist,2012JJ00,2012,61233,1262,643,10.5,646,10.5,-3,3941,64.3,589,3352,3754,61.2,357,-59,3397,187,187,3.1,61420
103227,T001038,Total male and female,GM0355,Zeist,2013JJ00,2013,61420,1266,625,10.2,662,10.8,-37,3894,63.5,507,3387,4012,65.4,369,-66,3643,-118,-170,-2.8,61250
103228,T001038,Total male and female,GM0355,Zeist,2014JJ00,2014,61250,1263,653,10.6,639,10.4,14,4768,77.6,763,4005,4396,71.5,461,-104,3935,372,391,6.4,61641
103229,T001038,Total male and female,GM0355,Zeist,2015JJ00,2015,61641,1271,647,10.4,691,11.2,-44,5183,83.7,856,4327,4524,73,394,-90,4130,659,617,10,62258
103230,T001038,Total male and female,GM0355,Zeist,2016JJ00,2016,62258,1283,632,10.1,675,10.8,-43,5382,86.1,795,4587,4764,76.2,409,-63,4355,618,572,9.2,62830
103231,T001038,Total male and female,GM0355,Zeist,2017JJ00,2017,62830,1295,648,10.3,736,11.7,-88,5385,85.4,734,4651,4803,76.1,529,-201,4274,582,492,7.8,63322
103232,T001038,Total male and female,GM0355,Zeist,2018JJ00,2018,63322,1305,639,10,716,11.3,-77,5119,80.5,636,4483,4420,69.5,458,-101,3962,699,612,9.7,63934
103233,T001038,Total male and female,GM0355,Zeist,2019JJ00,2019,63934,1318,648,10.1,742,11.5,-94,5135,79.7,726,4409,4066,63.1,443,-89,3623,1069,971,15.2,64905
103234,T001038,Total male and female,GM0355,Zeist,2020JJ00,2020,64905,1338,619,9.5,791,12.2,-172,4728,72.8,498,4230,4412,67.9,336,-12,4076,316,138,2.1,65043
103235,T001038,Total male and female,GM0355,Zeist,2021JJ00,2021,65043,1341,682,10.4,780,11.9,-98,5530,84.4,597,4933,4490,68.5,375,-67,4115,1040,944,14.5,65987
103236,T001038,Total male and female,GM0355,Zeist,2022JJ00,2022,65987,1361,648,9.8,828,12.5,-180,6178,93.2,1022,5156,5365,80.9,491,-81,4874,813,642,9.7,66629
103237,T001038,Total male and female,GM0355,Zeist,2023JJ00,2023,66629,1374,550,8.3,767,11.5,-217,5422,81.4,690,4732,5196,78,541,-105,4655,226,12,0.2,66641
103390,T001038,Total male and female,GM0299,Zevenaar,2012JJ00,2012,32429,609,280,8.6,269,8.3,11,1207,37.2,110,1097,1241,38.3,106,-18,1135,-34,-24,-0.7,32405
103391,T001038,Total male and female,GM0299,Zevenaar,2013JJ00,2013,32405,608,294,9.1,301,9.3,-7,1179,36.5,104,1075,1291,39.9,113,-11,1178,-112,-122,-3.8,32283
103392,T001038,Total male and female,GM0299,Zevenaar,2014JJ00,2014,32283,606,313,9.7,251,7.8,62,1244,38.5,109,1135,1325,41.1,115,1,1210,-81,-18,-0.6,32265
103393,T001038,Total male and female,GM0299,Zevenaar,2015JJ00,2015,32265,606,261,8.1,307,9.5,-46,1388,43,121,1267,1338,41.5,82,-5,1256,50,4,0.1,32269
103394,T001038,Total male and female,GM0299,Zevenaar,2016JJ00,2016,32269,606,287,8.9,324,10,-37,1529,47.3,116,1413,1382,42.8,84,-5,1298,147,110,3.4,32379
103395,T001038,Total male and female,GM0299,Zevenaar,2017JJ00,2017,32379,608,275,8.5,296,9.1,-21,1766,54.4,129,1637,1546,47.6,94,-18,1452,220,213,6.6,32592
103396,T001038,Total male and female,GM0299,Zevenaar,2018JJ00,2018,43402,469,343,7.9,424,9.8,-81,2047,47.1,173,1874,1879,43.3,128,-27,1751,168,86,2,43488
103397,T001038,Total male and female,GM0299,Zevenaar,2019JJ00,2019,43488,470,329,7.5,464,10.6,-135,2141,49.1,200,1941,1742,39.9,145,-19,1597,399,262,6,43750
103398,T001038,Total male and female,GM0299,Zevenaar,2020JJ00,2020,43750,472,355,8.1,481,11,-126,2287,52.1,211,2076,1811,41.2,135,-18,1676,476,346,7.9,44096
103399,T001038,Total male and female,GM0299,Zevenaar,2021JJ00,2021,44096,476,415,9.4,502,11.3,-87,2372,53.5,188,2184,1736,39.1,162,-30,1574,636,549,12.5,44645
103400,T001038,Total male and female,GM0299,Zevenaar,2022JJ00,2022,44645,482,375,8.4,483,10.8,-108,2344,52.3,415,1929,1831,40.8,235,-51,1596,513,397,8.9,45042
103401,T001038,Total male and female,GM0299,Zevenaar,2023JJ00,2023,45042,486,384,8.5,481,10.7,-97,1924,42.7,239,1685,1823,40.5,186,-57,1637,101,-1,0,45041
103882,T001038,Total male and female,GM0476,Zijpe,2012JJ00,2012,11589,122,84,7.3,84,7.3,0,503,43.5,77,426,564,48.8,89,-38,475,-61,-70,-6,11519
104046,T001038,Total male and female,GM0637,Zoetermeer,2012JJ00,2012,122331,3541,1344,11,768,6.3,576,4863,39.6,560,4303,4676,38.1,711,-54,3965,187,761,6.2,123092
104047,T001038,Total male and female,GM0637,Zoetermeer,2013JJ00,2013,123092,3565,1280,10.4,806,6.5,474,4643,37.6,592,4051,4647,37.7,765,-72,3882,-4,469,3.8,123561
104048,T001038,Total male and female,GM0637,Zoetermeer,2014JJ00,2014,123561,3578,1322,10.7,815,6.6,507,4727,38.2,628,4099,4779,38.6,682,-42,4097,-52,464,3.8,124025
104049,T001038,Total male and female,GM0637,Zoetermeer,2015JJ00,2015,124025,3592,1306,10.5,856,6.9,450,4918,39.6,646,4272,5286,42.6,719,-124,4567,-368,82,0.7,124107
104050,T001038,Total male and female,GM0637,Zoetermeer,2016JJ00,2016,124107,3596,1351,10.9,866,7,485,5884,47.3,746,5138,5697,45.8,740,-64,4957,187,656,5.3,124763
104051,T001038,Total male and female,GM0637,Zoetermeer,2017JJ00,2017,124763,3615,1261,10.1,852,6.8,409,5101,40.9,644,4457,5583,44.8,555,-51,5028,-482,-68,-0.5,124695
104052,T001038,Total male and female,GM0637,Zoetermeer,2018JJ00,2018,124695,3620,1263,10.1,919,7.4,344,5310,42.5,804,4506,5411,43.4,563,-20,4848,-101,249,2,124944
104053,T001038,Total male and female,GM0637,Zoetermeer,2019JJ00,2019,124944,3627,1234,9.9,903,7.2,331,5317,42.5,764,4553,5310,42.4,426,1,4884,7,341,2.7,125285
104054,T001038,Total male and female,GM0637,Zoetermeer,2020JJ00,2020,125285,3637,1216,9.7,1002,8,214,5201,41.5,577,4624,5426,43.3,345,-6,5081,-225,-18,-0.1,125267
104055,T001038,Total male and female,GM0637,Zoetermeer,2021JJ00,2021,125267,3636,1280,10.2,1007,8,273,5571,44.4,602,4969,5348,42.6,442,4,4906,223,500,4,125767
104056,T001038,Total male and female,GM0637,Zoetermeer,2022JJ00,2022,125767,3653,1218,9.6,1066,8.4,152,6631,52.5,1194,5437,5548,43.9,565,-49,4983,1083,1231,9.8,126998
104057,T001038,Total male and female,GM0637,Zoetermeer,2023JJ00,2023,126998,3689,1192,9.3,977,7.6,215,6858,53.7,1004,5854,5635,44.1,605,-21,5030,1223,1436,11.3,128434
104128,T001038,Total male and female,GM0638,Zoeterwoude,2012JJ00,2012,8171,384,57,7,64,7.9,-7,316,38.8,34,282,356,43.7,25,-4,331,-40,-49,-6,8122
104129,T001038,Total male and female,GM0638,Zoeterwoude,2013JJ00,2013,8122,382,60,7.4,76,9.4,-16,289,35.7,17,272,319,39.4,10,2,309,-30,-47,-5.8,8075
104130,T001038,Total male and female,GM0638,Zoeterwoude,2014JJ00,2014,8075,380,74,9.1,65,8,9,385,47.6,21,364,354,43.7,27,0,327,31,39,4.8,8114
104131,T001038,Total male and female,GM0638,Zoeterwoude,2015JJ00,2015,8114,382,55,6.8,59,7.3,-4,372,45.8,32,340,363,44.7,17,5,346,9,5,0.6,8119
104132,T001038,Total male and female,GM0638,Zoeterwoude,2016JJ00,2016,8119,382,68,8.2,65,7.9,3,619,75.1,41,578,374,45.4,24,0,350,245,248,30.5,8367
104133,T001038,Total male and female,GM0638,Zoeterwoude,2017JJ00,2017,8367,394,65,7.7,78,9.3,-13,511,60.8,27,484,435,51.8,30,-1,405,76,63,7.5,8430
104134,T001038,Total male and female,GM0638,Zoeterwoude,2018JJ00,2018,8430,398,78,9.2,79,9.4,-1,393,46.6,28,365,369,43.7,27,-2,342,24,20,2.4,8450
104135,T001038,Total male and female,GM0638,Zoeterwoude,2019JJ00,2019,8450,399,83,9.7,68,8,15,562,65.9,48,514,422,49.5,36,-1,386,140,155,18.3,8605
104136,T001038,Total male and female,GM0638,Zoeterwoude,2020JJ00,2020,8605,406,82,9.4,82,9.4,0,695,79.7,41,654,456,52.3,21,3,435,239,238,27.7,8843
104137,T001038,Total male and female,GM0638,Zoeterwoude,2021JJ00,2021,8843,417,100,11,82,9,18,847,93.4,57,790,406,44.8,21,1,385,441,459,51.9,9302
104138,T001038,Total male and female,GM0638,Zoeterwoude,2022JJ00,2022,9302,440,88,9.4,87,9.3,1,535,57.1,104,431,394,42,51,-5,343,141,141,15.2,9443
104139,T001038,Total male and female,GM0638,Zoeterwoude,2023JJ00,2023,9443,446,103,10.7,86,9,17,751,78.3,82,669,478,49.9,54,2,424,273,289,30.6,9732
104702,T001038,Total male and female,GM0056,Zuidhorn,2012JJ00,2012,18681,149,204,10.9,161,8.6,43,710,38,63,647,735,39.3,46,-7,689,-25,18,1,18699
104703,T001038,Total male and female,GM0056,Zuidhorn,2013JJ00,2013,18699,149,185,9.9,147,7.8,38,776,41.4,33,743,738,39.4,38,-6,700,38,76,4.1,18775
104704,T001038,Total male and female,GM0056,Zuidhorn,2014JJ00,2014,18775,150,191,10.2,159,8.5,32,782,41.7,29,753,856,45.6,42,-8,814,-74,-42,-2.2,18733
104705,T001038,Total male and female,GM0056,Zuidhorn,2015JJ00,2015,18733,149,185,9.9,176,9.4,9,880,46.9,42,838,828,44.1,40,-4,788,52,61,3.3,18794
104706,T001038,Total male and female,GM0056,Zuidhorn,2016JJ00,2016,18794,150,199,10.6,162,8.6,37,958,50.9,43,915,930,49.4,53,2,877,28,65,3.5,18859
104707,T001038,Total male and female,GM0056,Zuidhorn,2017JJ00,2017,18859,150,195,10.3,161,8.5,34,1001,53,38,963,978,51.8,55,-8,923,23,58,3.1,18917
104708,T001038,Total male and female,GM0056,Zuidhorn,2018JJ00,2018,18917,151,190,10,160,8.4,30,1000,52.7,61,939,878,46.2,37,-1,841,122,149,7.9,19066
104948,T001038,Total male and female,GM1892,Zuidplas,2012JJ00,2012,40673,685,412,10.1,286,7,126,1344,33,133,1211,1361,33.4,95,-7,1266,-17,106,2.6,40779
104949,T001038,Total male and female,GM1892,Zuidplas,2013JJ00,2013,40779,683,429,10.5,282,6.9,147,1443,35.3,178,1265,1485,36.4,144,2,1341,-42,113,2.8,40892
104950,T001038,Total male and female,GM1892,Zuidplas,2014JJ00,2014,40892,685,420,10.3,256,6.3,164,1380,33.8,162,1218,1665,40.8,154,-12,1511,-285,-121,-3,40771
104951,T001038,Total male and female,GM1892,Zuidplas,2015JJ00,2015,40771,683,407,10,291,7.1,116,1723,42.2,187,1536,1676,41,182,-22,1494,47,166,4.1,40937
104952,T001038,Total male and female,GM1892,Zuidplas,2016JJ00,2016,40937,686,428,10.4,279,6.8,149,2086,50.6,182,1904,1708,41.5,146,-21,1562,378,531,13,41468
104953,T001038,Total male and female,GM1892,Zuidplas,2017JJ00,2017,41468,695,453,10.9,289,6.9,164,2308,55.4,176,2132,2057,49.4,176,-45,1881,251,414,10,41882
104954,T001038,Total male and female,GM1892,Zuidplas,2018JJ00,2018,41882,722,468,11.1,320,7.6,148,2507,59.2,180,2327,1775,41.9,138,-24,1637,732,880,21,42762
104955,T001038,Total male and female,GM1892,Zuidplas,2019JJ00,2019,42762,737,505,11.7,273,6.3,232,2815,65,207,2608,1929,44.5,128,3,1801,886,1123,26.3,43885
104956,T001038,Total male and female,GM1892,Zuidplas,2020JJ00,2020,43885,756,529,11.9,342,7.7,187,2981,67,175,2806,1988,44.7,106,-3,1882,993,1179,26.9,45064
104957,T001038,Total male and female,GM1892,Zuidplas,2021JJ00,2021,45064,777,578,12.7,352,7.7,226,2479,54.6,139,2340,1975,43.5,122,-2,1853,504,730,16.2,45794
104958,T001038,Total male and female,GM1892,Zuidplas,2022JJ00,2022,45794,790,495,10.7,344,7.4,151,2893,62.4,386,2507,1861,40.1,165,-9,1696,1032,1187,25.9,46981
104959,T001038,Total male and female,GM1892,Zuidplas,2023JJ00,2023,46981,811,530,11.2,344,7.3,186,2794,58.9,379,2415,2118,44.7,279,-21,1839,676,862,18.3,47843
105358,T001038,Total male and female,GM0879,Zundert,2012JJ00,2012,21221,176,200,9.4,190,8.9,10,979,46.1,425,554,967,45.5,421,-139,546,12,20,0.9,21241
105359,T001038,Total male and female,GM0879,Zundert,2013JJ00,2013,21241,176,193,9.1,192,9,1,1496,70.2,948,548,1338,62.8,742,-16,596,158,158,7.4,21399
105360,T001038,Total male and female,GM0879,Zundert,2014JJ00,2014,21399,177,158,7.4,187,8.7,-29,1406,65.8,868,538,1413,66.1,736,2,677,-7,-36,-1.7,21363
105361,T001038,Total male and female,GM0879,Zundert,2015JJ00,2015,21363,177,186,8.7,195,9.1,-9,1568,73.2,843,725,1442,67.3,756,1,686,126,125,5.9,21488
105362,T001038,Total male and female,GM0879,Zundert,2016JJ00,2016,21488,178,178,8.3,213,9.9,-35,1616,74.9,814,802,1404,65.1,736,-5,668,212,169,7.9,21657
105363,T001038,Total male and female,GM0879,Zundert,2017JJ00,2017,21657,179,171,7.9,228,10.6,-57,1552,71.9,747,805,1621,75.1,790,4,831,-69,-132,-6.1,21525
105364,T001038,Total male and female,GM0879,Zundert,2018JJ00,2018,21525,178,183,8.5,232,10.8,-49,1695,78.6,736,959,1553,72,801,-18,752,142,87,4,21612
105365,T001038,Total male and female,GM0879,Zundert,2019JJ00,2019,21612,179,190,8.7,234,10.8,-44,1477,68,656,821,1219,56.1,597,-3,622,258,217,10,21829
105366,T001038,Total male and female,GM0879,Zundert,2020JJ00,2020,21829,181,198,9,245,11.2,-47,1430,65.3,557,873,1225,55.9,537,-16,688,205,159,7.3,21988
105367,T001038,Total male and female,GM0879,Zundert,2021JJ00,2021,21988,182,221,10,227,10.3,-6,1352,61.1,596,756,1074,48.5,485,-14,589,278,272,12.4,22260
105368,T001038,Total male and female,GM0879,Zundert,2022JJ00,2022,22260,185,188,8.4,262,11.7,-74,1516,67.7,681,835,1183,52.8,542,-18,641,333,258,11.6,22518
105369,T001038,Total male and female,GM0879,Zundert,2023JJ00,2023,22518,187,203,9,284,12.6,-81,1424,63.2,649,775,1309,58.1,639,-15,670,115,35,1.6,22553
105440,T001038,Total male and female,GM0301,Zutphen,2012JJ00,2012,47144,1150,438,9.3,429,9.1,9,2276,48.2,225,2051,2185,46.3,214,-28,1971,91,96,2,47240
105441,T001038,Total male and female,GM0301,Zutphen,2013JJ00,2013,47240,1152,415,8.8,424,9,-9,2066,43.8,184,1882,2134,45.2,207,-14,1927,-68,-76,-1.6,47164
105442,T001038,Total male and female,GM0301,Zutphen,2014JJ00,2014,47164,1151,390,8.3,447,9.5,-57,2097,44.6,168,1929,2354,50.1,212,-31,2142,-257,-315,-6.7,46849
105443,T001038,Total male and female,GM0301,Zutphen,2015JJ00,2015,46849,1143,403,8.6,425,9.1,-22,2307,49.2,177,2130,2140,45.6,129,12,2011,167,148,3.2,46997
105444,T001038,Total male and female,GM0301,Zutphen,2016JJ00,2016,46997,1147,356,7.5,442,9.4,-86,2896,61.4,432,2464,2464,52.2,109,36,2355,432,343,7.3,47340
105445,T001038,Total male and female,GM0301,Zutphen,2017JJ00,2017,47340,1156,392,8.3,466,9.8,-74,3119,65.7,318,2801,2848,60,185,-32,2663,271,197,4.2,47537
105446,T001038,Total male and female,GM0301,Zutphen,2018JJ00,2018,47537,1161,361,7.6,465,9.8,-104,2912,61.2,308,2604,2735,57.5,186,-28,2549,177,72,1.5,47609
105447,T001038,Total male and female,GM0301,Zutphen,2019JJ00,2019,47609,1163,392,8.2,498,10.4,-106,3101,64.9,362,2739,2663,55.7,211,-48,2452,438,325,6.8,47934
105448,T001038,Total male and female,GM0301,Zutphen,2020JJ00,2020,47934,1171,383,8,469,9.8,-86,2983,62.1,217,2766,2716,56.6,124,-23,2592,267,177,3.7,48111
105449,T001038,Total male and female,GM0301,Zutphen,2021JJ00,2021,48111,1175,391,8.1,520,10.8,-129,3218,66.7,200,3018,2861,59.3,184,-52,2677,357,219,4.6,48330
105450,T001038,Total male and female,GM0301,Zutphen,2022JJ00,2022,48330,1181,383,7.9,602,12.4,-219,3009,62.1,351,2658,2609,53.9,218,-55,2391,400,180,3.7,48510
105451,T001038,Total male and female,GM0301,Zutphen,2023JJ00,2023,48510,1185,393,8.1,525,10.8,-132,3237,66.6,254,2983,2849,58.6,265,-53,2584,388,242,5,48752
105768,T001038,Total male and female,GM1896,Zwartewaterland,2012JJ00,2012,22048,267,291,13.2,147,6.7,144,590,26.7,81,509,643,29.1,56,-12,587,-53,91,4.1,22139
105769,T001038,Total male and female,GM1896,Zwartewaterland,2013JJ00,2013,22139,268,297,13.4,130,5.9,167,576,26,85,491,715,32.3,77,-23,638,-139,28,1.3,22167
105770,T001038,Total male and female,GM1896,Zwartewaterland,2014JJ00,2014,22167,268,279,12.6,160,7.2,119,578,26.1,108,470,698,31.5,43,-4,655,-120,-1,0,22166
105771,T001038,Total male and female,GM1896,Zwartewaterland,2015JJ00,2015,22166,268,293,13.2,145,6.5,148,674,30.3,92,582,710,32,67,-24,643,-36,112,5.1,22278
105772,T001038,Total male and female,GM1896,Zwartewaterland,2016JJ00,2016,22278,269,259,11.6,148,6.6,111,713,32,81,632,793,35.6,75,-8,718,-80,31,1.4,22309
105773,T001038,Total male and female,GM1896,Zwartewaterland,2017JJ00,2017,22309,270,281,12.6,139,6.2,142,813,36.3,109,704,797,35.6,68,-11,729,16,159,7.1,22468
105774,T001038,Total male and female,GM1896,Zwartewaterland,2018JJ00,2018,22468,272,281,12.5,155,6.9,126,702,31.2,67,635,793,35.3,67,-5,726,-91,35,1.6,22503
105775,T001038,Total male and female,GM1896,Zwartewaterland,2019JJ00,2019,22503,273,293,13,175,7.7,118,831,36.8,121,710,768,34,74,-15,694,63,182,8.1,22685
105776,T001038,Total male and female,GM1896,Zwartewaterland,2020JJ00,2020,22685,275,311,13.7,203,8.9,108,787,34.6,124,663,756,33.2,69,-3,687,31,138,6.1,22823
105777,T001038,Total male and female,GM1896,Zwartewaterland,2021JJ00,2021,22823,277,288,12.6,169,7.4,119,791,34.5,100,691,721,31.5,64,-12,657,70,189,8.3,23012
105778,T001038,Total male and female,GM1896,Zwartewaterland,2022JJ00,2022,23012,279,299,12.9,172,7.4,127,1085,46.8,320,765,857,37,136,-16,721,228,356,15.5,23368
105779,T001038,Total male and female,GM1896,Zwartewaterland,2023JJ00,2023,23368,284,283,12.1,165,7,118,783,33.5,160,623,820,35,107,-30,713,-37,80,3.4,23448
106014,T001038,Total male and female,GM0642,Zwijndrecht,2012JJ00,2012,44499,2187,480,10.8,392,8.8,88,1783,40,126,1657,1758,39.5,170,-17,1588,25,111,2.5,44610
106015,T001038,Total male and female,GM0642,Zwijndrecht,2013JJ00,2013,44610,2193,468,10.5,427,9.6,41,1826,41,177,1649,1931,43.3,194,-42,1737,-105,-63,-1.4,44547
106016,T001038,Total male and female,GM0642,Zwijndrecht,2014JJ00,2014,44547,2190,510,11.5,423,9.5,87,1785,40.1,169,1616,1915,43,236,-34,1679,-130,-46,-1,44501
106017,T001038,Total male and female,GM0642,Zwijndrecht,2015JJ00,2015,44501,2188,431,9.7,430,9.7,1,1939,43.6,171,1768,1991,44.8,206,-35,1785,-52,-47,-1.1,44454
106018,T001038,Total male and female,GM0642,Zwijndrecht,2016JJ00,2016,44454,2184,442,9.9,469,10.6,-27,2248,50.6,160,2088,2255,50.7,175,-21,2080,-7,-37,-0.8,44417
106019,T001038,Total male and female,GM0642,Zwijndrecht,2017JJ00,2017,44417,2183,506,11.4,445,10,61,2456,55.2,191,2265,2351,52.8,176,-28,2175,105,169,3.8,44586
106020,T001038,Total male and female,GM0642,Zwijndrecht,2018JJ00,2018,44586,2196,440,9.9,470,10.5,-30,2334,52.3,225,2109,2251,50.5,175,-25,2076,83,53,1.2,44639
106021,T001038,Total male and female,GM0642,Zwijndrecht,2019JJ00,2019,44639,2199,457,10.2,471,10.5,-14,2228,49.9,219,2009,2114,47.3,135,-19,1979,114,98,2.2,44737
106022,T001038,Total male and female,GM0642,Zwijndrecht,2020JJ00,2020,44737,2204,406,9.1,558,12.5,-152,2298,51.3,205,2093,2107,47.1,138,-3,1969,191,38,0.8,44775
106023,T001038,Total male and female,GM0642,Zwijndrecht,2021JJ00,2021,44775,2206,490,10.9,536,12,-46,2515,56.2,214,2301,2454,54.8,168,-19,2286,61,14,0.3,44789
106024,T001038,Total male and female,GM0642,Zwijndrecht,2022JJ00,2022,44789,2205,481,10.7,513,11.4,-32,2480,55.2,496,1984,2218,49.4,198,-52,2020,262,229,5.1,45018
106025,T001038,Total male and female,GM0642,Zwijndrecht,2023JJ00,2023,45018,2217,390,8.7,490,10.9,-100,2373,52.8,289,2084,2411,53.6,269,-33,2142,-38,-144,-3.2,44874
106096,T001038,Total male and female,GM0193,Zwolle,2012JJ00,2012,121527,1091,1733,14.2,885,7.3,848,5900,48.3,680,5220,5710,46.8,705,-130,5005,190,1035,8.5,122562
106097,T001038,Total male and female,GM0193,Zwolle,2013JJ00,2013,122562,1101,1608,13.1,948,7.7,660,5817,47.3,679,5138,5885,47.9,747,-114,5138,-68,597,4.9,123159
106098,T001038,Total male and female,GM0193,Zwolle,2014JJ00,2014,123159,1106,1615,13.1,930,7.5,685,6076,49.2,642,5434,6053,49,771,-175,5282,23,702,5.7,123861
106099,T001038,Total male and female,GM0193,Zwolle,2015JJ00,2015,123861,1113,1491,12,967,7.8,524,6552,52.7,677,5875,6044,48.6,621,-23,5423,508,1035,8.4,124896
106100,T001038,Total male and female,GM0193,Zwolle,2016JJ00,2016,124896,1122,1541,12.3,913,7.3,628,6793,54.2,776,6017,6763,54,767,-75,5996,30,652,5.2,125548
106101,T001038,Total male and female,GM0193,Zwolle,2017JJ00,2017,125548,1128,1443,11.5,977,7.8,466,6703,53.3,749,5954,6593,52.4,656,-81,5937,110,568,4.5,126116
106102,T001038,Total male and female,GM0193,Zwolle,2018JJ00,2018,126116,1135,1458,11.5,988,7.8,470,7210,56.9,867,6343,6297,49.7,730,-48,5567,913,1381,11,127497
106103,T001038,Total male and female,GM0193,Zwolle,2019JJ00,2019,127497,1148,1460,11.4,953,7.4,507,6915,54,975,5940,6071,47.4,715,-60,5356,844,1343,10.5,128840
106104,T001038,Total male and female,GM0193,Zwolle,2020JJ00,2020,128840,1160,1469,11.4,1036,8,433,6708,51.9,686,6022,6136,47.4,562,-48,5574,572,1000,7.8,129840
106105,T001038,Total male and female,GM0193,Zwolle,2021JJ00,2021,129840,1169,1471,11.3,1070,8.2,401,6557,50.3,843,5714,6112,46.9,558,-84,5554,445,828,6.4,130668
106106,T001038,Total male and female,GM0193,Zwolle,2022JJ00,2022,130668,1181,1445,11,1107,8.4,338,7722,58.7,1947,5775,6314,48,913,-139,5401,1408,1743,13.3,132411
106107,T001038,Total male and female,GM0193,Zwolle,2023JJ00,2023,132411,1196,1411,10.6,1068,8,343,7097,53.5,1088,6009,6695,50.4,946,-169,5749,402,730,5.5,133141
106424,3000,Male,NL01  ,The Netherlands,2012JJ00,2012,8282871,,90180,,67907,,22273,379282,,80847,298435,377197,,78762,-21097,298435,2085,24468,,8307339
106425,3000,Male,NL01  ,The Netherlands,2013JJ00,2013,8307339,,87957,,68360,,19597,384513,,84064,300449,377368,,76919,-16494,300449,7145,27046,,8334385
106426,3000,Male,NL01  ,The Netherlands,2014JJ00,2014,8334385,,89510,,67121,,22389,417269,,95314,321955,401385,,79430,-15648,321955,15884,38473,,8372858
106427,3000,Male,NL01  ,The Netherlands,2015JJ00,2015,8372858,,87427,,71029,,16398,454519,,107551,346968,426598,,79630,-13780,346968,27921,44277,,8417135
106428,3000,Male,NL01  ,The Netherlands,2016JJ00,2016,8417135,,88587,,72180,,16407,509640,,122262,387378,467930,,80552,-14959,387378,41710,57967,,8475102
106429,3000,Male,NL01  ,The Netherlands,2017JJ00,2017,8475102,,87159,,72661,,14498,514753,,119874,394879,477072,,82193,-16577,394879,37681,51939,,8527041
106430,3000,Male,NL01  ,The Netherlands,2018JJ00,2018,8527041,,86204,,74522,,11682,502662,,125454,377208,460210,,83002,-14148,377208,42452,54045,,8581086
106431,3000,Male,NL01  ,The Netherlands,2019JJ00,2019,8581086,,86893,,74432,,12461,519579,,140096,379483,465068,,85585,-14010,379483,54511,66945,,8648031
106432,3000,Male,NL01  ,The Netherlands,2020JJ00,2020,8648031,,86497,,84317,,2180,513812,,116570,397242,477358,,80116,-12233,397242,36454,38505,,8686536
106433,3000,Male,NL01  ,The Netherlands,2021JJ00,2021,8686536,,91817,,85769,,6048,535388,,130969,404419,482365,,77946,-11303,404419,53023,58932,,8745468
106434,3000,Male,NL01  ,The Netherlands,2022JJ00,2022,8745468,,85724,,83749,,1975,591389,,194856,396533,488384,,91851,-14602,396533,103005,104841,,8850309
106435,3000,Male,NL01  ,The Netherlands,2023JJ00,2023,8850309,,84272,,83919,,353,588279,,172611,415668,517938,,102270,-20002,415668,70341,70459,,8920768
106506,3000,Male,LD01  ,Noord-Nederland (LD),2012JJ00,2012,855383,,8382,,7894,,488,38762,,5572,33190,39168,,5156,-1103,34012,-406,91,,855474
106507,3000,Male,LD01  ,Noord-Nederland (LD),2013JJ00,2013,855474,,8005,,7916,,89,39238,,5837,33401,39534,,4831,-1007,34703,-296,-182,,855292
106508,3000,Male,LD01  ,Noord-Nederland (LD),2014JJ00,2014,855292,,8140,,7647,,493,42943,,7989,34954,42212,,5415,-1386,36797,731,1208,,856500
106509,3000,Male,LD01  ,Noord-Nederland (LD),2015JJ00,2015,856500,,7834,,8035,,-201,47439,,10368,37071,46837,,5112,-964,41725,602,417,,856917
106510,3000,Male,LD01  ,Noord-Nederland (LD),2016JJ00,2016,856917,,8042,,8209,,-167,56103,,13964,42139,53511,,5195,-1008,48316,2592,2420,,859337
106511,3000,Male,LD01  ,Noord-Nederland (LD),2017JJ00,2017,859337,,7799,,8280,,-481,57180,,14302,42878,56347,,5390,-1444,50957,833,308,,859645
106512,3000,Male,LD01  ,Noord-Nederland (LD),2018JJ00,2018,859645,,7546,,8421,,-875,51037,,11235,39802,49163,,5016,-896,44147,1874,1013,,860658
106513,3000,Male,LD01  ,Noord-Nederland (LD),2019JJ00,2019,860658,,7784,,8340,,-556,50691,,11807,38884,46911,,5314,-1001,41597,3780,3212,,863870
106514,3000,Male,LD01  ,Noord-Nederland (LD),2020JJ00,2020,863870,,7718,,8970,,-1252,49772,,9684,40088,46205,,5115,-921,41090,3567,2306,,866176
106515,3000,Male,LD01  ,Noord-Nederland (LD),2021JJ00,2021,866176,,8211,,9653,,-1442,55122,,13625,41497,49066,,5052,-1014,44014,6056,4629,,870805
106516,3000,Male,LD01  ,Noord-Nederland (LD),2022JJ00,2022,870805,,7512,,9573,,-2061,59253,,19885,39368,49898,,5915,-963,43983,9355,7297,,878102
106517,3000,Male,LD01  ,Noord-Nederland (LD),2023JJ00,2023,878102,,7381,,9454,,-2073,61732,,19031,42701,54047,,7093,-1558,46954,7685,5625,,883727
106588,3000,Male,LD02  ,Oost-Nederland (LD),2012JJ00,2012,1759215,,18924,,13976,,4948,70684,,11255,59429,70695,,10393,-2171,60302,-11,4969,,1764184
106589,3000,Male,LD02  ,Oost-Nederland (LD),2013JJ00,2013,1764184,,18852,,14299,,4553,71837,,12175,59662,72593,,11367,-2586,61226,-756,3830,,1768014
106590,3000,Male,LD02  ,Oost-Nederland (LD),2014JJ00,2014,1768014,,18866,,13963,,4903,77373,,14040,63333,76734,,11621,-1997,65113,639,5751,,1773765
106591,3000,Male,LD02  ,Oost-Nederland (LD),2015JJ00,2015,1773765,,18483,,14450,,4033,84852,,16976,67876,80247,,11756,-2153,68491,4605,8680,,1782445
106592,3000,Male,LD02  ,Oost-Nederland (LD),2016JJ00,2016,1782445,,18516,,14860,,3656,98059,,19129,78930,89843,,11917,-2417,77926,8216,11838,,1794283
106593,3000,Male,LD02  ,Oost-Nederland (LD),2017JJ00,2017,1794283,,18138,,15200,,2938,95537,,15093,80444,88265,,11738,-2332,76527,7272,10177,,1804460
106594,3000,Male,LD02  ,Oost-Nederland (LD),2018JJ00,2018,1804460,,18071,,15537,,2534,94402,,17137,77265,85063,,11487,-1782,73576,9339,11918,,1816378
106595,3000,Male,LD02  ,Oost-Nederland (LD),2019JJ00,2019,1816378,,18304,,15585,,2719,98235,,20447,77788,86485,,12757,-2570,73728,11750,14480,,1830858
106596,3000,Male,LD02  ,Oost-Nederland (LD),2020JJ00,2020,1830858,,18360,,17625,,735,96952,,16655,80297,87036,,11371,-2234,75665,9916,10665,,1841523
106597,3000,Male,LD02  ,Oost-Nederland (LD),2021JJ00,2021,1841523,,19259,,17958,,1301,99379,,18004,81375,87285,,12127,-2601,75158,12094,13382,,1854905
106598,3000,Male,LD02  ,Oost-Nederland (LD),2022JJ00,2022,1854905,,18416,,17664,,752,109396,,30331,79065,88509,,14949,-3093,73560,20887,21613,,1876518
106599,3000,Male,LD02  ,Oost-Nederland (LD),2023JJ00,2023,1876518,,18051,,17490,,561,108244,,24770,83474,94791,,16974,-4444,77817,13453,13968,,1890486
106670,3000,Male,LD03  ,West-Nederland (LD),2012JJ00,2012,3881417,,45805,,30662,,15143,194198,,47537,146661,193624,,49326,-15036,144298,574,15765,,3897182
106671,3000,Male,LD03  ,West-Nederland (LD),2013JJ00,2013,3897182,,44466,,30712,,13754,195864,,48643,147221,190079,,46479,-11041,143600,5785,19741,,3916923
106672,3000,Male,LD03  ,West-Nederland (LD),2014JJ00,2014,3916923,,45674,,29921,,15753,213057,,53434,159623,201678,,46418,-9346,155260,11379,27164,,3944087
106673,3000,Male,LD03  ,West-Nederland (LD),2015JJ00,2015,3944087,,44574,,31952,,12622,231380,,57607,173773,213729,,46327,-7703,167402,17651,30168,,3974255
106674,3000,Male,LD03  ,West-Nederland (LD),2016JJ00,2016,3974255,,45118,,32314,,12804,250933,,61827,189106,228966,,47022,-8478,181944,21967,34660,,4008915
106675,3000,Male,LD03  ,West-Nederland (LD),2017JJ00,2017,4008915,,44513,,32201,,12312,258227,,65341,192886,237431,,48368,-9897,189063,20796,32984,,4041899
106676,3000,Male,LD03  ,West-Nederland (LD),2018JJ00,2018,4041899,,44191,,33406,,10785,255108,,70628,184480,233267,,48095,-7823,185172,21841,32469,,4074368
106677,3000,Male,LD03  ,West-Nederland (LD),2019JJ00,2019,4074368,,44393,,33117,,11276,266474,,78789,187685,238811,,48793,-6981,190018,27663,38922,,4113290
106678,3000,Male,LD03  ,West-Nederland (LD),2020JJ00,2020,4113290,,44080,,37340,,6740,259832,,62972,196860,246907,,45740,-6031,201167,12925,19540,,4132830
106679,3000,Male,LD03  ,West-Nederland (LD),2021JJ00,2021,4132830,,46424,,38215,,8209,269751,,68769,200982,248374,,42678,-4530,205696,21377,29489,,4162319
106680,3000,Male,LD03  ,West-Nederland (LD),2022JJ00,2022,4162319,,43041,,37285,,5756,300002,,100007,199995,251240,,50631,-7188,200609,48762,54429,,4216748
106681,3000,Male,LD03  ,West-Nederland (LD),2023JJ00,2023,4216748,,42296,,37451,,4845,294892,,85739,209153,261690,,55786,-9384,205904,33202,37849,,4254597
106752,3000,Male,LD04  ,Zuid-Nederland (LD),2012JJ00,2012,1786856,,17069,,15375,,1694,75638,,16483,59155,73710,,13887,-2787,59823,1928,3643,,1790499
106753,3000,Male,LD04  ,Zuid-Nederland (LD),2013JJ00,2013,1790499,,16634,,15433,,1201,77574,,17409,60165,75162,,14242,-1860,60920,2412,3657,,1794156
106754,3000,Male,LD04  ,Zuid-Nederland (LD),2014JJ00,2014,1794156,,16830,,15590,,1240,83896,,19851,64045,80761,,15976,-2919,64785,3135,4350,,1798506
106755,3000,Male,LD04  ,Zuid-Nederland (LD),2015JJ00,2015,1798506,,16536,,16592,,-56,90848,,22600,68248,85785,,16435,-2960,69350,5063,5012,,1803518
106756,3000,Male,LD04  ,Zuid-Nederland (LD),2016JJ00,2016,1803518,,16911,,16797,,114,104545,,27342,77203,95610,,16418,-3056,79192,8935,9049,,1812567
106757,3000,Male,LD04  ,Zuid-Nederland (LD),2017JJ00,2017,1812567,,16709,,16980,,-271,103809,,25138,78671,95029,,16697,-2904,78332,8780,8470,,1821037
106758,3000,Male,LD04  ,Zuid-Nederland (LD),2018JJ00,2018,1821037,,16396,,17158,,-762,102115,,26454,75661,92717,,18404,-3647,74313,9398,8645,,1829682
106759,3000,Male,LD04  ,Zuid-Nederland (LD),2019JJ00,2019,1829682,,16412,,17390,,-978,104179,,29053,75126,92861,,18721,-3458,74140,11318,10331,,1840013
106760,3000,Male,LD04  ,Zuid-Nederland (LD),2020JJ00,2020,1840013,,16339,,20382,,-4043,107256,,27259,79997,97210,,17890,-3047,79320,10046,5994,,1846007
106761,3000,Male,LD04  ,Zuid-Nederland (LD),2021JJ00,2021,1846007,,17923,,19943,,-2020,111136,,30571,80565,97640,,18089,-3158,79551,13496,11432,,1857439
106762,3000,Male,LD04  ,Zuid-Nederland (LD),2022JJ00,2022,1857439,,16755,,19227,,-2472,122738,,44633,78105,98737,,20356,-3358,78381,24001,21502,,1878941
106763,3000,Male,LD04  ,Zuid-Nederland (LD),2023JJ00,2023,1878941,,16544,,19524,,-2980,123411,,43071,80340,107410,,22417,-4616,84993,16001,13017,,1891958
106834,3000,Male,PV20  ,Groningen Province (PV),2012JJ00,2012,288754,,2832,,2653,,179,16998,,3036,13962,16665,,2789,-707,13876,333,521,,289275
106835,3000,Male,PV20  ,Groningen Province (PV),2013JJ00,2013,289275,,2671,,2584,,87,17167,,3247,13920,16712,,2687,-711,14025,455,545,,289820
106836,3000,Male,PV20  ,Groningen Province (PV),2014JJ00,2014,289820,,2718,,2557,,161,19462,,4805,14657,18601,,3101,-992,15500,861,1020,,290840
106837,3000,Male,PV20  ,Groningen Province (PV),2015JJ00,2015,290840,,2703,,2625,,78,21758,,6441,15317,21640,,2968,-768,18672,118,218,,291058
106838,3000,Male,PV20  ,Groningen Province (PV),2016JJ00,2016,291058,,2765,,2647,,118,23799,,6788,17011,23682,,3008,-788,20674,117,233,,291291
106839,3000,Male,PV20  ,Groningen Province (PV),2017JJ00,2017,291291,,2580,,2739,,-159,21120,,4454,16666,21305,,3135,-981,18170,-185,-353,,290938
106840,3000,Male,PV20  ,Groningen Province (PV),2018JJ00,2018,290938,,2516,,2646,,-130,23225,,7961,15264,22612,,2728,-487,19884,613,498,,291436
106841,3000,Male,PV20  ,Groningen Province (PV),2019JJ00,2019,291436,,2644,,2768,,-124,22436,,8107,14329,21319,,3055,-619,18264,1117,1008,,292444
106842,3000,Male,PV20  ,Groningen Province (PV),2020JJ00,2020,292444,,2665,,2873,,-208,21913,,6967,14946,20799,,3126,-602,17673,1114,917,,293361
106843,3000,Male,PV20  ,Groningen Province (PV),2021JJ00,2021,293361,,2736,,3105,,-369,25615,,11065,14550,23690,,2911,-434,20779,1925,1587,,294948
106844,3000,Male,PV20  ,Groningen Province (PV),2022JJ00,2022,294948,,2513,,3103,,-590,27812,,13553,14259,24629,,3096,-410,21533,3183,2625,,297573
106845,3000,Male,PV20  ,Groningen Province (PV),2023JJ00,2023,297573,,2408,,3056,,-648,30210,,14101,16109,26898,,3568,-592,23330,3312,2713,,300286
106916,3000,Male,PV21  ,Fryslân (PV),2012JJ00,2012,323495,,3307,,2890,,417,12449,,1498,10951,12921,,1363,-149,11558,-472,-53,,323442
106917,3000,Male,PV21  ,Fryslân (PV),2013JJ00,2013,323442,,3241,,2977,,264,12837,,1543,11294,13325,,1289,-137,12036,-488,-200,,323242
106918,3000,Male,PV21  ,Fryslân (PV),2014JJ00,2014,323242,,3213,,2863,,350,13858,,1984,11874,14035,,1451,-268,12584,-177,156,,323398
106919,3000,Male,PV21  ,Fryslân (PV),2015JJ00,2015,323398,,3050,,3011,,39,14036,,1773,12263,14092,,1226,-63,12866,-56,-22,,323376
106920,3000,Male,PV21  ,Fryslân (PV),2016JJ00,2016,323376,,3130,,3089,,41,15620,,1735,13885,14981,,1286,-90,13695,639,672,,324048
106921,3000,Male,PV21  ,Fryslân (PV),2017JJ00,2017,324048,,3082,,2973,,109,16237,,1701,14536,15887,,1469,-339,14418,350,443,,324491
106922,3000,Male,PV21  ,Fryslân (PV),2018JJ00,2018,324491,,2960,,3153,,-193,15043,,1944,13099,14682,,1390,-253,13292,361,175,,324666
106923,3000,Male,PV21  ,Fryslân (PV),2019JJ00,2019,324666,,3024,,3085,,-61,15485,,2242,13243,14130,,1327,-164,12803,1355,1285,,325951
106924,3000,Male,PV21  ,Fryslân (PV),2020JJ00,2020,325951,,2972,,3325,,-353,15304,,1721,13583,14111,,1280,-222,12831,1193,837,,326788
106925,3000,Male,PV21  ,Fryslân (PV),2021JJ00,2021,326788,,3209,,3573,,-364,16007,,1605,14402,14276,,1294,-356,12982,1731,1367,,328155
106926,3000,Male,PV21  ,Fryslân (PV),2022JJ00,2022,328155,,2973,,3513,,-540,17286,,3735,13551,14003,,1775,-351,12228,3283,2734,,330889
106927,3000,Male,PV21  ,Fryslân (PV),2023JJ00,2023,330889,,2941,,3525,,-584,17236,,2889,14347,15183,,2114,-562,13069,2053,1458,,332347
106998,3000,Male,PV22  ,Drenthe (PV),2012JJ00,2012,243134,,2243,,2351,,-108,9315,,1038,8277,9582,,1004,-247,8578,-267,-377,,242757
106999,3000,Male,PV22  ,Drenthe (PV),2013JJ00,2013,242757,,2093,,2355,,-262,9234,,1047,8187,9497,,855,-159,8642,-263,-527,,242230
107000,3000,Male,PV22  ,Drenthe (PV),2014JJ00,2014,242230,,2209,,2227,,-18,9623,,1200,8423,9576,,863,-126,8713,47,32,,242262
107001,3000,Male,PV22  ,Drenthe (PV),2015JJ00,2015,242262,,2081,,2399,,-318,11645,,2154,9491,11105,,918,-133,10187,540,221,,242483
107002,3000,Male,PV22  ,Drenthe (PV),2016JJ00,2016,242483,,2147,,2473,,-326,16684,,5441,11243,14848,,901,-130,13947,1836,1515,,243998
107003,3000,Male,PV22  ,Drenthe (PV),2017JJ00,2017,243998,,2137,,2568,,-431,19823,,8147,11676,19155,,786,-124,18369,668,218,,244216
107004,3000,Male,PV22  ,Drenthe (PV),2018JJ00,2018,244216,,2070,,2622,,-552,12769,,1330,11439,11869,,898,-156,10971,900,340,,244556
107005,3000,Male,PV22  ,Drenthe (PV),2019JJ00,2019,244556,,2116,,2487,,-371,12770,,1458,11312,11462,,932,-218,10530,1308,919,,245475
107006,3000,Male,PV22  ,Drenthe (PV),2020JJ00,2020,245475,,2081,,2772,,-691,12555,,996,11559,11295,,709,-97,10586,1260,552,,246027
107007,3000,Male,PV22  ,Drenthe (PV),2021JJ00,2021,246027,,2266,,2975,,-709,13500,,955,12545,11100,,847,-224,10253,2400,1675,,247702
107008,3000,Male,PV22  ,Drenthe (PV),2022JJ00,2022,247702,,2026,,2957,,-931,14155,,2597,11558,11266,,1044,-202,10222,2889,1938,,249640
107009,3000,Male,PV22  ,Drenthe (PV),2023JJ00,2023,249640,,2032,,2873,,-841,14286,,2041,12245,11966,,1411,-404,10555,2320,1454,,251094
107080,3000,Male,PV23  ,Overijssel (PV),2012JJ00,2012,568764,,6290,,4586,,1704,19713,,3542,16171,20493,,3370,-671,17123,-780,926,,569690
107081,3000,Male,PV23  ,Overijssel (PV),2013JJ00,2013,569690,,6206,,4706,,1500,19590,,3465,16125,20578,,3534,-788,17044,-988,524,,570214
107082,3000,Male,PV23  ,Overijssel (PV),2014JJ00,2014,570214,,6213,,4648,,1565,20702,,3642,17060,21566,,3545,-700,18021,-864,680,,570894
107083,3000,Male,PV23  ,Overijssel (PV),2015JJ00,2015,570894,,6126,,4770,,1356,23382,,4881,18501,22321,,3357,-514,18964,1061,2430,,573324
107084,3000,Male,PV23  ,Overijssel (PV),2016JJ00,2016,573324,,5928,,4884,,1044,25654,,4428,21226,24581,,3685,-861,20896,1073,2104,,575428
107085,3000,Male,PV23  ,Overijssel (PV),2017JJ00,2017,575428,,5817,,5107,,710,25725,,4083,21642,24427,,3340,-566,21087,1298,2003,,577431
107086,3000,Male,PV23  ,Overijssel (PV),2018JJ00,2018,577431,,5670,,5060,,610,25910,,4793,21117,23479,,3218,-318,20261,2431,3060,,580491
107087,3000,Male,PV23  ,Overijssel (PV),2019JJ00,2019,580491,,5748,,5138,,610,26185,,5511,20674,23517,,3785,-776,19732,2668,3265,,583756
107088,3000,Male,PV23  ,Overijssel (PV),2020JJ00,2020,583756,,5748,,5848,,-100,26025,,4607,21418,23627,,3193,-592,20434,2398,2299,,586055
107089,3000,Male,PV23  ,Overijssel (PV),2021JJ00,2021,586055,,5994,,5815,,179,26339,,4853,21486,23413,,3435,-681,19978,2926,3103,,589158
107090,3000,Male,PV23  ,Overijssel (PV),2022JJ00,2022,589158,,5703,,5817,,-114,29551,,8097,21454,23634,,4070,-722,19564,5917,5796,,594954
107091,3000,Male,PV23  ,Overijssel (PV),2023JJ00,2023,594954,,5651,,5714,,-63,28743,,6307,22436,25467,,4670,-1164,20797,3276,3204,,598158
107162,3000,Male,PV24  ,Flevoland (PV),2012JJ00,2012,197783,,2526,,1101,,1425,8150,,1908,6242,8049,,1311,-106,6738,101,1531,,199314
107163,3000,Male,PV24  ,Flevoland (PV),2013JJ00,2013,199314,,2418,,1154,,1264,8412,,2539,5873,9045,,1930,-507,7115,-633,636,,199950
107164,3000,Male,PV24  ,Flevoland (PV),2014JJ00,2014,199950,,2448,,1086,,1362,9768,,3496,6272,10335,,2171,-331,8164,-567,999,,200949
107165,3000,Male,PV24  ,Flevoland (PV),2015JJ00,2015,200949,,2474,,1118,,1356,11544,,4225,7319,11702,,2550,-434,9152,-158,1208,,202157
107166,3000,Male,PV24  ,Flevoland (PV),2016JJ00,2016,202157,,2454,,1213,,1241,12762,,3870,8892,12026,,2235,-397,9791,736,1981,,204138
107167,3000,Male,PV24  ,Flevoland (PV),2017JJ00,2017,204138,,2308,,1138,,1170,11738,,2716,9022,11132,,2163,-286,8969,606,1774,,205912
107168,3000,Male,PV24  ,Flevoland (PV),2018JJ00,2018,205912,,2472,,1220,,1252,11760,,2929,8831,10680,,2059,-199,8621,1080,2326,,208238
107169,3000,Male,PV24  ,Flevoland (PV),2019JJ00,2019,208238,,2540,,1268,,1272,13241,,3763,9478,11100,,2366,-234,8734,2141,3405,,211643
107170,3000,Male,PV24  ,Flevoland (PV),2020JJ00,2020,211643,,2484,,1447,,1037,12751,,2693,10058,11134,,1958,-242,9176,1617,2658,,214301
107171,3000,Male,PV24  ,Flevoland (PV),2021JJ00,2021,214301,,2643,,1540,,1103,14114,,3009,11105,11936,,2492,-496,9444,2178,3284,,217585
107172,3000,Male,PV24  ,Flevoland (PV),2022JJ00,2022,217585,,2527,,1474,,1053,16503,,5469,11034,12723,,3176,-525,9547,3780,4818,,222403
107173,3000,Male,PV24  ,Flevoland (PV),2023JJ00,2023,222403,,2529,,1489,,1040,15406,,3937,11469,13299,,3600,-812,9699,2107,3132,,225535
107244,3000,Male,PV25  ,Gelderland (PV),2012JJ00,2012,992668,,10108,,8289,,1819,42821,,5805,37016,42153,,5712,-1394,36441,668,2512,,995180
107245,3000,Male,PV25  ,Gelderland (PV),2013JJ00,2013,995180,,10228,,8439,,1789,43835,,6171,37664,42970,,5903,-1291,37067,865,2670,,997850
107246,3000,Male,PV25  ,Gelderland (PV),2014JJ00,2014,997850,,10205,,8229,,1976,46903,,6902,40001,44833,,5905,-966,38928,2070,4072,,1001922
107247,3000,Male,PV25  ,Gelderland (PV),2015JJ00,2015,1001922,,9883,,8562,,1321,49926,,7870,42056,46224,,5849,-1205,40375,3702,5042,,1006964
107248,3000,Male,PV25  ,Gelderland (PV),2016JJ00,2016,1006964,,10134,,8763,,1371,59643,,10831,48812,53236,,5997,-1159,47239,6407,7753,,1014717
107249,3000,Male,PV25  ,Gelderland (PV),2017JJ00,2017,1014717,,10013,,8955,,1058,58074,,8294,49780,52706,,6235,-1480,46471,5368,6400,,1021117
107250,3000,Male,PV25  ,Gelderland (PV),2018JJ00,2018,1021117,,9929,,9257,,672,56732,,9415,47317,50904,,6210,-1265,44694,5828,6532,,1027649
107251,3000,Male,PV25  ,Gelderland (PV),2019JJ00,2019,1027649,,10016,,9179,,837,58809,,11173,47636,51868,,6606,-1560,45262,6941,7810,,1035459
107252,3000,Male,PV25  ,Gelderland (PV),2020JJ00,2020,1035459,,10128,,10330,,-202,58176,,9355,48821,52275,,6220,-1400,46055,5901,5708,,1041167
107253,3000,Male,PV25  ,Gelderland (PV),2021JJ00,2021,1041167,,10622,,10603,,19,58926,,10142,48784,51936,,6200,-1424,45736,6990,6995,,1048162
107254,3000,Male,PV25  ,Gelderland (PV),2022JJ00,2022,1048162,,10186,,10373,,-187,63342,,16765,46577,52152,,7703,-1846,44449,11190,10999,,1059161
107255,3000,Male,PV25  ,Gelderland (PV),2023JJ00,2023,1059161,,9871,,10287,,-416,64095,,14526,49569,56025,,8704,-2468,47321,8070,7632,,1066793
107326,3000,Male,PV26  ,Utrecht Province (PV),2012JJ00,2012,605032,,7659,,4232,,3427,29878,,4533,25345,28997,,4424,-731,24573,881,4313,,609345
107327,3000,Male,PV26  ,Utrecht Province (PV),2013JJ00,2013,609345,,7327,,4342,,2985,30304,,4745,25559,28989,,4373,-447,24616,1315,4329,,613674
107328,3000,Male,PV26  ,Utrecht Province (PV),2014JJ00,2014,613674,,7534,,4263,,3271,34052,,5339,28713,32116,,4532,-438,27584,1936,5214,,618888
107329,3000,Male,PV26  ,Utrecht Province (PV),2015JJ00,2015,618888,,7337,,4473,,2864,37086,,5901,31185,34368,,4661,-617,29707,2718,5587,,624475
107330,3000,Male,PV26  ,Utrecht Province (PV),2016JJ00,2016,624475,,7377,,4487,,2890,39707,,6061,33646,36751,,4235,-447,32516,2956,5870,,630345
107331,3000,Male,PV26  ,Utrecht Province (PV),2017JJ00,2017,630345,,7371,,4635,,2736,39508,,5723,33785,36647,,4511,-660,32136,2861,5606,,635951
107332,3000,Male,PV26  ,Utrecht Province (PV),2018JJ00,2018,635951,,7388,,4722,,2666,39020,,6384,32636,35566,,4427,-410,31139,3454,6116,,642067
107333,3000,Male,PV26  ,Utrecht Province (PV),2019JJ00,2019,659562,,7665,,4810,,2855,40867,,7341,33526,36856,,4843,-550,32013,4011,6851,,666413
107334,3000,Male,PV26  ,Utrecht Province (PV),2020JJ00,2020,666413,,7613,,5411,,2202,40192,,5906,34286,38612,,4366,-263,34246,1580,3765,,670178
107335,3000,Male,PV26  ,Utrecht Province (PV),2021JJ00,2021,670178,,8109,,5566,,2543,41588,,6350,35238,39927,,4253,-499,35674,1661,4199,,674377
107336,3000,Male,PV26  ,Utrecht Province (PV),2022JJ00,2022,674377,,7246,,5502,,1744,45405,,9970,35435,38711,,4817,-378,33894,6694,8435,,682812
107337,3000,Male,PV26  ,Utrecht Province (PV),2023JJ00,2023,682812,,7131,,5627,,1504,44634,,7899,36735,40113,,5361,-830,34752,4521,6013,,688825
107408,3000,Male,PV27  ,Noord-Holland (PV),2012JJ00,2012,1333811,,15258,,10471,,4787,70124,,18354,51770,67879,,18407,-5143,49472,2245,7063,,1340874
107409,3000,Male,PV27  ,Noord-Holland (PV),2013JJ00,2013,1340874,,15090,,10661,,4429,70721,,18587,52134,66488,,17216,-3574,49272,4233,8774,,1349648
107410,3000,Male,PV27  ,Noord-Holland (PV),2014JJ00,2014,1349648,,15250,,10260,,4990,78374,,21677,56697,73004,,18230,-3675,54774,5370,10421,,1360069
107411,3000,Male,PV27  ,Noord-Holland (PV),2015JJ00,2015,1360069,,15252,,11134,,4118,86437,,23641,62796,78191,,17844,-2155,60347,8246,12393,,1372462
107412,3000,Male,PV27  ,Noord-Holland (PV),2016JJ00,2016,1372462,,15443,,11193,,4250,93084,,26231,66853,83292,,18208,-2263,65084,9792,14003,,1386465
107413,3000,Male,PV27  ,Noord-Holland (PV),2017JJ00,2017,1386465,,15182,,10998,,4184,95675,,28456,67219,88372,,19503,-3501,68869,7303,11479,,1397944
107414,3000,Male,PV27  ,Noord-Holland (PV),2018JJ00,2018,1397944,,14832,,11348,,3484,96127,,31674,64453,87933,,20112,-2922,67821,8194,11625,,1409569
107415,3000,Male,PV27  ,Noord-Holland (PV),2019JJ00,2019,1409569,,14947,,11253,,3694,101456,,35223,66233,91453,,20630,-2820,70823,10003,13734,,1423303
107416,3000,Male,PV27  ,Noord-Holland (PV),2020JJ00,2020,1423303,,14816,,12681,,2135,96221,,26882,69339,93059,,18621,-1340,74438,3162,5256,,1428559
107417,3000,Male,PV27  ,Noord-Holland (PV),2021JJ00,2021,1428559,,15761,,13158,,2603,100919,,29894,71025,93522,,18268,-1249,75254,7397,9918,,1438477
107418,3000,Male,PV27  ,Noord-Holland (PV),2022JJ00,2022,1438477,,14488,,12672,,1816,113681,,43487,70194,95927,,21237,-2481,74690,17754,19484,,1457961
107419,3000,Male,PV27  ,Noord-Holland (PV),2023JJ00,2023,1457961,,14103,,13002,,1101,110723,,37896,72827,99593,,23736,-2981,75857,11130,12077,,1470038
107490,3000,Male,PV28  ,Zuid-Holland (PV),2012JJ00,2012,1753393,,21053,,14123,,6930,86738,,22735,64003,89001,,24840,-8522,64161,-2263,4688,,1758081
107491,3000,Male,PV28  ,Zuid-Holland (PV),2013JJ00,2013,1758081,,20256,,13798,,6458,87319,,23471,63848,86987,,23557,-6682,63430,332,6846,,1764927
107492,3000,Male,PV28  ,Zuid-Holland (PV),2014JJ00,2014,1764927,,21033,,13635,,7398,93080,,24702,68378,88960,,22147,-4912,66813,4120,11485,,1776412
107493,3000,Male,PV28  ,Zuid-Holland (PV),2015JJ00,2015,1776412,,20138,,14390,,5748,99841,,26228,73613,93665,,22436,-4602,71229,6176,11791,,1788203
107494,3000,Male,PV28  ,Zuid-Holland (PV),2016JJ00,2016,1788203,,20548,,14742,,5806,109274,,27435,81839,100416,,23186,-5468,77230,8858,14565,,1802768
107495,3000,Male,PV28  ,Zuid-Holland (PV),2017JJ00,2017,1802768,,20228,,14671,,5557,113916,,29222,84694,103805,,22921,-5459,80884,10111,15553,,1818321
107496,3000,Male,PV28  ,Zuid-Holland (PV),2018JJ00,2018,1818321,,20234,,15347,,4887,110773,,30341,80432,101239,,22002,-4154,79237,9534,14309,,1832630
107497,3000,Male,PV28  ,Zuid-Holland (PV),2019JJ00,2019,1815135,,19999,,15114,,4885,115011,,34023,80988,101845,,21661,-3257,80184,13166,18004,,1833139
107498,3000,Male,PV28  ,Zuid-Holland (PV),2020JJ00,2020,1833139,,19915,,17160,,2755,113782,,28048,85734,106933,,21396,-4171,85537,6849,9530,,1842669
107499,3000,Male,PV28  ,Zuid-Holland (PV),2021JJ00,2021,1842669,,20753,,17067,,3686,117785,,30399,87386,106820,,18609,-2447,88211,10965,14634,,1857303
107500,3000,Male,PV28  ,Zuid-Holland (PV),2022JJ00,2022,1857303,,19514,,16867,,2647,129633,,43005,86628,107721,,22668,-3993,85053,21912,24565,,1881868
107501,3000,Male,PV28  ,Zuid-Holland (PV),2023JJ00,2023,1881868,,19329,,16623,,2706,129183,,37191,91992,112603,,24723,-5120,87880,16580,19248,,1901116
107572,3000,Male,PV29  ,Zeeland (PV),2012JJ00,2012,189181,,1835,,1836,,-1,7458,,1915,5543,7747,,1655,-640,6092,-289,-299,,188882
107573,3000,Male,PV29  ,Zeeland (PV),2013JJ00,2013,188882,,1793,,1911,,-118,7520,,1840,5680,7615,,1333,-338,6282,-95,-208,,188674
107574,3000,Male,PV29  ,Zeeland (PV),2014JJ00,2014,188674,,1857,,1763,,94,7551,,1716,5835,7598,,1509,-321,6089,-47,44,,188718
107575,3000,Male,PV29  ,Zeeland (PV),2015JJ00,2015,188718,,1847,,1955,,-108,8016,,1837,6179,7505,,1386,-329,6119,511,397,,189115
107576,3000,Male,PV29  ,Zeeland (PV),2016JJ00,2016,189115,,1750,,1892,,-142,8868,,2100,6768,8507,,1393,-300,7114,361,222,,189337
107577,3000,Male,PV29  ,Zeeland (PV),2017JJ00,2017,189337,,1732,,1897,,-165,9128,,1940,7188,8607,,1433,-277,7174,521,346,,189683
107578,3000,Male,PV29  ,Zeeland (PV),2018JJ00,2018,189683,,1737,,1989,,-252,9188,,2229,6959,8529,,1554,-337,6975,659,419,,190102
107579,3000,Male,PV29  ,Zeeland (PV),2019JJ00,2019,190102,,1782,,1940,,-158,9140,,2202,6938,8657,,1659,-354,6998,483,333,,190435
107580,3000,Male,PV29  ,Zeeland (PV),2020JJ00,2020,190435,,1736,,2088,,-352,9637,,2136,7501,8303,,1357,-257,6946,1334,989,,191424
107581,3000,Male,PV29  ,Zeeland (PV),2021JJ00,2021,191424,,1801,,2424,,-623,9459,,2126,7333,8105,,1548,-335,6557,1354,738,,192162
107582,3000,Male,PV29  ,Zeeland (PV),2022JJ00,2022,192162,,1793,,2244,,-451,11283,,3545,7738,8881,,1909,-336,6972,2402,1945,,194107
107583,3000,Male,PV29  ,Zeeland (PV),2023JJ00,2023,194107,,1733,,2199,,-466,10352,,2753,7599,9381,,1966,-453,7415,971,511,,194618
107654,3000,Male,PV30  ,Noord-Brabant (PV),2012JJ00,2012,1229968,,12414,,10010,,2404,51013,,10534,40479,49381,,9122,-1991,40259,1632,4070,,1234038
107655,3000,Male,PV30  ,Noord-Brabant (PV),2013JJ00,2013,1234038,,12099,,10051,,2048,53490,,11336,42154,50938,,9154,-1107,41784,2552,4630,,1238668
107656,3000,Male,PV30  ,Noord-Brabant (PV),2014JJ00,2014,1238668,,12334,,10260,,2074,57995,,12995,45000,54865,,10610,-2159,44255,3130,5188,,1243856
107657,3000,Male,PV30  ,Noord-Brabant (PV),2015JJ00,2015,1243856,,12063,,10689,,1374,62895,,15018,47877,58491,,10741,-2166,47750,4404,5785,,1249641
107658,3000,Male,PV30  ,Noord-Brabant (PV),2016JJ00,2016,1249641,,12278,,11075,,1203,73618,,19471,54147,66950,,11050,-2376,55900,6668,7877,,1257518
107659,3000,Male,PV30  ,Noord-Brabant (PV),2017JJ00,2017,1257518,,12110,,11224,,886,73295,,17915,55380,65584,,10836,-2046,54748,7711,8575,,1266093
107660,3000,Male,PV30  ,Noord-Brabant (PV),2018JJ00,2018,1266093,,11977,,11341,,636,72089,,18862,53227,63745,,12106,-2725,51639,8344,8987,,1275080
107661,3000,Male,PV30  ,Noord-Brabant (PV),2019JJ00,2019,1275080,,12013,,11401,,612,73165,,20550,52615,64185,,12492,-2756,51693,8980,9606,,1284686
107662,3000,Male,PV30  ,Noord-Brabant (PV),2020JJ00,2020,1284686,,11947,,13498,,-1551,75370,,19611,55759,67652,,11309,-2321,56343,7718,6172,,1290858
107663,3000,Male,PV30  ,Noord-Brabant (PV),2021JJ00,2021,1290858,,13094,,12920,,174,78489,,22399,56090,68495,,11592,-2156,56903,9994,10160,,1301018
107664,3000,Male,PV30  ,Noord-Brabant (PV),2022JJ00,2022,1301018,,12213,,12735,,-522,87357,,32941,54416,69909,,13181,-2240,56728,17448,16908,,1317926
107665,3000,Male,PV30  ,Noord-Brabant (PV),2023JJ00,2023,1317926,,12107,,13020,,-913,88656,,32376,56280,77413,,14663,-3128,62750,11243,10349,,1328275
107736,3000,Male,PV31  ,Limburg (PV),2012JJ00,2012,556888,,4655,,5365,,-710,24625,,5949,18676,24329,,4765,-796,19564,296,-427,,556461
107737,3000,Male,PV31  ,Limburg (PV),2013JJ00,2013,556461,,4535,,5382,,-847,24084,,6073,18011,24224,,5088,-753,19136,-140,-973,,555488
107738,3000,Male,PV31  ,Limburg (PV),2014JJ00,2014,555488,,4496,,5330,,-834,25901,,6856,19045,25896,,5366,-760,20530,5,-838,,554650
107739,3000,Male,PV31  ,Limburg (PV),2015JJ00,2015,554650,,4473,,5903,,-1430,27953,,7582,20371,27294,,5694,-794,21600,659,-773,,553877
107740,3000,Male,PV31  ,Limburg (PV),2016JJ00,2016,553877,,4633,,5722,,-1089,30927,,7871,23056,28660,,5368,-680,23292,2267,1172,,555049
107741,3000,Male,PV31  ,Limburg (PV),2017JJ00,2017,555049,,4599,,5756,,-1157,30514,,7223,23291,29445,,5861,-858,23584,1069,-105,,554944
107742,3000,Male,PV31  ,Limburg (PV),2018JJ00,2018,554944,,4419,,5817,,-1398,30026,,7592,22434,28972,,6298,-922,22674,1054,-342,,554602
107743,3000,Male,PV31  ,Limburg (PV),2019JJ00,2019,554602,,4399,,5989,,-1590,31014,,8503,22511,28676,,6229,-702,22447,2338,725,,555327
107744,3000,Male,PV31  ,Limburg (PV),2020JJ00,2020,555327,,4392,,6884,,-2492,31886,,7648,24238,29558,,6581,-726,22977,2328,-178,,555149
107745,3000,Male,PV31  ,Limburg (PV),2021JJ00,2021,555149,,4829,,7023,,-2194,32647,,8172,24475,29145,,6497,-1002,22648,3502,1272,,556421
107746,3000,Male,PV31  ,Limburg (PV),2022JJ00,2022,556421,,4542,,6492,,-1950,35381,,11692,23689,28828,,7175,-1118,21653,6553,4594,,561015
107747,3000,Male,PV31  ,Limburg (PV),2023JJ00,2023,561015,,4437,,6504,,-2067,34755,,10695,24060,29997,,7754,-1488,22243,4758,2668,,563683
107818,3000,Male,CR01  ,Oost-Groningen (CR),2012JJ00,2012,74935,,678,,826,,-148,3206,,335,2871,3562,,369,-129,3193,-356,-506,,74429
107819,3000,Male,CR01  ,Oost-Groningen (CR),2013JJ00,2013,74429,,610,,826,,-216,3191,,555,2636,3432,,322,-69,3110,-241,-457,,73972
107820,3000,Male,CR01  ,Oost-Groningen (CR),2014JJ00,2014,73972,,649,,776,,-127,4437,,1713,2724,3998,,332,-77,3666,439,307,,74279
107821,3000,Male,CR01  ,Oost-Groningen (CR),2015JJ00,2015,74279,,634,,808,,-174,6206,,3128,3078,6149,,399,-140,5750,57,-112,,74167
107822,3000,Male,CR01  ,Oost-Groningen (CR),2016JJ00,2016,74167,,677,,852,,-175,6890,,3248,3642,7341,,313,-100,7028,-451,-628,,73539
107823,3000,Male,CR01  ,Oost-Groningen (CR),2017JJ00,2017,73539,,591,,843,,-252,4963,,1258,3705,5041,,389,-193,4652,-78,-330,,73209
107824,3000,Male,CR01  ,Oost-Groningen (CR),2018JJ00,2018,67094,,519,,782,,-263,7356,,4325,3031,7027,,212,-23,6815,329,76,,67170
107825,3000,Male,CR01  ,Oost-Groningen (CR),2019JJ00,2019,67170,,546,,816,,-270,7386,,4067,3319,6985,,301,-113,6684,401,150,,67320
107826,3000,Male,CR01  ,Oost-Groningen (CR),2020JJ00,2020,67320,,576,,808,,-232,7228,,3528,3700,6552,,255,-71,6297,676,460,,67780
107827,3000,Male,CR01  ,Oost-Groningen (CR),2021JJ00,2021,67780,,566,,950,,-384,10830,,7052,3778,9988,,175,-18,9813,842,500,,68280
107828,3000,Male,CR01  ,Oost-Groningen (CR),2022JJ00,2022,68280,,572,,888,,-316,11820,,8308,3512,10938,,322,-99,10616,882,599,,68879
107829,3000,Male,CR01  ,Oost-Groningen (CR),2023JJ00,2023,68879,,493,,915,,-422,13029,,9716,3313,12483,,385,-109,12098,546,168,,69047
107900,3000,Male,CR02  ,Delfzijl en omgeving (CR),2012JJ00,2012,24261,,231,,261,,-30,1097,,201,896,1257,,214,-141,1043,-160,-186,,24075
107901,3000,Male,CR02  ,Delfzijl en omgeving (CR),2013JJ00,2013,24075,,197,,274,,-77,1018,,211,807,1149,,137,-52,1012,-131,-209,,23866
107902,3000,Male,CR02  ,Delfzijl en omgeving (CR),2014JJ00,2014,23866,,177,,267,,-90,1317,,404,913,1406,,144,-49,1262,-89,-178,,23688
107903,3000,Male,CR02  ,Delfzijl en omgeving (CR),2015JJ00,2015,23688,,180,,268,,-88,1347,,346,1001,1498,,137,-51,1361,-151,-235,,23453
107904,3000,Male,CR02  ,Delfzijl en omgeving (CR),2016JJ00,2016,23453,,214,,285,,-71,1567,,285,1282,1566,,116,-42,1450,1,-70,,23383
107905,3000,Male,CR02  ,Delfzijl en omgeving (CR),2017JJ00,2017,23383,,191,,271,,-80,1281,,127,1154,1420,,117,-58,1303,-139,-218,,23165
107906,3000,Male,CR02  ,Delfzijl en omgeving (CR),2018JJ00,2018,23165,,190,,273,,-83,1289,,198,1091,1366,,98,-27,1268,-77,-156,,23009
107907,3000,Male,CR02  ,Delfzijl en omgeving (CR),2019JJ00,2019,23009,,196,,283,,-87,1330,,238,1092,1328,,105,-21,1223,2,-79,,22930
107908,3000,Male,CR02  ,Delfzijl en omgeving (CR),2020JJ00,2020,22930,,204,,300,,-96,1268,,214,1054,1261,,89,-6,1172,7,-89,,22841
107909,3000,Male,CR02  ,Delfzijl en omgeving (CR),2021JJ00,2021,22841,,204,,334,,-130,1091,,154,937,1043,,116,-21,927,48,-81,,22760
107910,3000,Male,CR02  ,Delfzijl en omgeving (CR),2022JJ00,2022,22760,,188,,292,,-104,1319,,261,1058,1233,,159,-51,1074,86,-17,,22743
107911,3000,Male,CR02  ,Delfzijl en omgeving (CR),2023JJ00,2023,22743,,189,,294,,-105,1183,,187,996,1144,,121,-28,1023,39,-62,,22681
107982,3000,Male,CR03  ,Overig Groningen (CR),2012JJ00,2012,189558,,1923,,1566,,357,12695,,2500,10195,11846,,2206,-437,9640,849,1213,,190771
107983,3000,Male,CR03  ,Overig Groningen (CR),2013JJ00,2013,190771,,1864,,1484,,380,12958,,2481,10477,12131,,2228,-590,9903,827,1211,,191982
107984,3000,Male,CR03  ,Overig Groningen (CR),2014JJ00,2014,191982,,1892,,1514,,378,13708,,2688,11020,13197,,2625,-866,10572,511,891,,192873
107985,3000,Male,CR03  ,Overig Groningen (CR),2015JJ00,2015,192873,,1889,,1549,,340,14205,,2967,11238,13993,,2432,-577,11561,212,565,,193438
107986,3000,Male,CR03  ,Overig Groningen (CR),2016JJ00,2016,193438,,1874,,1510,,364,15342,,3255,12087,14775,,2579,-646,12196,567,931,,194369
107987,3000,Male,CR03  ,Overig Groningen (CR),2017JJ00,2017,194369,,1798,,1625,,173,14876,,3069,11807,14844,,2629,-730,12215,32,195,,194564
107988,3000,Male,CR03  ,Overig Groningen (CR),2018JJ00,2018,200679,,1807,,1591,,216,14580,,3438,11142,14219,,2418,-437,11801,361,578,,201257
107989,3000,Male,CR03  ,Overig Groningen (CR),2019JJ00,2019,201257,,1902,,1669,,233,13720,,3802,9918,13006,,2649,-485,10357,714,937,,202194
107990,3000,Male,CR03  ,Overig Groningen (CR),2020JJ00,2020,202194,,1885,,1765,,120,13417,,3225,10192,12986,,2782,-525,10204,431,546,,202740
107991,3000,Male,CR03  ,Overig Groningen (CR),2021JJ00,2021,202740,,1966,,1821,,145,13694,,3859,9835,12659,,2620,-395,10039,1035,1168,,203908
107992,3000,Male,CR03  ,Overig Groningen (CR),2022JJ00,2022,203908,,1753,,1923,,-170,14673,,4984,9689,12458,,2615,-260,9843,2215,2043,,205951
107993,3000,Male,CR03  ,Overig Groningen (CR),2023JJ00,2023,205951,,1726,,1847,,-121,15998,,4198,11800,13271,,3062,-455,10209,2727,2607,,208558
108064,3000,Male,CR04  ,Noord-Friesland (CR),2012JJ00,2012,166583,,1774,,1436,,338,7267,,926,6341,7430,,799,-20,6631,-163,173,,166756
108065,3000,Male,CR04  ,Noord-Friesland (CR),2013JJ00,2013,166756,,1702,,1485,,217,7556,,948,6608,7814,,841,-88,6973,-258,-33,,166723
108066,3000,Male,CR04  ,Noord-Friesland (CR),2014JJ00,2014,162516,,1633,,1383,,250,7815,,1170,6645,8028,,880,-147,7148,-213,26,,162542
108067,3000,Male,CR04  ,Noord-Friesland (CR),2015JJ00,2015,162542,,1550,,1449,,101,7922,,1096,6826,7990,,732,-26,7258,-68,29,,162571
108068,3000,Male,CR04  ,Noord-Friesland (CR),2016JJ00,2016,162571,,1633,,1517,,116,8632,,1043,7589,8473,,737,1,7736,159,276,,162847
108069,3000,Male,CR04  ,Noord-Friesland (CR),2017JJ00,2017,162847,,1554,,1497,,57,8916,,1028,7888,8864,,944,-220,7920,52,100,,162947
108070,3000,Male,CR04  ,Noord-Friesland (CR),2018JJ00,2018,160186,,1510,,1510,,0,7964,,1192,6772,7935,,825,-131,7110,29,36,,160222
108071,3000,Male,CR04  ,Noord-Friesland (CR),2019JJ00,2019,160222,,1531,,1519,,12,8287,,1371,6916,7576,,790,-69,6786,711,713,,160935
108072,3000,Male,CR04  ,Noord-Friesland (CR),2020JJ00,2020,160935,,1453,,1562,,-109,8145,,1092,7053,7517,,838,-136,6679,628,517,,161452
108073,3000,Male,CR04  ,Noord-Friesland (CR),2021JJ00,2021,161452,,1598,,1823,,-225,8354,,1087,7267,7327,,791,-199,6536,1027,800,,162252
108074,3000,Male,CR04  ,Noord-Friesland (CR),2022JJ00,2022,162252,,1529,,1671,,-142,9143,,2345,6798,7323,,1110,-241,6213,1820,1679,,163931
108075,3000,Male,CR04  ,Noord-Friesland (CR),2023JJ00,2023,163931,,1483,,1712,,-229,9429,,1912,7517,8098,,1384,-439,6714,1331,1092,,165023
108146,3000,Male,CR05  ,Zuidwest-Friesland (CR),2012JJ00,2012,53338,,518,,498,,20,1472,,167,1305,1542,,183,-29,1359,-70,-51,,53287
108147,3000,Male,CR05  ,Zuidwest-Friesland (CR),2013JJ00,2013,53287,,542,,516,,26,1522,,160,1362,1595,,153,-10,1442,-73,-53,,53234
108148,3000,Male,CR05  ,Zuidwest-Friesland (CR),2014JJ00,2014,67968,,607,,559,,48,1959,,234,1725,2065,,246,-41,1819,-106,-64,,67904
108149,3000,Male,CR05  ,Zuidwest-Friesland (CR),2015JJ00,2015,67904,,626,,637,,-11,2095,,200,1895,2067,,184,-4,1883,28,18,,67922
108150,3000,Male,CR05  ,Zuidwest-Friesland (CR),2016JJ00,2016,67922,,643,,625,,18,2484,,231,2253,2251,,193,-12,2058,233,249,,68171
108151,3000,Male,CR05  ,Zuidwest-Friesland (CR),2017JJ00,2017,68171,,649,,591,,58,2816,,294,2522,2710,,216,-48,2494,106,161,,68332
108152,3000,Male,CR05  ,Zuidwest-Friesland (CR),2018JJ00,2018,71093,,613,,720,,-107,2613,,384,2229,2630,,258,-69,2372,-17,-124,,70969
108153,3000,Male,CR05  ,Zuidwest-Friesland (CR),2019JJ00,2019,70969,,661,,651,,10,2748,,338,2410,2496,,247,-60,2249,252,263,,71232
108154,3000,Male,CR05  ,Zuidwest-Friesland (CR),2020JJ00,2020,71232,,644,,752,,-108,2772,,246,2526,2546,,199,-41,2347,226,118,,71350
108155,3000,Male,CR05  ,Zuidwest-Friesland (CR),2021JJ00,2021,71350,,703,,761,,-58,3159,,242,2917,2933,,189,-34,2744,226,173,,71523
108156,3000,Male,CR05  ,Zuidwest-Friesland (CR),2022JJ00,2022,71523,,628,,776,,-148,3421,,667,2754,2772,,309,-47,2463,649,497,,72020
108157,3000,Male,CR05  ,Zuidwest-Friesland (CR),2023JJ00,2023,72020,,611,,776,,-165,3016,,360,2656,3015,,338,-47,2677,1,-166,,71854
108228,3000,Male,CR06  ,Zuidoost-Friesland (CR),2012JJ00,2012,103574,,1015,,956,,59,3710,,405,3305,3949,,381,-100,3568,-239,-175,,103399
108229,3000,Male,CR06  ,Zuidoost-Friesland (CR),2013JJ00,2013,103399,,997,,976,,21,3759,,435,3324,3916,,295,-39,3621,-157,-114,,103285
108230,3000,Male,CR06  ,Zuidoost-Friesland (CR),2014JJ00,2014,92758,,973,,921,,52,4084,,580,3504,3942,,325,-80,3617,142,194,,92952
108231,3000,Male,CR06  ,Zuidoost-Friesland (CR),2015JJ00,2015,92952,,874,,925,,-51,4019,,477,3542,4035,,310,-33,3725,-16,-69,,92883
108232,3000,Male,CR06  ,Zuidoost-Friesland (CR),2016JJ00,2016,92883,,854,,947,,-93,4504,,461,4043,4257,,356,-79,3901,247,147,,93030
108233,3000,Male,CR06  ,Zuidoost-Friesland (CR),2017JJ00,2017,93030,,879,,885,,-6,4505,,379,4126,4313,,309,-71,4004,192,182,,93212
108234,3000,Male,CR06  ,Zuidoost-Friesland (CR),2018JJ00,2018,93212,,837,,923,,-86,4466,,368,4098,4117,,307,-53,3810,349,263,,93475
108235,3000,Male,CR06  ,Zuidoost-Friesland (CR),2019JJ00,2019,93475,,832,,915,,-83,4450,,533,3917,4058,,290,-35,3768,392,309,,93784
108236,3000,Male,CR06  ,Zuidoost-Friesland (CR),2020JJ00,2020,93784,,875,,1011,,-136,4387,,383,4004,4048,,243,-45,3805,339,202,,93986
108237,3000,Male,CR06  ,Zuidoost-Friesland (CR),2021JJ00,2021,93986,,908,,989,,-81,4494,,276,4218,4016,,314,-123,3702,478,394,,94380
108238,3000,Male,CR06  ,Zuidoost-Friesland (CR),2022JJ00,2022,94380,,816,,1066,,-250,4722,,723,3999,3908,,356,-63,3552,814,558,,94938
108239,3000,Male,CR06  ,Zuidoost-Friesland (CR),2023JJ00,2023,94938,,847,,1037,,-190,4791,,617,4174,4070,,392,-76,3678,721,532,,95470
108310,3000,Male,CR07  ,Noord-Drenthe (CR),2012JJ00,2012,93757,,867,,893,,-26,3993,,304,3689,4034,,372,-79,3662,-41,-64,,93693
108311,3000,Male,CR07  ,Noord-Drenthe (CR),2013JJ00,2013,93693,,822,,873,,-51,4151,,344,3807,4089,,255,37,3834,62,15,,93708
108312,3000,Male,CR07  ,Noord-Drenthe (CR),2014JJ00,2014,93708,,842,,809,,33,4200,,328,3872,4237,,272,3,3965,-37,-4,,93704
108313,3000,Male,CR07  ,Noord-Drenthe (CR),2015JJ00,2015,93704,,785,,970,,-185,5112,,705,4407,4804,,317,1,4487,308,125,,93829
108314,3000,Male,CR07  ,Noord-Drenthe (CR),2016JJ00,2016,93829,,837,,911,,-74,9403,,4205,5198,7938,,323,-10,7615,1465,1393,,95222
108315,3000,Male,CR07  ,Noord-Drenthe (CR),2017JJ00,2017,95222,,838,,993,,-155,12648,,7390,5258,12636,,329,-80,12307,12,-152,,95070
108316,3000,Male,CR07  ,Noord-Drenthe (CR),2018JJ00,2018,95070,,834,,996,,-162,5565,,432,5133,5506,,289,-9,5217,59,-115,,94955
108317,3000,Male,CR07  ,Noord-Drenthe (CR),2019JJ00,2019,94955,,797,,995,,-198,5705,,653,5052,5013,,233,8,4780,692,490,,95445
108318,3000,Male,CR07  ,Noord-Drenthe (CR),2020JJ00,2020,95445,,813,,1061,,-248,5630,,389,5241,5123,,204,3,4919,507,256,,95701
108319,3000,Male,CR07  ,Noord-Drenthe (CR),2021JJ00,2021,95701,,853,,1126,,-273,5774,,294,5480,5061,,296,-61,4765,713,432,,96133
108320,3000,Male,CR07  ,Noord-Drenthe (CR),2022JJ00,2022,96133,,783,,1116,,-333,6021,,994,5027,5069,,388,-37,4681,952,620,,96753
108321,3000,Male,CR07  ,Noord-Drenthe (CR),2023JJ00,2023,96753,,834,,1107,,-273,6082,,717,5365,5326,,525,-171,4801,756,480,,97233
108392,3000,Male,CR08  ,Zuidoost-Drenthe (CR),2012JJ00,2012,84723,,727,,873,,-146,2964,,513,2451,3225,,505,-197,2720,-261,-413,,84310
108393,3000,Male,CR08  ,Zuidoost-Drenthe (CR),2013JJ00,2013,84310,,674,,851,,-177,2935,,522,2413,3040,,414,-169,2626,-105,-283,,84027
108394,3000,Male,CR08  ,Zuidoost-Drenthe (CR),2014JJ00,2014,84027,,721,,828,,-107,2905,,572,2333,2993,,401,-120,2592,-88,-203,,83824
108395,3000,Male,CR08  ,Zuidoost-Drenthe (CR),2015JJ00,2015,83824,,696,,820,,-124,3297,,589,2708,3267,,383,-118,2884,30,-99,,83725
108396,3000,Male,CR08  ,Zuidoost-Drenthe (CR),2016JJ00,2016,83725,,735,,902,,-167,3587,,594,2993,3444,,382,-75,3062,143,-24,,83701
108397,3000,Male,CR08  ,Zuidoost-Drenthe (CR),2017JJ00,2017,83701,,664,,910,,-246,3726,,409,3317,3634,,321,-59,3313,92,-158,,83543
108398,3000,Male,CR08  ,Zuidoost-Drenthe (CR),2018JJ00,2018,83543,,658,,924,,-266,3705,,424,3281,3290,,282,-10,3008,415,152,,83695
108399,3000,Male,CR08  ,Zuidoost-Drenthe (CR),2019JJ00,2019,83695,,724,,880,,-156,3731,,455,3276,3510,,455,-172,3055,221,49,,83744
108400,3000,Male,CR08  ,Zuidoost-Drenthe (CR),2020JJ00,2020,83744,,672,,994,,-322,3590,,302,3288,3262,,327,-61,2935,328,-10,,83734
108401,3000,Male,CR08  ,Zuidoost-Drenthe (CR),2021JJ00,2021,83734,,748,,1035,,-287,4038,,334,3704,3026,,296,-84,2730,1012,720,,84454
108402,3000,Male,CR08  ,Zuidoost-Drenthe (CR),2022JJ00,2022,84454,,688,,1024,,-336,4139,,817,3322,3056,,340,-80,2716,1083,728,,85182
108403,3000,Male,CR08  ,Zuidoost-Drenthe (CR),2023JJ00,2023,85182,,658,,1036,,-378,4210,,773,3437,3308,,505,-105,2803,902,507,,85689
108474,3000,Male,CR09  ,Zuidwest-Drenthe (CR),2012JJ00,2012,64654,,649,,585,,64,2358,,221,2137,2323,,127,29,2196,35,100,,64754
108475,3000,Male,CR09  ,Zuidwest-Drenthe (CR),2013JJ00,2013,64754,,597,,631,,-34,2148,,181,1967,2368,,186,-27,2182,-220,-259,,64495
108476,3000,Male,CR09  ,Zuidwest-Drenthe (CR),2014JJ00,2014,64495,,646,,590,,56,2518,,300,2218,2346,,190,-9,2156,172,239,,64734
108477,3000,Male,CR09  ,Zuidwest-Drenthe (CR),2015JJ00,2015,64734,,600,,609,,-9,3236,,860,2376,3034,,218,-16,2816,202,195,,64929
108478,3000,Male,CR09  ,Zuidwest-Drenthe (CR),2016JJ00,2016,64929,,575,,660,,-85,3694,,642,3052,3466,,196,-45,3270,228,146,,65075
108479,3000,Male,CR09  ,Zuidwest-Drenthe (CR),2017JJ00,2017,65075,,635,,665,,-30,3449,,348,3101,2885,,136,15,2749,564,528,,65603
108480,3000,Male,CR09  ,Zuidwest-Drenthe (CR),2018JJ00,2018,65603,,578,,702,,-124,3499,,474,3025,3073,,327,-137,2746,426,303,,65906
108481,3000,Male,CR09  ,Zuidwest-Drenthe (CR),2019JJ00,2019,65906,,595,,612,,-17,3334,,350,2984,2939,,244,-54,2695,395,380,,66286
108482,3000,Male,CR09  ,Zuidwest-Drenthe (CR),2020JJ00,2020,66286,,596,,717,,-121,3335,,305,3030,2910,,178,-39,2732,425,306,,66592
108483,3000,Male,CR09  ,Zuidwest-Drenthe (CR),2021JJ00,2021,66592,,665,,814,,-149,3688,,327,3361,3013,,255,-79,2758,675,523,,67115
108484,3000,Male,CR09  ,Zuidwest-Drenthe (CR),2022JJ00,2022,67115,,555,,817,,-262,3995,,786,3209,3141,,316,-85,2825,854,590,,67705
108485,3000,Male,CR09  ,Zuidwest-Drenthe (CR),2023JJ00,2023,67705,,540,,730,,-190,3994,,551,3443,3332,,381,-128,2951,662,467,,68172
108556,3000,Male,CR10  ,Noord-Overijssel (CR),2012JJ00,2012,178427,,2282,,1318,,964,6053,,735,5318,6134,,719,-123,5415,-81,882,,179309
108557,3000,Male,CR10  ,Noord-Overijssel (CR),2013JJ00,2013,179309,,2205,,1301,,904,5890,,724,5166,6187,,731,-100,5456,-297,612,,179921
108558,3000,Male,CR10  ,Noord-Overijssel (CR),2014JJ00,2014,179921,,2224,,1382,,842,6344,,731,5613,6642,,785,-131,5857,-298,545,,180466
108559,3000,Male,CR10  ,Noord-Overijssel (CR),2015JJ00,2015,180466,,2163,,1379,,784,7504,,1149,6355,6800,,669,-68,6131,704,1503,,181969
108560,3000,Male,CR10  ,Noord-Overijssel (CR),2016JJ00,2016,181969,,2152,,1401,,751,7850,,867,6983,7430,,751,-55,6679,420,1166,,183135
108561,3000,Male,CR10  ,Noord-Overijssel (CR),2017JJ00,2017,183135,,2125,,1458,,667,8265,,824,7441,7525,,722,-108,6803,740,1410,,184545
108562,3000,Male,CR10  ,Noord-Overijssel (CR),2018JJ00,2018,184545,,2070,,1484,,586,8513,,1015,7498,7518,,730,-74,6788,995,1591,,186136
108563,3000,Male,CR10  ,Noord-Overijssel (CR),2019JJ00,2019,186136,,2126,,1441,,685,8121,,1180,6941,7256,,818,-124,6438,865,1546,,187682
108564,3000,Male,CR10  ,Noord-Overijssel (CR),2020JJ00,2020,187682,,2121,,1664,,457,8239,,1012,7227,7370,,651,-92,6719,869,1322,,189004
108565,3000,Male,CR10  ,Noord-Overijssel (CR),2021JJ00,2021,189004,,2218,,1684,,534,8188,,914,7274,7346,,729,-164,6617,842,1365,,190369
108566,3000,Male,CR10  ,Noord-Overijssel (CR),2022JJ00,2022,190369,,2090,,1708,,382,9735,,2217,7518,7603,,998,-143,6605,2132,2526,,192895
108567,3000,Male,CR10  ,Noord-Overijssel (CR),2023JJ00,2023,192895,,1989,,1659,,330,8966,,1504,7462,8034,,1080,-227,6954,932,1257,,194152
108638,3000,Male,CR11  ,Zuidwest-Overijssel (CR),2012JJ00,2012,75802,,843,,571,,272,2731,,626,2105,2989,,461,-106,2528,-258,19,,75821
108639,3000,Male,CR11  ,Zuidwest-Overijssel (CR),2013JJ00,2013,75821,,785,,616,,169,2910,,702,2208,3111,,609,-241,2502,-201,-33,,75788
108640,3000,Male,CR11  ,Zuidwest-Overijssel (CR),2014JJ00,2014,75788,,790,,620,,170,3222,,851,2371,3129,,470,-124,2659,93,261,,76049
108641,3000,Male,CR11  ,Zuidwest-Overijssel (CR),2015JJ00,2015,76049,,762,,635,,127,3532,,814,2718,3316,,417,-45,2899,216,345,,76394
108642,3000,Male,CR11  ,Zuidwest-Overijssel (CR),2016JJ00,2016,76394,,783,,631,,152,3797,,708,3089,3658,,711,-354,2947,139,290,,76684
108643,3000,Male,CR11  ,Zuidwest-Overijssel (CR),2017JJ00,2017,76684,,773,,712,,61,3818,,610,3208,3528,,475,-120,3053,290,345,,77029
108644,3000,Male,CR11  ,Zuidwest-Overijssel (CR),2018JJ00,2018,77029,,738,,707,,31,3695,,693,3002,3341,,406,-70,2935,354,399,,77428
108645,3000,Male,CR11  ,Zuidwest-Overijssel (CR),2019JJ00,2019,77428,,712,,698,,14,3774,,741,3033,3263,,507,-110,2756,511,522,,77950
108646,3000,Male,CR11  ,Zuidwest-Overijssel (CR),2020JJ00,2020,77950,,779,,813,,-34,3743,,540,3203,3270,,335,-18,2935,473,439,,78389
108647,3000,Male,CR11  ,Zuidwest-Overijssel (CR),2021JJ00,2021,78389,,808,,770,,38,3636,,562,3074,3372,,430,-76,2942,264,311,,78700
108648,3000,Male,CR11  ,Zuidwest-Overijssel (CR),2022JJ00,2022,78700,,780,,783,,-3,4004,,888,3116,3055,,366,-40,2689,949,951,,79651
108649,3000,Male,CR11  ,Zuidwest-Overijssel (CR),2023JJ00,2023,79651,,726,,779,,-53,3910,,719,3191,3451,,622,-197,2829,459,408,,80059
108720,3000,Male,CR12  ,Twente (CR),2012JJ00,2012,314535,,3165,,2697,,468,10929,,2181,8748,11370,,2190,-442,9180,-441,25,,314560
108721,3000,Male,CR12  ,Twente (CR),2013JJ00,2013,314560,,3216,,2789,,427,10790,,2039,8751,11280,,2194,-447,9086,-490,-55,,314505
108722,3000,Male,CR12  ,Twente (CR),2014JJ00,2014,314505,,3199,,2646,,553,11136,,2060,9076,11795,,2290,-445,9505,-659,-126,,314379
108723,3000,Male,CR12  ,Twente (CR),2015JJ00,2015,314379,,3201,,2756,,445,12346,,2918,9428,12205,,2271,-401,9934,141,582,,314961
108724,3000,Male,CR12  ,Twente (CR),2016JJ00,2016,314961,,2993,,2852,,141,14007,,2853,11154,13493,,2223,-452,11270,514,648,,315609
108725,3000,Male,CR12  ,Twente (CR),2017JJ00,2017,315609,,2919,,2937,,-18,13642,,2649,10993,13374,,2143,-338,11231,268,248,,315857
108726,3000,Male,CR12  ,Twente (CR),2018JJ00,2018,315857,,2862,,2869,,-7,13702,,3085,10617,12620,,2082,-174,10538,1082,1070,,316927
108727,3000,Male,CR12  ,Twente (CR),2019JJ00,2019,316927,,2910,,2999,,-89,14290,,3590,10700,12998,,2460,-542,10538,1292,1197,,318124
108728,3000,Male,CR12  ,Twente (CR),2020JJ00,2020,318124,,2848,,3371,,-523,14043,,3055,10988,12987,,2207,-482,10780,1056,538,,318662
108729,3000,Male,CR12  ,Twente (CR),2021JJ00,2021,318662,,2968,,3361,,-393,14515,,3377,11138,12695,,2276,-441,10419,1820,1427,,320089
108730,3000,Male,CR12  ,Twente (CR),2022JJ00,2022,320089,,2833,,3326,,-493,15812,,4992,10820,12976,,2706,-539,10270,2836,2319,,322408
108731,3000,Male,CR12  ,Twente (CR),2023JJ00,2023,322408,,2936,,3276,,-340,15867,,4084,11783,13982,,2968,-740,11014,1885,1539,,323947
108802,3000,Male,CR13  ,Veluwe (CR),2012JJ00,2012,325320,,3624,,2712,,912,12980,,2002,10978,12613,,1798,-400,10815,367,1296,,326616
108803,3000,Male,CR13  ,Veluwe (CR),2013JJ00,2013,326616,,3698,,2818,,880,13403,,2125,11278,13113,,2152,-574,10961,290,1181,,327797
108804,3000,Male,CR13  ,Veluwe (CR),2014JJ00,2014,327797,,3635,,2631,,1004,14754,,2396,12358,13644,,2100,-342,11544,1110,2129,,329926
108805,3000,Male,CR13  ,Veluwe (CR),2015JJ00,2015,329926,,3612,,2689,,923,15490,,2576,12914,14024,,2129,-460,11895,1466,2398,,332324
108806,3000,Male,CR13  ,Veluwe (CR),2016JJ00,2016,332324,,3795,,2884,,911,16971,,2431,14540,14633,,2184,-456,12449,2338,3247,,335571
108807,3000,Male,CR13  ,Veluwe (CR),2017JJ00,2017,335571,,3617,,2862,,755,17682,,2830,14852,15412,,2185,-528,13227,2270,3014,,338585
108808,3000,Male,CR13  ,Veluwe (CR),2018JJ00,2018,338585,,3710,,2975,,735,17632,,2809,14823,15355,,2223,-414,13132,2277,3024,,341609
108809,3000,Male,CR13  ,Veluwe (CR),2019JJ00,2019,341609,,3716,,3032,,684,18422,,2963,15459,15456,,2142,-412,13314,2966,3654,,345263
108810,3000,Male,CR13  ,Veluwe (CR),2020JJ00,2020,345263,,3714,,3340,,374,18131,,2521,15610,15591,,1778,-307,13813,2540,2911,,348174
108811,3000,Male,CR13  ,Veluwe (CR),2021JJ00,2021,348174,,3932,,3411,,521,18098,,2713,15385,15464,,1826,-384,13638,2634,3141,,351315
108812,3000,Male,CR13  ,Veluwe (CR),2022JJ00,2022,351315,,3790,,3438,,352,19220,,4940,14280,15250,,2272,-466,12978,3970,4319,,355634
108813,3000,Male,CR13  ,Veluwe (CR),2023JJ00,2023,355634,,3476,,3344,,132,19619,,3818,15801,16369,,2760,-689,13609,3250,3362,,358996
108884,3000,Male,CR14  ,Achterhoek (CR),2012JJ00,2012,199662,,1672,,1832,,-160,7248,,794,6454,7540,,751,-177,6789,-292,-450,,199212
108885,3000,Male,CR14  ,Achterhoek (CR),2013JJ00,2013,199212,,1695,,1890,,-195,7217,,843,6374,7397,,675,-83,6722,-180,-368,,198844
108886,3000,Male,CR14  ,Achterhoek (CR),2014JJ00,2014,198844,,1666,,1866,,-200,7812,,1161,6651,7974,,710,-102,7264,-162,-355,,198489
108887,3000,Male,CR14  ,Achterhoek (CR),2015JJ00,2015,198489,,1563,,1936,,-373,8538,,1378,7160,7844,,609,-65,7235,694,316,,198805
108888,3000,Male,CR14  ,Achterhoek (CR),2016JJ00,2016,198805,,1680,,1955,,-275,11693,,3402,8291,10860,,650,-62,10210,833,548,,199353
108889,3000,Male,CR14  ,Achterhoek (CR),2017JJ00,2017,199353,,1648,,1985,,-337,9649,,911,8738,9118,,726,-137,8392,531,196,,199549
108890,3000,Male,CR14  ,Achterhoek (CR),2018JJ00,2018,199549,,1517,,2066,,-549,9191,,978,8213,8476,,742,-129,7734,715,164,,199713
108891,3000,Male,CR14  ,Achterhoek (CR),2019JJ00,2019,199713,,1645,,2080,,-435,9180,,1048,8132,8421,,804,-230,7617,759,325,,200038
108892,3000,Male,CR14  ,Achterhoek (CR),2020JJ00,2020,200038,,1617,,2251,,-634,9373,,807,8566,8156,,638,-137,7518,1217,587,,200625
108893,3000,Male,CR14  ,Achterhoek (CR),2021JJ00,2021,200625,,1707,,2349,,-642,9471,,718,8753,8159,,645,-100,7514,1312,666,,201291
108894,3000,Male,CR14  ,Achterhoek (CR),2022JJ00,2022,201291,,1655,,2317,,-662,9957,,1662,8295,7961,,897,-186,7064,1996,1343,,202634
108895,3000,Male,CR14  ,Achterhoek (CR),2023JJ00,2023,202634,,1651,,2303,,-652,9745,,1229,8516,8626,,975,-181,7651,1119,459,,203093
108966,3000,Male,CR15  ,Arnhem/Nijmegen (CR),2012JJ00,2012,350028,,3607,,2856,,751,18363,,2419,15944,17878,,2742,-756,15136,485,1236,,351264
108967,3000,Male,CR15  ,Arnhem/Nijmegen (CR),2013JJ00,2013,351264,,3596,,2900,,696,19057,,2601,16456,18088,,2605,-592,15483,969,1668,,352932
108968,3000,Male,CR15  ,Arnhem/Nijmegen (CR),2014JJ00,2014,352932,,3622,,2812,,810,19884,,2706,17178,18686,,2592,-494,16094,1198,2008,,354940
108969,3000,Male,CR15  ,Arnhem/Nijmegen (CR),2015JJ00,2015,354940,,3488,,2996,,492,21020,,3253,17767,19656,,2549,-579,17107,1364,1867,,356807
108970,3000,Male,CR15  ,Arnhem/Nijmegen (CR),2016JJ00,2016,356807,,3431,,3032,,399,25314,,4331,20983,22678,,2646,-555,20032,2636,3027,,359834
108971,3000,Male,CR15  ,Arnhem/Nijmegen (CR),2017JJ00,2017,359834,,3501,,3170,,331,24627,,3815,20812,22506,,2740,-713,19766,2121,2436,,362270
108972,3000,Male,CR15  ,Arnhem/Nijmegen (CR),2018JJ00,2018,362270,,3436,,3238,,198,23096,,4017,19079,21501,,2625,-603,18876,1595,1811,,364081
108973,3000,Male,CR15  ,Arnhem/Nijmegen (CR),2019JJ00,2019,364081,,3397,,3139,,258,24446,,5617,18829,22334,,2720,-626,19614,2112,2402,,366483
108974,3000,Male,CR15  ,Arnhem/Nijmegen (CR),2020JJ00,2020,366483,,3476,,3587,,-111,23361,,4218,19143,22180,,2421,-520,19759,1181,1080,,367563
108975,3000,Male,CR15  ,Arnhem/Nijmegen (CR),2021JJ00,2021,367563,,3542,,3622,,-80,24045,,4905,19140,22024,,2371,-592,19653,2021,1946,,369509
108976,3000,Male,CR15  ,Arnhem/Nijmegen (CR),2022JJ00,2022,369509,,3436,,3534,,-98,26111,,7417,18694,22403,,2824,-607,19579,3708,3602,,373111
108977,3000,Male,CR15  ,Arnhem/Nijmegen (CR),2023JJ00,2023,373111,,3418,,3559,,-141,27664,,7608,20056,24191,,3156,-778,21035,3473,3330,,376441
109048,3000,Male,CR16  ,Zuidwest-Gelderland (CR),2012JJ00,2012,117658,,1205,,889,,316,4230,,590,3640,4122,,421,-61,3701,108,430,,118088
109049,3000,Male,CR16  ,Zuidwest-Gelderland (CR),2013JJ00,2013,118088,,1239,,831,,408,4158,,602,3556,4372,,471,-42,3901,-214,189,,118277
109050,3000,Male,CR16  ,Zuidwest-Gelderland (CR),2014JJ00,2014,118277,,1282,,920,,362,4453,,639,3814,4529,,503,-28,4026,-76,290,,118567
109051,3000,Male,CR16  ,Zuidwest-Gelderland (CR),2015JJ00,2015,118567,,1220,,941,,279,4878,,663,4215,4700,,562,-101,4138,178,461,,119028
109052,3000,Male,CR16  ,Zuidwest-Gelderland (CR),2016JJ00,2016,119028,,1228,,892,,336,5665,,667,4998,5065,,517,-86,4548,600,931,,119959
109053,3000,Male,CR16  ,Zuidwest-Gelderland (CR),2017JJ00,2017,119959,,1247,,938,,309,6116,,738,5378,5670,,584,-102,5086,446,754,,120713
109054,3000,Male,CR16  ,Zuidwest-Gelderland (CR),2018JJ00,2018,120713,,1266,,978,,288,6813,,1611,5202,5572,,620,-119,4952,1241,1533,,122246
109055,3000,Male,CR16  ,Zuidwest-Gelderland (CR),2019JJ00,2019,122246,,1258,,928,,330,6761,,1545,5216,5657,,940,-292,4717,1104,1429,,123675
109056,3000,Male,CR16  ,Zuidwest-Gelderland (CR),2020JJ00,2020,123675,,1321,,1152,,169,7311,,1809,5502,6348,,1383,-436,4965,963,1130,,124805
109057,3000,Male,CR16  ,Zuidwest-Gelderland (CR),2021JJ00,2021,124805,,1441,,1221,,220,7312,,1806,5506,6289,,1358,-348,4931,1023,1242,,126047
109058,3000,Male,CR16  ,Zuidwest-Gelderland (CR),2022JJ00,2022,126047,,1305,,1084,,221,8054,,2746,5308,6538,,1710,-587,4828,1516,1735,,127782
109059,3000,Male,CR16  ,Zuidwest-Gelderland (CR),2023JJ00,2023,127782,,1326,,1081,,245,7067,,1871,5196,6839,,1813,-820,5026,228,481,,128263
109130,3000,Male,CR17  ,Utrecht (CR),2012JJ00,2012,605032,,7659,,4232,,3427,29878,,4533,25345,28997,,4424,-731,24573,881,4313,,609345
109131,3000,Male,CR17  ,Utrecht (CR),2013JJ00,2013,609345,,7327,,4342,,2985,30304,,4745,25559,28989,,4373,-447,24616,1315,4329,,613674
109132,3000,Male,CR17  ,Utrecht (CR),2014JJ00,2014,613674,,7534,,4263,,3271,34052,,5339,28713,32116,,4532,-438,27584,1936,5214,,618888
109133,3000,Male,CR17  ,Utrecht (CR),2015JJ00,2015,618888,,7337,,4473,,2864,37086,,5901,31185,34368,,4661,-617,29707,2718,5587,,624475
109134,3000,Male,CR17  ,Utrecht (CR),2016JJ00,2016,624475,,7377,,4487,,2890,39707,,6061,33646,36751,,4235,-447,32516,2956,5870,,630345
109135,3000,Male,CR17  ,Utrecht (CR),2017JJ00,2017,630345,,7371,,4635,,2736,39508,,5723,33785,36647,,4511,-660,32136,2861,5606,,635951
109136,3000,Male,CR17  ,Utrecht (CR),2018JJ00,2018,635951,,7388,,4722,,2666,39020,,6384,32636,35566,,4427,-410,31139,3454,6116,,642067
109137,3000,Male,CR17  ,Utrecht (CR),2019JJ00,2019,659562,,7665,,4810,,2855,40867,,7341,33526,36856,,4843,-550,32013,4011,6851,,666413
109138,3000,Male,CR17  ,Utrecht (CR),2020JJ00,2020,666413,,7613,,5411,,2202,40192,,5906,34286,38612,,4366,-263,34246,1580,3765,,670178
109139,3000,Male,CR17  ,Utrecht (CR),2021JJ00,2021,670178,,8109,,5566,,2543,41588,,6350,35238,39927,,4253,-499,35674,1661,4199,,674377
109140,3000,Male,CR17  ,Utrecht (CR),2022JJ00,2022,674377,,7246,,5502,,1744,45405,,9970,35435,38711,,4817,-378,33894,6694,8435,,682812
109141,3000,Male,CR17  ,Utrecht (CR),2023JJ00,2023,682812,,7131,,5627,,1504,44634,,7899,36735,40113,,5361,-830,34752,4521,6013,,688825
109212,3000,Male,CR18  ,Kop van Noord-Holland (CR),2012JJ00,2012,186300,,1904,,1459,,445,6391,,974,5417,7059,,983,-262,6076,-668,-226,,186074
109213,3000,Male,CR18  ,Kop van Noord-Holland (CR),2013JJ00,2013,186074,,1741,,1476,,265,6158,,1065,5093,6534,,850,-79,5684,-376,-117,,185957
109214,3000,Male,CR18  ,Kop van Noord-Holland (CR),2014JJ00,2014,185957,,1879,,1501,,378,6969,,1468,5501,6961,,1056,-115,5905,8,406,,186363
109215,3000,Male,CR18  ,Kop van Noord-Holland (CR),2015JJ00,2015,186363,,1778,,1674,,104,7937,,1600,6337,7921,,1159,-129,6762,16,137,,186500
109216,3000,Male,CR18  ,Kop van Noord-Holland (CR),2016JJ00,2016,186500,,1840,,1547,,293,8650,,1538,7112,8492,,1038,-153,7454,158,446,,186946
109217,3000,Male,CR18  ,Kop van Noord-Holland (CR),2017JJ00,2017,186946,,1799,,1640,,159,8913,,1312,7601,8462,,1018,-102,7444,451,606,,187552
109218,3000,Male,CR18  ,Kop van Noord-Holland (CR),2018JJ00,2018,187552,,1702,,1674,,28,8810,,1513,7297,8248,,1039,-186,7209,562,579,,188131
109219,3000,Male,CR18  ,Kop van Noord-Holland (CR),2019JJ00,2019,188131,,1728,,1763,,-35,9523,,2367,7156,8238,,1315,-288,6923,1285,1245,,189376
109220,3000,Male,CR18  ,Kop van Noord-Holland (CR),2020JJ00,2020,189376,,1767,,1817,,-50,9533,,1973,7560,8743,,1613,-403,7130,790,741,,190117
109221,3000,Male,CR18  ,Kop van Noord-Holland (CR),2021JJ00,2021,190117,,1827,,2026,,-199,9815,,1742,8073,8830,,1620,-316,7210,985,789,,190906
109222,3000,Male,CR18  ,Kop van Noord-Holland (CR),2022JJ00,2022,190906,,1781,,1901,,-120,11055,,3214,7841,8939,,1939,-418,7000,2116,1982,,192888
109223,3000,Male,CR18  ,Kop van Noord-Holland (CR),2023JJ00,2023,192888,,1763,,2002,,-239,9811,,2230,7581,9050,,1879,-393,7171,761,527,,193415
109294,3000,Male,CR19  ,Alkmaar en omgeving (CR),2012JJ00,2012,115131,,1175,,906,,269,5091,,738,4353,5283,,765,-103,4518,-192,81,,115212
109295,3000,Male,CR19  ,Alkmaar en omgeving (CR),2013JJ00,2013,115212,,1123,,941,,182,5218,,754,4464,5101,,583,-19,4518,117,306,,115518
109296,3000,Male,CR19  ,Alkmaar en omgeving (CR),2014JJ00,2014,115518,,1177,,872,,305,5514,,852,4662,5420,,589,27,4831,94,402,,115920
109297,3000,Male,CR19  ,Alkmaar en omgeving (CR),2015JJ00,2015,119136,,1151,,989,,162,6485,,985,5500,6129,,652,-20,5477,356,519,,119655
109298,3000,Male,CR19  ,Alkmaar en omgeving (CR),2016JJ00,2016,119655,,1181,,1061,,120,7729,,1360,6369,6717,,728,-96,5989,1012,1126,,120781
109299,3000,Male,CR19  ,Alkmaar en omgeving (CR),2017JJ00,2017,120781,,1177,,1011,,166,7558,,864,6694,6863,,624,-82,6239,695,863,,121644
109300,3000,Male,CR19  ,Alkmaar en omgeving (CR),2018JJ00,2018,121644,,1184,,1033,,151,6945,,880,6065,6395,,707,-176,5688,550,697,,122341
109301,3000,Male,CR19  ,Alkmaar en omgeving (CR),2019JJ00,2019,122341,,1156,,1013,,143,7247,,929,6318,6327,,635,-92,5692,920,1070,,123411
109302,3000,Male,CR19  ,Alkmaar en omgeving (CR),2020JJ00,2020,123411,,1123,,1188,,-65,7226,,740,6486,6478,,593,-57,5885,748,680,,124091
109303,3000,Male,CR19  ,Alkmaar en omgeving (CR),2021JJ00,2021,124091,,1266,,1238,,28,7308,,740,6568,6215,,627,-96,5588,1093,1117,,125208
109304,3000,Male,CR19  ,Alkmaar en omgeving (CR),2022JJ00,2022,125208,,1086,,1247,,-161,7326,,1408,5918,6118,,791,-144,5327,1208,1040,,126248
109305,3000,Male,CR19  ,Alkmaar en omgeving (CR),2023JJ00,2023,126248,,1109,,1311,,-202,6993,,946,6047,6137,,841,-206,5296,856,642,,126890
109376,3000,Male,CR20  ,IJmond (CR),2012JJ00,2012,95579,,955,,854,,101,3964,,548,3416,3884,,545,-151,3339,80,179,,95758
109377,3000,Male,CR20  ,IJmond (CR),2013JJ00,2013,95758,,937,,914,,23,3798,,521,3277,3813,,497,-95,3316,-15,7,,95765
109378,3000,Male,CR20  ,IJmond (CR),2014JJ00,2014,95765,,862,,851,,11,4289,,523,3766,4165,,581,-136,3584,124,134,,95899
109379,3000,Male,CR20  ,IJmond (CR),2015JJ00,2015,95899,,943,,907,,36,4868,,626,4242,4374,,604,-136,3770,494,530,,96429
109380,3000,Male,CR20  ,IJmond (CR),2016JJ00,2016,96429,,948,,910,,38,5116,,591,4525,4499,,569,-168,3930,617,650,,97079
109381,3000,Male,CR20  ,IJmond (CR),2017JJ00,2017,97079,,937,,907,,30,5197,,603,4594,4691,,586,-136,4105,506,537,,97616
109382,3000,Male,CR20  ,IJmond (CR),2018JJ00,2018,97616,,865,,945,,-80,4933,,768,4165,4352,,637,-124,3715,581,501,,98117
109383,3000,Male,CR20  ,IJmond (CR),2019JJ00,2019,98117,,949,,889,,60,5216,,705,4511,4576,,649,-172,3927,640,708,,98825
109384,3000,Male,CR20  ,IJmond (CR),2020JJ00,2020,98825,,948,,1070,,-122,5150,,650,4500,4895,,524,-105,4371,255,130,,98955
109385,3000,Male,CR20  ,IJmond (CR),2021JJ00,2021,98955,,1000,,1100,,-100,4737,,511,4226,4669,,528,-90,4141,68,-24,,98931
109386,3000,Male,CR20  ,IJmond (CR),2022JJ00,2022,98931,,906,,1019,,-113,5408,,993,4415,4721,,608,-98,4113,687,568,,99499
109387,3000,Male,CR20  ,IJmond (CR),2023JJ00,2023,99499,,953,,1112,,-159,5468,,890,4578,4866,,647,-124,4219,602,451,,99950
109458,3000,Male,CR21  ,Agglomeratie Haarlem (CR),2012JJ00,2012,107469,,1214,,1016,,198,6056,,1045,5011,5480,,994,-246,4486,576,776,,108245
109459,3000,Male,CR21  ,Agglomeratie Haarlem (CR),2013JJ00,2013,108245,,1184,,1058,,126,6256,,1015,5241,5317,,770,-38,4547,939,1069,,109314
109460,3000,Male,CR21  ,Agglomeratie Haarlem (CR),2014JJ00,2014,109314,,1212,,959,,253,7005,,1088,5917,6323,,1193,-366,5130,682,943,,110257
109461,3000,Male,CR21  ,Agglomeratie Haarlem (CR),2015JJ00,2015,110257,,1239,,1070,,169,7511,,1101,6410,6472,,925,-84,5547,1039,1201,,111458
109462,3000,Male,CR21  ,Agglomeratie Haarlem (CR),2016JJ00,2016,111458,,1256,,1109,,147,8140,,1487,6653,7081,,1073,-137,6008,1059,1207,,112665
109463,3000,Male,CR21  ,Agglomeratie Haarlem (CR),2017JJ00,2017,112665,,1195,,1079,,116,7984,,1344,6640,7498,,1091,-207,6407,486,586,,113251
109464,3000,Male,CR21  ,Agglomeratie Haarlem (CR),2018JJ00,2018,113251,,1231,,1070,,161,8015,,1493,6522,6896,,992,-82,5904,1119,1283,,114534
109465,3000,Male,CR21  ,Agglomeratie Haarlem (CR),2019JJ00,2019,111435,,1220,,1050,,170,7992,,1693,6299,7174,,1062,-169,6112,818,982,,112417
109466,3000,Male,CR21  ,Agglomeratie Haarlem (CR),2020JJ00,2020,112417,,1145,,1129,,16,7990,,1347,6643,7841,,1002,-166,6839,149,158,,112575
109467,3000,Male,CR21  ,Agglomeratie Haarlem (CR),2021JJ00,2021,112575,,1208,,1145,,63,7872,,1308,6564,7592,,1030,-165,6562,280,331,,112906
109468,3000,Male,CR21  ,Agglomeratie Haarlem (CR),2022JJ00,2022,112906,,1143,,1188,,-45,8845,,2100,6745,7390,,1161,-172,6229,1455,1405,,114311
109469,3000,Male,CR21  ,Agglomeratie Haarlem (CR),2023JJ00,2023,114311,,1057,,1166,,-109,8760,,1707,7053,7662,,1263,-200,6399,1098,987,,115298
109540,3000,Male,CR22  ,Zaanstreek (CR),2012JJ00,2012,81205,,879,,670,,209,3307,,643,2664,2856,,713,-238,2143,451,658,,81863
109541,3000,Male,CR22  ,Zaanstreek (CR),2013JJ00,2013,81863,,869,,689,,180,3208,,615,2593,2939,,761,-214,2178,269,454,,82317
109542,3000,Male,CR22  ,Zaanstreek (CR),2014JJ00,2014,82317,,930,,649,,281,3204,,660,2544,3181,,703,-208,2478,23,301,,82618
109543,3000,Male,CR22  ,Zaanstreek (CR),2015JJ00,2015,82618,,877,,771,,106,3698,,721,2977,3296,,648,-148,2648,402,516,,83134
109544,3000,Male,CR22  ,Zaanstreek (CR),2016JJ00,2016,83134,,968,,770,,198,4095,,718,3377,3577,,694,-117,2883,518,713,,83847
109545,3000,Male,CR22  ,Zaanstreek (CR),2017JJ00,2017,83847,,901,,746,,155,4218,,807,3411,3687,,594,-92,3093,531,687,,84534
109546,3000,Male,CR22  ,Zaanstreek (CR),2018JJ00,2018,84534,,898,,685,,213,4446,,957,3489,3896,,601,-57,3295,550,758,,85292
109547,3000,Male,CR22  ,Zaanstreek (CR),2019JJ00,2019,85292,,896,,687,,209,4383,,1002,3381,4261,,726,-190,3535,122,334,,85626
109548,3000,Male,CR22  ,Zaanstreek (CR),2020JJ00,2020,85626,,886,,822,,64,4431,,914,3517,4268,,600,-102,3668,163,219,,85845
109549,3000,Male,CR22  ,Zaanstreek (CR),2021JJ00,2021,85845,,904,,839,,65,4414,,918,3496,4387,,675,-151,3712,27,92,,85937
109550,3000,Male,CR22  ,Zaanstreek (CR),2022JJ00,2022,85937,,862,,829,,33,6037,,1596,4441,4486,,730,-116,3756,1551,1583,,87520
109551,3000,Male,CR22  ,Zaanstreek (CR),2023JJ00,2023,87520,,877,,778,,99,5646,,1461,4185,4912,,999,-271,3913,734,832,,88352
109622,3000,Male,CR23  ,Groot-Amsterdam (CR),2012JJ00,2012,629531,,7985,,4439,,3546,38691,,13433,25258,36774,,13419,-3872,23355,1917,5500,,635031
109623,3000,Male,CR23  ,Groot-Amsterdam (CR),2013JJ00,2013,635031,,8172,,4446,,3726,39701,,13663,26038,36502,,12884,-3067,23618,3199,7017,,642048
109624,3000,Male,CR23  ,Groot-Amsterdam (CR),2014JJ00,2014,642048,,7975,,4312,,3663,43946,,15966,27980,40170,,13161,-2729,27009,3776,7473,,649521
109625,3000,Male,CR23  ,Groot-Amsterdam (CR),2015JJ00,2015,646305,,8098,,4498,,3600,47722,,17353,30369,42724,,12838,-1486,29886,4998,8603,,654908
109626,3000,Male,CR23  ,Groot-Amsterdam (CR),2016JJ00,2016,654908,,8040,,4594,,3446,50711,,19235,31476,45654,,13160,-1455,32494,5057,8478,,663386
109627,3000,Male,CR23  ,Groot-Amsterdam (CR),2017JJ00,2017,663386,,7995,,4414,,3581,52751,,22189,30562,49291,,14680,-2794,34611,3460,7047,,670433
109628,3000,Male,CR23  ,Groot-Amsterdam (CR),2018JJ00,2018,670433,,7718,,4698,,3020,54388,,24502,29886,50659,,15138,-2166,35521,3729,6716,,677149
109629,3000,Male,CR23  ,Groot-Amsterdam (CR),2019JJ00,2019,680248,,7781,,4651,,3130,58077,,26959,31118,52921,,15259,-1784,37662,5156,8308,,688556
109630,3000,Male,CR23  ,Groot-Amsterdam (CR),2020JJ00,2020,688556,,7730,,5268,,2462,52632,,19947,32685,52866,,13420,-386,39446,-234,2208,,690764
109631,3000,Male,CR23  ,Groot-Amsterdam (CR),2021JJ00,2021,690764,,8205,,5434,,2771,57687,,23371,34316,53566,,12862,-323,40704,4121,6830,,697594
109632,3000,Male,CR23  ,Groot-Amsterdam (CR),2022JJ00,2022,697594,,7564,,5301,,2263,65823,,32018,33805,56957,,15014,-1441,41943,8866,11077,,718780
109633,3000,Male,CR23  ,Groot-Amsterdam (CR),2023JJ00,2023,718780,,7273,,5298,,1975,65535,,29016,36519,59265,,17159,-1648,42106,6270,8093,,726873
109704,3000,Male,CR24  ,Het Gooi en Vechtstreek (CR),2012JJ00,2012,118596,,1146,,1127,,19,6624,,973,5651,6543,,988,-271,5555,81,95,,118691
109705,3000,Male,CR24  ,Het Gooi en Vechtstreek (CR),2013JJ00,2013,118691,,1064,,1137,,-73,6382,,954,5428,6282,,871,-62,5411,100,38,,118729
109706,3000,Male,CR24  ,Het Gooi en Vechtstreek (CR),2014JJ00,2014,118729,,1215,,1116,,99,7447,,1120,6327,6784,,947,-148,5837,663,762,,119491
109707,3000,Male,CR24  ,Het Gooi en Vechtstreek (CR),2015JJ00,2015,119491,,1166,,1225,,-59,8216,,1255,6961,7275,,1018,-152,6257,941,887,,120378
109708,3000,Male,CR24  ,Het Gooi en Vechtstreek (CR),2016JJ00,2016,120378,,1210,,1202,,8,8643,,1302,7341,7272,,946,-137,6326,1371,1383,,121761
109709,3000,Male,CR24  ,Het Gooi en Vechtstreek (CR),2017JJ00,2017,121761,,1178,,1201,,-23,9054,,1337,7717,7880,,910,-88,6970,1174,1153,,122914
109710,3000,Male,CR24  ,Het Gooi en Vechtstreek (CR),2018JJ00,2018,122914,,1234,,1243,,-9,8590,,1561,7029,7487,,998,-131,6489,1103,1091,,124005
109711,3000,Male,CR24  ,Het Gooi en Vechtstreek (CR),2019JJ00,2019,124005,,1217,,1200,,17,9018,,1568,7450,7956,,984,-125,6972,1062,1087,,125092
109712,3000,Male,CR24  ,Het Gooi en Vechtstreek (CR),2020JJ00,2020,125092,,1217,,1387,,-170,9259,,1311,7948,7968,,869,-121,7099,1291,1120,,126212
109713,3000,Male,CR24  ,Het Gooi en Vechtstreek (CR),2021JJ00,2021,126212,,1351,,1376,,-25,9086,,1304,7782,8263,,926,-108,7337,823,783,,126995
109714,3000,Male,CR24  ,Het Gooi en Vechtstreek (CR),2022JJ00,2022,126995,,1146,,1187,,-41,9187,,2158,7029,7316,,994,-92,6322,1871,1829,,118715
109715,3000,Male,CR24  ,Het Gooi en Vechtstreek (CR),2023JJ00,2023,118715,,1071,,1335,,-264,8510,,1646,6864,7701,,948,-139,6753,809,545,,119260
109786,3000,Male,CR25  ,Agglomeratie Leiden en Bollenstreek (CR),2012JJ00,2012,201447,,2134,,1559,,575,10439,,2093,8346,10036,,2087,-473,7949,403,982,,202429
109787,3000,Male,CR25  ,Agglomeratie Leiden en Bollenstreek (CR),2013JJ00,2013,202429,,2076,,1561,,515,10269,,2153,8116,9930,,1883,-275,8047,339,846,,203275
109788,3000,Male,CR25  ,Agglomeratie Leiden en Bollenstreek (CR),2014JJ00,2014,203275,,2201,,1630,,571,11077,,2146,8931,10761,,2132,-429,8629,316,898,,204173
109789,3000,Male,CR25  ,Agglomeratie Leiden en Bollenstreek (CR),2015JJ00,2015,204173,,1982,,1611,,371,12818,,3028,9790,11720,,2037,-298,9683,1098,1457,,205630
109790,3000,Male,CR25  ,Agglomeratie Leiden en Bollenstreek (CR),2016JJ00,2016,205630,,2047,,1632,,415,13870,,2685,11185,12668,,2327,-507,10341,1202,1618,,207248
109791,3000,Male,CR25  ,Agglomeratie Leiden en Bollenstreek (CR),2017JJ00,2017,207248,,2139,,1689,,450,13797,,2735,11062,12722,,2532,-649,10190,1075,1524,,208772
109792,3000,Male,CR25  ,Agglomeratie Leiden en Bollenstreek (CR),2018JJ00,2018,208772,,2065,,1796,,269,12855,,2729,10126,11882,,2155,-362,9727,973,1248,,210020
109793,3000,Male,CR25  ,Agglomeratie Leiden en Bollenstreek (CR),2019JJ00,2019,210020,,2112,,1735,,377,13074,,2948,10126,11877,,1977,-249,9900,1197,1573,,211593
109794,3000,Male,CR25  ,Agglomeratie Leiden en Bollenstreek (CR),2020JJ00,2020,211593,,2066,,1853,,213,13047,,2251,10796,12467,,1993,-450,10474,580,795,,212388
109795,3000,Male,CR25  ,Agglomeratie Leiden en Bollenstreek (CR),2021JJ00,2021,212388,,2216,,1984,,232,13199,,2433,10766,11971,,1698,-176,10273,1228,1466,,213854
109796,3000,Male,CR25  ,Agglomeratie Leiden en Bollenstreek (CR),2022JJ00,2022,213854,,2029,,1933,,96,14849,,3911,10938,12388,,2100,-259,10288,2461,2560,,216414
109797,3000,Male,CR25  ,Agglomeratie Leiden en Bollenstreek (CR),2023JJ00,2023,216414,,2022,,1945,,77,15419,,3263,12156,13095,,2162,-307,10933,2324,2405,,218819
109868,3000,Male,CR26  ,Agglomeratie 's-Gravenhage (CR),2012JJ00,2012,401840,,5312,,3171,,2141,23571,,7896,15675,23145,,7699,-2087,15446,426,2578,,404418
109869,3000,Male,CR26  ,Agglomeratie 's-Gravenhage (CR),2013JJ00,2013,404418,,5085,,3025,,2060,24508,,8572,15936,24077,,8754,-2902,15323,431,2526,,406944
109870,3000,Male,CR26  ,Agglomeratie 's-Gravenhage (CR),2014JJ00,2014,406944,,5241,,3125,,2116,25733,,8909,16824,24062,,7365,-1683,16697,1671,3695,,410639
109871,3000,Male,CR26  ,Agglomeratie 's-Gravenhage (CR),2015JJ00,2015,410639,,5232,,3246,,1986,26987,,8840,18147,24769,,7064,-1079,17705,2218,4069,,414708
109872,3000,Male,CR26  ,Agglomeratie 's-Gravenhage (CR),2016JJ00,2016,414708,,5274,,3345,,1929,29346,,9537,19809,26481,,7642,-1845,18839,2865,4722,,419430
109873,3000,Male,CR26  ,Agglomeratie 's-Gravenhage (CR),2017JJ00,2017,419430,,5081,,3216,,1865,30210,,10290,19920,26545,,6893,-1108,19652,3665,5470,,424900
109874,3000,Male,CR26  ,Agglomeratie 's-Gravenhage (CR),2018JJ00,2018,424900,,5034,,3326,,1708,29431,,10657,18774,26727,,7390,-1583,19337,2704,4241,,429141
109875,3000,Male,CR26  ,Agglomeratie 's-Gravenhage (CR),2019JJ00,2019,429141,,5030,,3358,,1672,31962,,12252,19710,27394,,6918,-911,20476,4568,6226,,435367
109876,3000,Male,CR26  ,Agglomeratie 's-Gravenhage (CR),2020JJ00,2020,435367,,4858,,3730,,1128,30744,,9938,20806,29187,,7626,-1898,21561,1557,2636,,438003
109877,3000,Male,CR26  ,Agglomeratie 's-Gravenhage (CR),2021JJ00,2021,438003,,4900,,3824,,1076,32250,,10739,21511,28939,,5937,-366,23002,3311,4373,,442376
109878,3000,Male,CR26  ,Agglomeratie 's-Gravenhage (CR),2022JJ00,2022,442376,,4599,,3800,,799,36326,,14728,21598,30127,,7921,-1386,22206,6199,6963,,449339
109879,3000,Male,CR26  ,Agglomeratie 's-Gravenhage (CR),2023JJ00,2023,449339,,4663,,3703,,960,34487,,12729,21758,31383,,8530,-1715,22853,3104,4030,,453369
109950,3000,Male,CR27  ,Delft en Westland (CR),2012JJ00,2012,112336,,1088,,774,,314,7494,,2888,4606,7214,,2526,-843,4688,280,585,,112921
109951,3000,Male,CR27  ,Delft en Westland (CR),2013JJ00,2013,112921,,1063,,777,,286,8195,,3191,5004,7254,,2617,-576,4637,941,1215,,114136
109952,3000,Male,CR27  ,Delft en Westland (CR),2014JJ00,2014,114136,,1107,,758,,349,8853,,3590,5263,7884,,2809,-607,5075,969,1297,,115433
109953,3000,Male,CR27  ,Delft en Westland (CR),2015JJ00,2015,115433,,1077,,849,,228,8991,,3823,5168,8903,,3584,-1183,5319,88,311,,115744
109954,3000,Male,CR27  ,Delft en Westland (CR),2016JJ00,2016,115744,,1124,,824,,300,9303,,3916,5387,9073,,3422,-968,5651,230,523,,116267
109955,3000,Male,CR27  ,Delft en Westland (CR),2017JJ00,2017,116267,,1065,,848,,217,10457,,4293,6164,9077,,3276,-938,5801,1380,1590,,117857
109956,3000,Male,CR27  ,Delft en Westland (CR),2018JJ00,2018,117857,,1131,,837,,294,10002,,4209,5793,9379,,3483,-645,5896,623,907,,118764
109957,3000,Male,CR27  ,Delft en Westland (CR),2019JJ00,2019,118764,,1141,,812,,329,9985,,4207,5778,9517,,3356,-661,6161,468,793,,119557
109958,3000,Male,CR27  ,Delft en Westland (CR),2020JJ00,2020,119557,,1124,,955,,169,9625,,3357,6268,9388,,3102,-527,6286,237,398,,119955
109959,3000,Male,CR27  ,Delft en Westland (CR),2021JJ00,2021,119955,,1221,,907,,314,10071,,3757,6314,9210,,2487,-512,6723,861,1172,,121127
109960,3000,Male,CR27  ,Delft en Westland (CR),2022JJ00,2022,121127,,1125,,943,,182,10657,,4628,6029,9000,,2617,-550,6383,1657,1838,,122965
109961,3000,Male,CR27  ,Delft en Westland (CR),2023JJ00,2023,122965,,1110,,910,,200,11902,,4242,7660,9448,,2919,-650,6529,2454,2641,,125606
110032,3000,Male,CR28  ,Oost-Zuid-Holland (CR),2012JJ00,2012,145975,,1633,,1085,,548,4584,,657,3927,5207,,749,-191,4458,-623,-65,,145910
110033,3000,Male,CR28  ,Oost-Zuid-Holland (CR),2013JJ00,2013,145910,,1604,,1075,,529,4873,,723,4150,5099,,593,-37,4506,-226,319,,146229
110034,3000,Male,CR28  ,Oost-Zuid-Holland (CR),2014JJ00,2014,146229,,1598,,1070,,528,5416,,802,4614,5129,,697,-98,4432,287,829,,147058
110035,3000,Male,CR28  ,Oost-Zuid-Holland (CR),2015JJ00,2015,158115,,1667,,1268,,399,6520,,984,5536,5816,,753,-157,5063,704,1083,,159198
110036,3000,Male,CR28  ,Oost-Zuid-Holland (CR),2016JJ00,2016,159198,,1699,,1270,,429,7967,,1487,6480,6663,,1089,-218,5574,1304,1730,,160928
110037,3000,Male,CR28  ,Oost-Zuid-Holland (CR),2017JJ00,2017,160928,,1724,,1255,,469,8547,,1373,7174,7126,,1171,-322,5955,1421,1881,,162809
110038,3000,Male,CR28  ,Oost-Zuid-Holland (CR),2018JJ00,2018,162809,,1765,,1314,,451,8438,,1472,6966,6960,,1242,-369,5718,1478,1925,,164734
110039,3000,Male,CR28  ,Oost-Zuid-Holland (CR),2019JJ00,2019,164734,,1794,,1349,,445,8069,,1458,6611,7047,,1164,-151,5883,1022,1465,,166199
110040,3000,Male,CR28  ,Oost-Zuid-Holland (CR),2020JJ00,2020,166199,,1870,,1504,,366,8665,,1304,7361,7281,,948,-116,6333,1384,1743,,167942
110041,3000,Male,CR28  ,Oost-Zuid-Holland (CR),2021JJ00,2021,167942,,1950,,1485,,465,8027,,1200,6827,7128,,910,-248,6218,899,1364,,169306
110042,3000,Male,CR28  ,Oost-Zuid-Holland (CR),2022JJ00,2022,169306,,1860,,1554,,306,9356,,2047,7309,7357,,1234,-438,6123,1999,2295,,171601
110043,3000,Male,CR28  ,Oost-Zuid-Holland (CR),2023JJ00,2023,171601,,1897,,1554,,343,8923,,1505,7418,7665,,1313,-433,6352,1258,1603,,173204
110114,3000,Male,CR29  ,Groot-Rijnmond (CR),2012JJ00,2012,695572,,8465,,5903,,2562,33357,,8139,25218,35728,,10440,-4548,25288,-2371,192,,695764
110115,3000,Male,CR29  ,Groot-Rijnmond (CR),2013JJ00,2013,695764,,8109,,5815,,2294,32410,,7694,24716,33330,,8624,-2760,24706,-920,1398,,697162
110116,3000,Male,CR29  ,Groot-Rijnmond (CR),2014JJ00,2014,697162,,8449,,5509,,2940,34400,,8139,26261,33178,,7812,-1831,25366,1222,4212,,701374
110117,3000,Male,CR29  ,Groot-Rijnmond (CR),2015JJ00,2015,690317,,7984,,5733,,2251,36473,,8415,28058,34308,,7868,-1671,26440,2165,4455,,694772
110118,3000,Male,CR29  ,Groot-Rijnmond (CR),2016JJ00,2016,694772,,8238,,5984,,2254,39764,,8703,31061,36823,,7746,-1785,29077,2941,5180,,699952
110119,3000,Male,CR29  ,Groot-Rijnmond (CR),2017JJ00,2017,699952,,7995,,5914,,2081,41080,,9385,31695,38913,,7990,-2217,30923,2167,4216,,704168
110120,3000,Male,CR29  ,Groot-Rijnmond (CR),2018JJ00,2018,704168,,8037,,6274,,1763,40746,,9907,30839,37294,,6689,-938,30605,3452,5263,,709431
110121,3000,Male,CR29  ,Groot-Rijnmond (CR),2019JJ00,2019,709431,,7886,,6227,,1659,43454,,11849,31605,38149,,7292,-1114,30857,5305,6939,,716370
110122,3000,Male,CR29  ,Groot-Rijnmond (CR),2020JJ00,2020,716370,,8034,,7201,,833,42968,,9965,33003,40327,,6942,-1048,33385,2641,3458,,719828
110123,3000,Male,CR29  ,Groot-Rijnmond (CR),2021JJ00,2021,719828,,8292,,6964,,1328,44802,,11091,33711,40970,,6711,-1019,34259,3832,5156,,724984
110124,3000,Male,CR29  ,Groot-Rijnmond (CR),2022JJ00,2022,724984,,7890,,6876,,1014,47965,,15080,32885,40482,,7666,-1170,32816,7483,8551,,733535
110125,3000,Male,CR29  ,Groot-Rijnmond (CR),2023JJ00,2023,733535,,7650,,6749,,901,48633,,13842,34791,41791,,8422,-1586,33369,6842,7748,,741283
110196,3000,Male,CR30  ,Zuidoost-Zuid-Holland (CR),2012JJ00,2012,196223,,2421,,1631,,790,7293,,1062,6231,7671,,1339,-380,6332,-378,416,,196639
110197,3000,Male,CR30  ,Zuidoost-Zuid-Holland (CR),2013JJ00,2013,196639,,2319,,1545,,774,7064,,1138,5926,7297,,1086,-132,6211,-233,542,,197181
110198,3000,Male,CR30  ,Zuidoost-Zuid-Holland (CR),2014JJ00,2014,197181,,2437,,1543,,894,7601,,1116,6485,7946,,1332,-264,6614,-345,554,,197735
110199,3000,Male,CR30  ,Zuidoost-Zuid-Holland (CR),2015JJ00,2015,197735,,2196,,1683,,513,8052,,1138,6914,8149,,1130,-214,7019,-97,416,,198151
110200,3000,Male,CR30  ,Zuidoost-Zuid-Holland (CR),2016JJ00,2016,198151,,2166,,1687,,479,9024,,1107,7917,8708,,960,-145,7748,316,792,,198943
110201,3000,Male,CR30  ,Zuidoost-Zuid-Holland (CR),2017JJ00,2017,198943,,2224,,1749,,475,9825,,1146,8679,9422,,1059,-225,8363,403,872,,199815
110202,3000,Male,CR30  ,Zuidoost-Zuid-Holland (CR),2018JJ00,2018,199815,,2202,,1800,,402,9301,,1367,7934,8997,,1043,-257,7954,304,725,,200540
110203,3000,Male,CR30  ,Zuidoost-Zuid-Holland (CR),2019JJ00,2019,183045,,2036,,1633,,403,8467,,1309,7158,7861,,954,-171,6907,606,1008,,184053
110204,3000,Male,CR30  ,Zuidoost-Zuid-Holland (CR),2020JJ00,2020,184053,,1963,,1917,,46,8733,,1233,7500,8283,,785,-132,7498,450,500,,184553
110205,3000,Male,CR30  ,Zuidoost-Zuid-Holland (CR),2021JJ00,2021,184553,,2174,,1903,,271,9436,,1179,8257,8602,,866,-126,7736,834,1103,,185656
110206,3000,Male,CR30  ,Zuidoost-Zuid-Holland (CR),2022JJ00,2022,185656,,2011,,1761,,250,10480,,2611,7869,8367,,1130,-190,7237,2113,2358,,188014
110207,3000,Male,CR30  ,Zuidoost-Zuid-Holland (CR),2023JJ00,2023,188014,,1987,,1762,,225,9819,,1610,8209,9221,,1377,-429,7844,598,821,,188835
110278,3000,Male,CR31  ,Zeeuwsch-Vlaanderen (CR),2012JJ00,2012,52759,,441,,559,,-118,1803,,761,1042,1778,,533,-111,1245,25,-94,,52665
110279,3000,Male,CR31  ,Zeeuwsch-Vlaanderen (CR),2013JJ00,2013,52665,,418,,583,,-165,1836,,729,1107,1753,,529,-105,1224,83,-83,,52582
110280,3000,Male,CR31  ,Zeeuwsch-Vlaanderen (CR),2014JJ00,2014,52582,,461,,567,,-106,1754,,699,1055,1819,,625,-119,1194,-65,-167,,52415
110281,3000,Male,CR31  ,Zeeuwsch-Vlaanderen (CR),2015JJ00,2015,52415,,450,,631,,-181,1856,,721,1135,1615,,553,-115,1062,241,63,,52478
110282,3000,Male,CR31  ,Zeeuwsch-Vlaanderen (CR),2016JJ00,2016,52478,,408,,590,,-182,2156,,908,1248,1994,,514,-63,1480,162,-20,,52458
110283,3000,Male,CR31  ,Zeeuwsch-Vlaanderen (CR),2017JJ00,2017,52458,,407,,618,,-211,1968,,775,1193,1861,,544,-100,1317,107,-100,,52358
110284,3000,Male,CR31  ,Zeeuwsch-Vlaanderen (CR),2018JJ00,2018,52358,,426,,591,,-165,2116,,913,1203,1811,,548,-51,1263,305,147,,52505
110285,3000,Male,CR31  ,Zeeuwsch-Vlaanderen (CR),2019JJ00,2019,52505,,391,,598,,-207,2016,,823,1193,1935,,607,-98,1328,81,-120,,52385
110286,3000,Male,CR31  ,Zeeuwsch-Vlaanderen (CR),2020JJ00,2020,52385,,416,,663,,-247,2065,,786,1279,1798,,523,-58,1275,267,16,,52401
110287,3000,Male,CR31  ,Zeeuwsch-Vlaanderen (CR),2021JJ00,2021,52401,,405,,700,,-295,2129,,830,1299,1812,,592,-87,1220,317,21,,52422
110288,3000,Male,CR31  ,Zeeuwsch-Vlaanderen (CR),2022JJ00,2022,52422,,412,,685,,-273,2630,,1255,1375,2011,,761,-131,1250,619,341,,52763
110289,3000,Male,CR31  ,Zeeuwsch-Vlaanderen (CR),2023JJ00,2023,52763,,432,,679,,-247,2278,,981,1297,2126,,682,-129,1444,152,-94,,52669
110360,3000,Male,CR32  ,Overig Zeeland (CR),2012JJ00,2012,136422,,1394,,1277,,117,5655,,1154,4501,5969,,1122,-529,4847,-314,-205,,136217
110361,3000,Male,CR32  ,Overig Zeeland (CR),2013JJ00,2013,136217,,1375,,1328,,47,5684,,1111,4573,5862,,804,-233,5058,-178,-125,,136092
110362,3000,Male,CR32  ,Overig Zeeland (CR),2014JJ00,2014,136092,,1396,,1196,,200,5797,,1017,4780,5779,,884,-202,4895,18,211,,136303
110363,3000,Male,CR32  ,Overig Zeeland (CR),2015JJ00,2015,136303,,1397,,1324,,73,6160,,1116,5044,5890,,833,-214,5057,270,334,,136637
110364,3000,Male,CR32  ,Overig Zeeland (CR),2016JJ00,2016,136637,,1342,,1302,,40,6712,,1192,5520,6513,,879,-237,5634,199,242,,136879
110365,3000,Male,CR32  ,Overig Zeeland (CR),2017JJ00,2017,136879,,1325,,1279,,46,7160,,1165,5995,6746,,889,-177,5857,414,446,,137325
110366,3000,Male,CR32  ,Overig Zeeland (CR),2018JJ00,2018,137325,,1311,,1398,,-87,7072,,1316,5756,6718,,1006,-286,5712,354,272,,137597
110367,3000,Male,CR32  ,Overig Zeeland (CR),2019JJ00,2019,137597,,1391,,1342,,49,7124,,1379,5745,6722,,1052,-256,5670,402,453,,138050
110368,3000,Male,CR32  ,Overig Zeeland (CR),2020JJ00,2020,138050,,1320,,1425,,-105,7572,,1350,6222,6505,,834,-199,5671,1067,973,,139023
110369,3000,Male,CR32  ,Overig Zeeland (CR),2021JJ00,2021,139023,,1396,,1724,,-328,7330,,1296,6034,6293,,956,-248,5337,1037,717,,139740
110370,3000,Male,CR32  ,Overig Zeeland (CR),2022JJ00,2022,139740,,1381,,1559,,-178,8653,,2290,6363,6870,,1148,-205,5722,1783,1604,,141344
110371,3000,Male,CR32  ,Overig Zeeland (CR),2023JJ00,2023,141344,,1301,,1520,,-219,8074,,1772,6302,7255,,1284,-324,5971,819,605,,141949
110442,3000,Male,CR33  ,West-Noord-Brabant (CR),2012JJ00,2012,305704,,3044,,2682,,362,12079,,2636,9443,11455,,2359,-505,9096,624,1023,,306727
110443,3000,Male,CR33  ,West-Noord-Brabant (CR),2013JJ00,2013,306727,,3061,,2690,,371,12763,,2815,9948,12061,,2356,-164,9705,702,1081,,307808
110444,3000,Male,CR33  ,West-Noord-Brabant (CR),2014JJ00,2014,307808,,3030,,2715,,315,13798,,3147,10651,13031,,2759,-466,10272,767,1064,,308872
110445,3000,Male,CR33  ,West-Noord-Brabant (CR),2015JJ00,2015,308872,,2983,,2836,,147,14762,,3482,11280,14001,,2884,-549,11117,761,913,,309785
110446,3000,Male,CR33  ,West-Noord-Brabant (CR),2016JJ00,2016,309785,,2995,,2866,,129,16365,,3792,12573,14765,,2907,-575,11858,1600,1719,,311504
110447,3000,Male,CR33  ,West-Noord-Brabant (CR),2017JJ00,2017,311504,,3022,,2935,,87,17366,,4406,12960,15412,,3184,-713,12228,1954,2041,,313545
110448,3000,Male,CR33  ,West-Noord-Brabant (CR),2018JJ00,2018,313545,,2958,,2940,,18,17052,,4669,12383,15589,,3613,-905,11976,1463,1475,,315020
110449,3000,Male,CR33  ,West-Noord-Brabant (CR),2019JJ00,2019,315020,,2907,,3014,,-107,16611,,4366,12245,15625,,3868,-1099,11757,986,874,,315894
110450,3000,Male,CR33  ,West-Noord-Brabant (CR),2020JJ00,2020,315894,,2868,,3336,,-468,16158,,3672,12486,14964,,2890,-568,12074,1194,708,,316602
110451,3000,Male,CR33  ,West-Noord-Brabant (CR),2021JJ00,2021,316602,,3191,,3387,,-196,16153,,3653,12500,14379,,2992,-628,11387,1774,1568,,318170
110452,3000,Male,CR33  ,West-Noord-Brabant (CR),2022JJ00,2022,318170,,2889,,3268,,-379,17866,,5181,12685,14241,,3253,-554,10988,3625,3235,,321405
110453,3000,Male,CR33  ,West-Noord-Brabant (CR),2023JJ00,2023,321405,,2911,,3354,,-443,17875,,4558,13317,15050,,3532,-661,11518,2825,2373,,323778
110524,3000,Male,CR34  ,Midden-Noord-Brabant (CR),2012JJ00,2012,229631,,2391,,1802,,589,9848,,1999,7849,9449,,1578,-247,7871,399,992,,230623
110525,3000,Male,CR34  ,Midden-Noord-Brabant (CR),2013JJ00,2013,230623,,2354,,1839,,515,10362,,2240,8122,9762,,1557,-96,8205,600,1126,,231749
110526,3000,Male,CR34  ,Midden-Noord-Brabant (CR),2014JJ00,2014,231749,,2348,,1902,,446,10895,,2388,8507,10611,,2045,-629,8566,284,728,,232477
110527,3000,Male,CR34  ,Midden-Noord-Brabant (CR),2015JJ00,2015,232477,,2275,,1942,,333,12102,,2982,9120,11039,,1961,-485,9078,1063,1407,,233884
110528,3000,Male,CR34  ,Midden-Noord-Brabant (CR),2016JJ00,2016,233884,,2358,,2014,,344,14856,,4839,10017,13852,,2141,-636,11711,1004,1346,,235230
110529,3000,Male,CR34  ,Midden-Noord-Brabant (CR),2017JJ00,2017,235230,,2288,,2109,,179,14134,,3457,10677,12318,,1748,-201,10570,1816,1979,,237209
110530,3000,Male,CR34  ,Midden-Noord-Brabant (CR),2018JJ00,2018,237209,,2304,,2136,,168,14198,,3923,10275,12500,,2268,-622,10232,1698,1879,,239088
110531,3000,Male,CR34  ,Midden-Noord-Brabant (CR),2019JJ00,2019,239088,,2253,,2015,,238,13908,,4225,9683,12260,,2350,-517,9910,1648,1902,,240990
110532,3000,Male,CR34  ,Midden-Noord-Brabant (CR),2020JJ00,2020,240990,,2262,,2587,,-325,15384,,4634,10750,13709,,2464,-683,11245,1675,1368,,242358
110533,3000,Male,CR34  ,Midden-Noord-Brabant (CR),2021JJ00,2021,246165,,2629,,2445,,184,16436,,5666,10770,14391,,2451,-484,11940,2045,2229,,248394
110534,3000,Male,CR34  ,Midden-Noord-Brabant (CR),2022JJ00,2022,248394,,2367,,2459,,-92,19274,,8599,10675,15983,,2867,-536,13116,3291,3206,,251600
110535,3000,Male,CR34  ,Midden-Noord-Brabant (CR),2023JJ00,2023,251600,,2354,,2430,,-76,20297,,9401,10896,18253,,3221,-705,15032,2044,1992,,253592
110606,3000,Male,CR35  ,Noordoost-Noord-Brabant (CR),2012JJ00,2012,320247,,3197,,2496,,701,12439,,1836,10603,12445,,1654,-350,10791,-6,698,,320945
110607,3000,Male,CR35  ,Noordoost-Noord-Brabant (CR),2013JJ00,2013,320945,,3065,,2448,,617,12613,,2052,10561,12545,,1630,-239,10915,68,686,,321631
110608,3000,Male,CR35  ,Noordoost-Noord-Brabant (CR),2014JJ00,2014,321631,,3282,,2508,,774,13972,,2553,11419,13593,,1783,-287,11810,379,1168,,322799
110609,3000,Male,CR35  ,Noordoost-Noord-Brabant (CR),2015JJ00,2015,322799,,3087,,2647,,440,15238,,2821,12417,14658,,1797,-403,12861,580,1018,,323817
110610,3000,Male,CR35  ,Noordoost-Noord-Brabant (CR),2016JJ00,2016,323817,,3192,,2857,,335,17172,,3063,14109,15608,,1814,-425,13794,1564,1907,,325724
110611,3000,Male,CR35  ,Noordoost-Noord-Brabant (CR),2017JJ00,2017,325724,,3184,,2817,,367,16573,,2431,14142,15171,,1744,-405,13427,1402,1769,,327493
110612,3000,Male,CR35  ,Noordoost-Noord-Brabant (CR),2018JJ00,2018,327493,,3117,,2916,,201,16630,,2942,13688,14821,,1833,-427,12988,1809,2014,,329507
110613,3000,Male,CR35  ,Noordoost-Noord-Brabant (CR),2019JJ00,2019,329507,,3155,,2957,,198,17232,,3320,13912,14821,,2030,-460,12791,2411,2616,,332123
110614,3000,Male,CR35  ,Noordoost-Noord-Brabant (CR),2020JJ00,2020,332123,,3152,,3577,,-425,17753,,2950,14803,15340,,1764,-384,13576,2413,1982,,334105
110615,3000,Male,CR35  ,Noordoost-Noord-Brabant (CR),2021JJ00,2021,330298,,3369,,3283,,86,17748,,3021,14727,15129,,1958,-472,13171,2619,2711,,333009
110616,3000,Male,CR35  ,Noordoost-Noord-Brabant (CR),2022JJ00,2022,333009,,3253,,3287,,-34,18151,,4687,13464,14159,,2297,-487,11862,3992,3955,,336964
110617,3000,Male,CR35  ,Noordoost-Noord-Brabant (CR),2023JJ00,2023,336964,,3137,,3362,,-225,17797,,3898,13899,15065,,2565,-725,12500,2732,2521,,339485
110688,3000,Male,CR36  ,Zuidoost-Noord-Brabant (CR),2012JJ00,2012,374386,,3782,,3030,,752,16647,,4063,12584,16032,,3531,-889,12501,615,1357,,375743
110689,3000,Male,CR36  ,Zuidoost-Noord-Brabant (CR),2013JJ00,2013,375743,,3619,,3074,,545,17752,,4229,13523,16570,,3611,-608,12959,1182,1737,,377480
110690,3000,Male,CR36  ,Zuidoost-Noord-Brabant (CR),2014JJ00,2014,377480,,3674,,3135,,539,19330,,4907,14423,17630,,4023,-777,13607,1700,2228,,379708
110691,3000,Male,CR36  ,Zuidoost-Noord-Brabant (CR),2015JJ00,2015,379708,,3718,,3264,,454,20793,,5733,15060,18793,,4099,-729,14694,2000,2447,,382155
110692,3000,Male,CR36  ,Zuidoost-Noord-Brabant (CR),2016JJ00,2016,382155,,3733,,3338,,395,25225,,7777,17448,22725,,4188,-740,18537,2500,2905,,385060
110693,3000,Male,CR36  ,Zuidoost-Noord-Brabant (CR),2017JJ00,2017,385060,,3616,,3363,,253,25222,,7621,17601,22683,,4160,-727,18523,2539,2786,,387846
110694,3000,Male,CR36  ,Zuidoost-Noord-Brabant (CR),2018JJ00,2018,387846,,3598,,3349,,249,24209,,7328,16881,20835,,4392,-771,16443,3374,3619,,391465
110695,3000,Male,CR36  ,Zuidoost-Noord-Brabant (CR),2019JJ00,2019,391465,,3698,,3415,,283,25414,,8639,16775,21479,,4244,-680,17235,3935,4214,,395679
110696,3000,Male,CR36  ,Zuidoost-Noord-Brabant (CR),2020JJ00,2020,395679,,3665,,3998,,-333,26075,,8355,17720,23639,,4191,-686,19448,2436,2114,,397793
110697,3000,Male,CR36  ,Zuidoost-Noord-Brabant (CR),2021JJ00,2021,397793,,3905,,3805,,100,28152,,10059,18093,24596,,4191,-572,20405,3556,3652,,401445
110698,3000,Male,CR36  ,Zuidoost-Noord-Brabant (CR),2022JJ00,2022,401445,,3704,,3721,,-17,32066,,14474,17592,25526,,4764,-663,20762,6540,6512,,407957
110699,3000,Male,CR36  ,Zuidoost-Noord-Brabant (CR),2023JJ00,2023,407957,,3705,,3874,,-169,32687,,14519,18168,29045,,5345,-1037,23700,3642,3463,,411420
110770,3000,Male,CR37  ,Noord-Limburg (CR),2012JJ00,2012,140684,,1293,,1199,,94,4481,,1153,3328,4530,,873,-160,3657,-49,45,,140729
110771,3000,Male,CR37  ,Noord-Limburg (CR),2013JJ00,2013,140729,,1270,,1161,,109,4355,,1199,3156,4428,,839,-135,3589,-73,36,,140765
110772,3000,Male,CR37  ,Noord-Limburg (CR),2014JJ00,2014,140765,,1260,,1121,,139,4958,,1526,3432,4944,,891,-121,4053,14,155,,140920
110773,3000,Male,CR37  ,Noord-Limburg (CR),2015JJ00,2015,140920,,1193,,1289,,-96,5076,,1359,3717,5338,,1173,-307,4165,-262,-368,,140552
110774,3000,Male,CR37  ,Noord-Limburg (CR),2016JJ00,2016,140552,,1310,,1220,,90,5985,,1703,4282,5114,,969,-193,4145,871,967,,141519
110775,3000,Male,CR37  ,Noord-Limburg (CR),2017JJ00,2017,141519,,1262,,1270,,-8,5903,,1478,4425,5877,,1088,-260,4789,26,18,,141537
110776,3000,Male,CR37  ,Noord-Limburg (CR),2018JJ00,2018,141537,,1244,,1261,,-17,5651,,1531,4120,5209,,1083,-271,4126,442,431,,141968
110777,3000,Male,CR37  ,Noord-Limburg (CR),2019JJ00,2019,141968,,1158,,1350,,-192,5879,,1833,4046,5365,,1144,-246,4221,514,316,,142284
110778,3000,Male,CR37  ,Noord-Limburg (CR),2020JJ00,2020,142284,,1179,,1565,,-386,6291,,1962,4329,5450,,1335,-215,4115,841,456,,142740
110779,3000,Male,CR37  ,Noord-Limburg (CR),2021JJ00,2021,142740,,1301,,1490,,-189,6564,,2054,4510,5360,,1323,-335,4037,1204,1007,,143747
110780,3000,Male,CR37  ,Noord-Limburg (CR),2022JJ00,2022,143747,,1190,,1446,,-256,7613,,3234,4379,5527,,1658,-390,3869,2086,1831,,145578
110781,3000,Male,CR37  ,Noord-Limburg (CR),2023JJ00,2023,145578,,1168,,1460,,-292,7338,,2941,4397,6244,,1867,-456,4377,1094,793,,146371
110852,3000,Male,CR38  ,Midden-Limburg (CR),2012JJ00,2012,117669,,984,,1068,,-84,4809,,1002,3807,4603,,737,-130,3866,206,116,,117785
110853,3000,Male,CR38  ,Midden-Limburg (CR),2013JJ00,2013,117785,,968,,1149,,-181,4687,,1006,3681,4674,,798,-174,3876,13,-161,,117624
110854,3000,Male,CR38  ,Midden-Limburg (CR),2014JJ00,2014,117624,,920,,1111,,-191,5200,,1304,3896,4962,,764,-113,4198,238,41,,117665
110855,3000,Male,CR38  ,Midden-Limburg (CR),2015JJ00,2015,117665,,1001,,1218,,-217,5474,,1236,4238,5183,,884,-155,4299,291,76,,117741
110856,3000,Male,CR38  ,Midden-Limburg (CR),2016JJ00,2016,117741,,1035,,1197,,-162,6531,,1331,5200,5895,,791,-161,5104,636,462,,118203
110857,3000,Male,CR38  ,Midden-Limburg (CR),2017JJ00,2017,118203,,969,,1136,,-167,6489,,1148,5341,5966,,797,-148,5169,523,352,,118555
110858,3000,Male,CR38  ,Midden-Limburg (CR),2018JJ00,2018,118555,,926,,1194,,-268,6163,,1196,4967,5995,,853,-208,5142,168,-98,,118457
110859,3000,Male,CR38  ,Midden-Limburg (CR),2019JJ00,2019,118457,,935,,1229,,-294,6625,,1592,5033,5891,,985,-281,4906,734,436,,118893
110860,3000,Male,CR38  ,Midden-Limburg (CR),2020JJ00,2020,118893,,976,,1409,,-433,6868,,1233,5635,5960,,898,-221,5062,908,471,,119364
110861,3000,Male,CR38  ,Midden-Limburg (CR),2021JJ00,2021,119364,,1102,,1520,,-418,6598,,1215,5383,5763,,999,-319,4764,835,412,,119776
110862,3000,Male,CR38  ,Midden-Limburg (CR),2022JJ00,2022,119776,,1021,,1398,,-377,7462,,2065,5397,5879,,1284,-382,4595,1583,1208,,120984
110863,3000,Male,CR38  ,Midden-Limburg (CR),2023JJ00,2023,120984,,1023,,1389,,-366,7080,,1780,5300,6091,,1493,-551,4598,989,609,,121593
110934,3000,Male,CR39  ,Zuid-Limburg (CR),2012JJ00,2012,298535,,2378,,3098,,-720,15335,,3794,11541,15196,,3155,-506,12041,139,-588,,297947
110935,3000,Male,CR39  ,Zuid-Limburg (CR),2013JJ00,2013,297947,,2297,,3072,,-775,15042,,3868,11174,15122,,3451,-444,11671,-80,-848,,297099
110936,3000,Male,CR39  ,Zuid-Limburg (CR),2014JJ00,2014,297099,,2316,,3098,,-782,15743,,4026,11717,15990,,3711,-526,12279,-247,-1034,,296065
110937,3000,Male,CR39  ,Zuid-Limburg (CR),2015JJ00,2015,296065,,2279,,3396,,-1117,17403,,4987,12416,16773,,3637,-332,13136,630,-481,,295584
110938,3000,Male,CR39  ,Zuid-Limburg (CR),2016JJ00,2016,295584,,2288,,3305,,-1017,18411,,4837,13574,17651,,3608,-326,14043,760,-257,,295327
110939,3000,Male,CR39  ,Zuid-Limburg (CR),2017JJ00,2017,295327,,2368,,3350,,-982,18122,,4597,13525,17602,,3976,-450,13626,520,-475,,294852
110940,3000,Male,CR39  ,Zuid-Limburg (CR),2018JJ00,2018,294852,,2249,,3362,,-1113,18212,,4865,13347,17768,,4362,-443,13406,444,-675,,294177
110941,3000,Male,CR39  ,Zuid-Limburg (CR),2019JJ00,2019,294177,,2306,,3410,,-1104,18510,,5078,13432,17420,,4100,-175,13320,1090,-27,,294150
110942,3000,Male,CR39  ,Zuid-Limburg (CR),2020JJ00,2020,294150,,2237,,3910,,-1673,18727,,4453,14274,18148,,4348,-290,13800,579,-1105,,293045
110943,3000,Male,CR39  ,Zuid-Limburg (CR),2021JJ00,2021,293045,,2426,,4013,,-1587,19485,,4903,14582,18022,,4175,-348,13847,1463,-147,,292898
110944,3000,Male,CR39  ,Zuid-Limburg (CR),2022JJ00,2022,292898,,2331,,3648,,-1317,20306,,6393,13913,17422,,4233,-346,13189,2884,1555,,294453
110945,3000,Male,CR39  ,Zuid-Limburg (CR),2023JJ00,2023,294453,,2246,,3655,,-1409,20337,,5974,14363,17662,,4394,-481,13268,2675,1266,,295719
111016,3000,Male,CR40  ,Flevoland (CR),2012JJ00,2012,197783,,2526,,1101,,1425,8150,,1908,6242,8049,,1311,-106,6738,101,1531,,199314
111017,3000,Male,CR40  ,Flevoland (CR),2013JJ00,2013,199314,,2418,,1154,,1264,8412,,2539,5873,9045,,1930,-507,7115,-633,636,,199950
111018,3000,Male,CR40  ,Flevoland (CR),2014JJ00,2014,199950,,2448,,1086,,1362,9768,,3496,6272,10335,,2171,-331,8164,-567,999,,200949
111019,3000,Male,CR40  ,Flevoland (CR),2015JJ00,2015,200949,,2474,,1118,,1356,11544,,4225,7319,11702,,2550,-434,9152,-158,1208,,202157
111020,3000,Male,CR40  ,Flevoland (CR),2016JJ00,2016,202157,,2454,,1213,,1241,12762,,3870,8892,12026,,2235,-397,9791,736,1981,,204138
111021,3000,Male,CR40  ,Flevoland (CR),2017JJ00,2017,204138,,2308,,1138,,1170,11738,,2716,9022,11132,,2163,-286,8969,606,1774,,205912
111022,3000,Male,CR40  ,Flevoland (CR),2018JJ00,2018,205912,,2472,,1220,,1252,11760,,2929,8831,10680,,2059,-199,8621,1080,2326,,208238
111023,3000,Male,CR40  ,Flevoland (CR),2019JJ00,2019,208238,,2540,,1268,,1272,13241,,3763,9478,11100,,2366,-234,8734,2141,3405,,211643
111024,3000,Male,CR40  ,Flevoland (CR),2020JJ00,2020,211643,,2484,,1447,,1037,12751,,2693,10058,11134,,1958,-242,9176,1617,2658,,214301
111025,3000,Male,CR40  ,Flevoland (CR),2021JJ00,2021,214301,,2643,,1540,,1103,14114,,3009,11105,11936,,2492,-496,9444,2178,3284,,217585
111026,3000,Male,CR40  ,Flevoland (CR),2022JJ00,2022,217585,,2527,,1474,,1053,16503,,5469,11034,12723,,3176,-525,9547,3780,4818,,222403
111027,3000,Male,CR40  ,Flevoland (CR),2023JJ00,2023,222403,,2529,,1489,,1040,15406,,3937,11469,13299,,3600,-812,9699,2107,3132,,225535
111098,3000,Male,GM1680,Aa en Hunze,2012JJ00,2012,12834,,96,,140,,-44,541,,45,496,646,,155,-124,491,-105,-148,,12686
111099,3000,Male,GM1680,Aa en Hunze,2013JJ00,2013,12686,,88,,126,,-38,540,,43,497,588,,45,-15,543,-48,-85,,12601
111100,3000,Male,GM1680,Aa en Hunze,2014JJ00,2014,12601,,86,,128,,-42,546,,26,520,560,,40,-6,520,-14,-56,,12545
111101,3000,Male,GM1680,Aa en Hunze,2015JJ00,2015,12545,,90,,130,,-40,694,,37,657,620,,38,2,582,74,32,,12577
111102,3000,Male,GM1680,Aa en Hunze,2016JJ00,2016,12577,,69,,126,,-57,712,,46,666,631,,41,1,590,81,26,,12603
111103,3000,Male,GM1680,Aa en Hunze,2017JJ00,2017,12603,,90,,131,,-41,826,,46,780,718,,43,-12,675,108,63,,12666
111104,3000,Male,GM1680,Aa en Hunze,2018JJ00,2018,12666,,84,,137,,-53,758,,43,715,713,,50,-10,663,45,-7,,12659
111105,3000,Male,GM1680,Aa en Hunze,2019JJ00,2019,12659,,89,,144,,-55,754,,52,702,651,,17,5,634,103,49,,12708
111106,3000,Male,GM1680,Aa en Hunze,2020JJ00,2020,12708,,94,,136,,-42,764,,25,739,722,,34,-9,688,42,1,,12709
111107,3000,Male,GM1680,Aa en Hunze,2021JJ00,2021,12709,,101,,145,,-44,731,,38,693,622,,30,-1,592,109,65,,12774
111108,3000,Male,GM1680,Aa en Hunze,2022JJ00,2022,12774,,95,,155,,-60,686,,125,561,580,,62,-14,518,106,46,,12820
111109,3000,Male,GM1680,Aa en Hunze,2023JJ00,2023,12820,,97,,154,,-57,730,,94,636,631,,53,-10,578,99,47,,12867
111262,3000,Male,GM0738,Aalburg,2012JJ00,2012,6441,,73,,47,,26,177,,21,156,184,,20,-1,164,-7,18,,6459
111263,3000,Male,GM0738,Aalburg,2013JJ00,2013,6459,,77,,50,,27,174,,31,143,170,,16,-6,154,4,31,,6490
111264,3000,Male,GM0738,Aalburg,2014JJ00,2014,6490,,77,,48,,29,210,,33,177,189,,22,-9,167,21,50,,6540
111265,3000,Male,GM0738,Aalburg,2015JJ00,2015,6540,,74,,59,,15,247,,37,210,224,,21,-3,203,23,42,,6582
111266,3000,Male,GM0738,Aalburg,2016JJ00,2016,6582,,81,,50,,31,226,,32,194,221,,22,-8,199,5,33,,6615
111267,3000,Male,GM0738,Aalburg,2017JJ00,2017,6615,,84,,50,,34,292,,37,255,257,,15,-1,242,35,69,,6684
111268,3000,Male,GM0738,Aalburg,2018JJ00,2018,6684,,73,,43,,30,297,,58,239,241,,21,0,220,56,97,,6781
111344,3000,Male,GM0358,Aalsmeer,2012JJ00,2012,15049,,170,,96,,74,577,,129,448,524,,102,-9,422,53,129,,15178
111345,3000,Male,GM0358,Aalsmeer,2013JJ00,2013,15178,,158,,112,,46,604,,139,465,605,,131,-44,474,-1,44,,15222
111346,3000,Male,GM0358,Aalsmeer,2014JJ00,2014,15222,,147,,114,,33,733,,166,567,610,,104,-27,506,123,152,,15374
111347,3000,Male,GM0358,Aalsmeer,2015JJ00,2015,15374,,156,,123,,33,811,,192,619,741,,124,-36,617,70,103,,15477
111348,3000,Male,GM0358,Aalsmeer,2016JJ00,2016,15477,,140,,127,,13,876,,157,719,850,,127,-36,723,26,39,,15516
111349,3000,Male,GM0358,Aalsmeer,2017JJ00,2017,15516,,131,,136,,-5,912,,164,748,828,,140,-28,688,84,80,,15596
111350,3000,Male,GM0358,Aalsmeer,2018JJ00,2018,15596,,130,,136,,-6,830,,178,652,725,,152,-38,573,105,98,,15694
111351,3000,Male,GM0358,Aalsmeer,2019JJ00,2019,15694,,124,,133,,-9,821,,187,634,691,,119,-25,572,130,121,,15815
111352,3000,Male,GM0358,Aalsmeer,2020JJ00,2020,15815,,163,,125,,38,917,,153,764,857,,114,-14,743,60,98,,15913
111353,3000,Male,GM0358,Aalsmeer,2021JJ00,2021,15913,,156,,113,,43,1011,,347,664,860,,142,-38,718,151,194,,16107
111354,3000,Male,GM0358,Aalsmeer,2022JJ00,2022,16107,,126,,129,,-3,1154,,399,755,888,,246,-64,642,266,264,,16371
111355,3000,Male,GM0358,Aalsmeer,2023JJ00,2023,16371,,127,,154,,-27,1247,,496,751,1137,,451,-33,686,110,85,,16456
111426,3000,Male,GM0197,Aalten,2012JJ00,2012,13686,,132,,132,,0,322,,30,292,484,,47,-23,437,-162,-159,,13527
111427,3000,Male,GM0197,Aalten,2013JJ00,2013,13527,,112,,119,,-7,320,,34,286,338,,37,-1,301,-18,-23,,13504
111428,3000,Male,GM0197,Aalten,2014JJ00,2014,13504,,121,,128,,-7,343,,43,300,370,,43,2,327,-27,-33,,13471
111429,3000,Male,GM0197,Aalten,2015JJ00,2015,13471,,133,,122,,11,380,,47,333,379,,49,1,330,1,11,,13482
111430,3000,Male,GM0197,Aalten,2016JJ00,2016,13482,,130,,120,,10,707,,187,520,573,,39,-2,534,134,143,,13625
111431,3000,Male,GM0197,Aalten,2017JJ00,2017,13625,,105,,117,,-12,568,,78,490,623,,64,-24,559,-55,-66,,13559
111432,3000,Male,GM0197,Aalten,2018JJ00,2018,13559,,109,,143,,-34,451,,61,390,415,,65,-7,350,36,0,,13559
111433,3000,Male,GM0197,Aalten,2019JJ00,2019,13559,,125,,121,,4,495,,76,419,410,,62,-21,348,85,90,,13649
111434,3000,Male,GM0197,Aalten,2020JJ00,2020,13649,,127,,143,,-16,416,,72,344,395,,51,-12,344,21,6,,13655
111435,3000,Male,GM0197,Aalten,2021JJ00,2021,13655,,121,,151,,-30,456,,60,396,450,,79,-29,371,6,-25,,13630
111436,3000,Male,GM0197,Aalten,2022JJ00,2022,13630,,134,,141,,-7,465,,114,351,360,,76,-30,284,105,100,,13730
111437,3000,Male,GM0197,Aalten,2023JJ00,2023,13730,,114,,134,,-20,470,,96,374,400,,72,-33,328,70,50,,13780
112000,3000,Male,GM0059,Achtkarspelen,2012JJ00,2012,14263,,149,,122,,27,364,,29,335,372,,17,-9,355,-8,18,,14281
112001,3000,Male,GM0059,Achtkarspelen,2013JJ00,2013,14281,,167,,114,,53,328,,19,309,407,,39,-16,368,-79,-26,,14255
112002,3000,Male,GM0059,Achtkarspelen,2014JJ00,2014,14255,,140,,112,,28,347,,18,329,413,,21,-4,392,-66,-37,,14218
112003,3000,Male,GM0059,Achtkarspelen,2015JJ00,2015,14218,,141,,114,,27,441,,28,413,447,,20,-6,427,-6,21,,14239
112004,3000,Male,GM0059,Achtkarspelen,2016JJ00,2016,14239,,153,,148,,5,454,,15,439,514,,30,-6,484,-60,-54,,14185
112005,3000,Male,GM0059,Achtkarspelen,2017JJ00,2017,14185,,142,,115,,27,500,,17,483,509,,24,-3,485,-9,18,,14203
112006,3000,Male,GM0059,Achtkarspelen,2018JJ00,2018,14203,,134,,131,,3,479,,27,452,517,,22,-4,495,-38,-36,,14167
112007,3000,Male,GM0059,Achtkarspelen,2019JJ00,2019,14167,,151,,109,,42,513,,25,488,544,,32,-7,512,-31,13,,14180
112008,3000,Male,GM0059,Achtkarspelen,2020JJ00,2020,14180,,131,,106,,25,488,,38,450,476,,19,-5,457,12,37,,14217
112009,3000,Male,GM0059,Achtkarspelen,2021JJ00,2021,14217,,145,,154,,-9,479,,20,459,429,,22,-10,407,50,42,,14259
112010,3000,Male,GM0059,Achtkarspelen,2022JJ00,2022,14259,,138,,131,,7,593,,166,427,506,,70,-43,436,87,93,,14352
112011,3000,Male,GM0059,Achtkarspelen,2023JJ00,2023,14352,,130,,144,,-14,556,,105,451,512,,76,-30,436,44,28,,14380
112410,3000,Male,GM0482,Alblasserdam,2012JJ00,2012,9496,,114,,84,,30,362,,30,332,276,,33,-5,243,86,114,,9610
112411,3000,Male,GM0482,Alblasserdam,2013JJ00,2013,9610,,125,,64,,61,308,,19,289,285,,25,-5,260,23,83,,9693
112412,3000,Male,GM0482,Alblasserdam,2014JJ00,2014,9693,,149,,75,,74,309,,41,268,364,,40,-9,324,-55,20,,9713
112413,3000,Male,GM0482,Alblasserdam,2015JJ00,2015,9713,,123,,84,,39,351,,44,307,332,,38,-11,294,19,58,,9771
112414,3000,Male,GM0482,Alblasserdam,2016JJ00,2016,9771,,126,,84,,42,390,,43,347,394,,40,-13,354,-4,38,,9809
112415,3000,Male,GM0482,Alblasserdam,2017JJ00,2017,9809,,118,,89,,29,387,,41,346,397,,32,-1,365,-10,17,,9826
112416,3000,Male,GM0482,Alblasserdam,2018JJ00,2018,9826,,133,,82,,51,368,,54,314,393,,24,-5,369,-25,27,,9853
112417,3000,Male,GM0482,Alblasserdam,2019JJ00,2019,9853,,108,,96,,12,422,,43,379,373,,20,1,353,49,61,,9914
112418,3000,Male,GM0482,Alblasserdam,2020JJ00,2020,9914,,108,,87,,21,402,,36,366,441,,29,-6,412,-39,-17,,9897
112419,3000,Male,GM0482,Alblasserdam,2021JJ00,2021,9897,,137,,118,,19,407,,29,378,437,,16,-5,421,-30,-12,,9885
112420,3000,Male,GM0482,Alblasserdam,2022JJ00,2022,9885,,116,,87,,29,558,,163,395,451,,57,-16,394,107,134,,10019
112421,3000,Male,GM0482,Alblasserdam,2023JJ00,2023,10019,,115,,74,,41,474,,109,365,520,,68,-31,452,-46,-4,,10015
112492,3000,Male,GM0613,Albrandswaard,2012JJ00,2012,12388,,129,,93,,36,577,,47,530,546,,11,30,535,31,67,,12455
112493,3000,Male,GM0613,Albrandswaard,2013JJ00,2013,12455,,130,,77,,53,526,,30,496,583,,7,32,576,-57,-4,,12451
112494,3000,Male,GM0613,Albrandswaard,2014JJ00,2014,12451,,141,,81,,60,642,,32,610,630,,20,30,610,12,74,,12525
112495,3000,Male,GM0613,Albrandswaard,2015JJ00,2015,12525,,119,,93,,26,674,,37,637,804,,70,-7,734,-130,-101,,12424
112496,3000,Male,GM0613,Albrandswaard,2016JJ00,2016,12424,,115,,105,,10,854,,51,803,837,,70,-10,767,17,26,,12450
112497,3000,Male,GM0613,Albrandswaard,2017JJ00,2017,12450,,113,,89,,24,831,,42,789,805,,68,-17,737,26,49,,12499
112498,3000,Male,GM0613,Albrandswaard,2018JJ00,2018,12499,,107,,107,,0,768,,53,715,746,,51,-21,695,22,19,,12518
112499,3000,Male,GM0613,Albrandswaard,2019JJ00,2019,12518,,110,,81,,29,905,,49,856,774,,37,-10,737,131,159,,12677
112500,3000,Male,GM0613,Albrandswaard,2020JJ00,2020,12677,,121,,109,,12,914,,45,869,797,,25,-6,772,117,130,,12807
112501,3000,Male,GM0613,Albrandswaard,2021JJ00,2021,12807,,130,,113,,17,854,,44,810,790,,40,-12,750,64,81,,12888
112502,3000,Male,GM0613,Albrandswaard,2022JJ00,2022,12888,,123,,94,,29,853,,77,776,726,,46,-7,680,127,157,,13045
112503,3000,Male,GM0613,Albrandswaard,2023JJ00,2023,13045,,115,,84,,31,786,,56,730,770,,50,-8,720,16,48,,13093
112738,3000,Male,GM0361,Alkmaar,2012JJ00,2012,46423,,560,,377,,183,2195,,370,1825,2253,,403,-115,1850,-58,126,,46549
112739,3000,Male,GM0361,Alkmaar,2013JJ00,2013,46549,,532,,381,,151,2110,,376,1734,2058,,290,-44,1768,52,201,,46750
112740,3000,Male,GM0361,Alkmaar,2014JJ00,2014,46750,,544,,354,,190,2260,,441,1819,2214,,271,-6,1943,46,239,,46989
112741,3000,Male,GM0361,Alkmaar,2015JJ00,2015,52973,,584,,432,,152,2858,,550,2308,2711,,331,13,2380,147,293,,53266
112742,3000,Male,GM0361,Alkmaar,2016JJ00,2016,53266,,583,,487,,96,3293,,582,2711,2991,,365,-40,2626,302,393,,53659
112743,3000,Male,GM0361,Alkmaar,2017JJ00,2017,53659,,575,,435,,140,3022,,406,2616,3111,,324,-60,2787,-89,54,,53713
112744,3000,Male,GM0361,Alkmaar,2018JJ00,2018,53713,,542,,420,,122,2762,,420,2342,2897,,413,-137,2484,-135,-18,,53695
112745,3000,Male,GM0361,Alkmaar,2019JJ00,2019,53695,,571,,437,,134,2908,,480,2428,2593,,324,-60,2269,315,455,,54150
112746,3000,Male,GM0361,Alkmaar,2020JJ00,2020,54150,,512,,480,,32,2892,,394,2498,2713,,312,-15,2401,179,205,,54355
112747,3000,Male,GM0361,Alkmaar,2021JJ00,2021,54355,,604,,506,,98,3117,,390,2727,2722,,346,-47,2376,395,487,,54842
112748,3000,Male,GM0361,Alkmaar,2022JJ00,2022,54842,,515,,536,,-21,3116,,654,2462,2754,,363,-68,2391,362,337,,55179
112749,3000,Male,GM0361,Alkmaar,2023JJ00,2023,55179,,507,,568,,-61,2957,,443,2514,2647,,355,-72,2292,310,244,,55423
112820,3000,Male,GM0141,Almelo,2012JJ00,2012,36089,,371,,290,,81,1351,,290,1061,1401,,228,-71,1173,-50,35,,36124
112821,3000,Male,GM0141,Almelo,2013JJ00,2013,36124,,391,,350,,41,1278,,268,1010,1440,,246,-98,1194,-162,-118,,36006
112822,3000,Male,GM0141,Almelo,2014JJ00,2014,36006,,382,,329,,53,1220,,208,1012,1289,,210,-42,1079,-69,-15,,35991
112823,3000,Male,GM0141,Almelo,2015JJ00,2015,35991,,395,,347,,48,1480,,308,1172,1408,,210,-69,1198,72,124,,36115
112824,3000,Male,GM0141,Almelo,2016JJ00,2016,36115,,347,,346,,1,1621,,326,1295,1573,,190,-40,1383,48,50,,36165
112825,3000,Male,GM0141,Almelo,2017JJ00,2017,36165,,336,,376,,-40,1769,,253,1516,1659,,219,-84,1440,110,74,,36239
112826,3000,Male,GM0141,Almelo,2018JJ00,2018,36239,,340,,297,,43,1797,,369,1428,1658,,254,-59,1404,139,182,,36421
112827,3000,Male,GM0141,Almelo,2019JJ00,2019,36421,,354,,332,,22,1748,,360,1388,1602,,223,-73,1379,146,171,,36592
112828,3000,Male,GM0141,Almelo,2020JJ00,2020,36592,,350,,425,,-75,1686,,296,1390,1556,,191,-50,1365,130,51,,36643
112829,3000,Male,GM0141,Almelo,2021JJ00,2021,36643,,338,,441,,-103,1791,,312,1479,1681,,294,-114,1387,110,4,,36647
112830,3000,Male,GM0141,Almelo,2022JJ00,2022,36647,,367,,349,,18,2110,,536,1574,1653,,301,-90,1352,457,467,,37114
112831,3000,Male,GM0141,Almelo,2023JJ00,2023,37114,,351,,400,,-49,2063,,497,1566,1766,,348,-123,1418,297,250,,37364
112902,3000,Male,GM0034,Almere,2012JJ00,2012,95874,,1249,,496,,753,4041,,909,3132,3744,,587,191,3157,297,1054,,96928
112903,3000,Male,GM0034,Almere,2013JJ00,2013,96928,,1191,,487,,704,3845,,942,2903,4243,,924,-27,3319,-398,310,,97238
112904,3000,Male,GM0034,Almere,2014JJ00,2014,97238,,1200,,426,,774,4220,,1138,3082,4560,,975,-89,3585,-340,428,,97666
112905,3000,Male,GM0034,Almere,2015JJ00,2015,97666,,1234,,460,,774,4712,,1143,3569,4924,,1153,-311,3771,-212,574,,98240
112906,3000,Male,GM0034,Almere,2016JJ00,2016,98240,,1227,,513,,714,5472,,1208,4264,4750,,862,-62,3888,722,1433,,99673
112907,3000,Male,GM0034,Almere,2017JJ00,2017,99673,,1123,,464,,659,5563,,1124,4439,4715,,784,-41,3931,848,1508,,101181
112908,3000,Male,GM0034,Almere,2018JJ00,2018,101181,,1219,,500,,719,5891,,1254,4637,4699,,779,7,3920,1192,1901,,103082
112909,3000,Male,GM0034,Almere,2019JJ00,2019,103082,,1344,,538,,806,6370,,1361,5009,5123,,864,-32,4259,1247,2048,,105130
112910,3000,Male,GM0034,Almere,2020JJ00,2020,105130,,1260,,571,,689,6006,,1068,4938,5304,,740,-11,4564,702,1393,,106523
112911,3000,Male,GM0034,Almere,2021JJ00,2021,106523,,1337,,630,,707,6441,,1096,5345,5580,,932,-184,4648,861,1568,,108091
112912,3000,Male,GM0034,Almere,2022JJ00,2022,108091,,1290,,631,,659,7749,,2047,5702,5899,,1133,-184,4766,1850,2498,,110589
112913,3000,Male,GM0034,Almere,2023JJ00,2023,110589,,1281,,645,,636,7112,,1616,5496,6024,,1315,-319,4709,1088,1714,,112303
113066,3000,Male,GM0484,Alphen aan den Rijn,2012JJ00,2012,35958,,444,,245,,199,1111,,164,947,1252,,201,-54,1051,-141,59,,36017
113067,3000,Male,GM0484,Alphen aan den Rijn,2013JJ00,2013,36017,,424,,257,,167,1160,,194,966,1237,,182,0,1055,-77,109,,36126
113068,3000,Male,GM0484,Alphen aan den Rijn,2014JJ00,2014,52979,,563,,354,,209,1872,,314,1558,1726,,311,-66,1415,146,342,,53321
113069,3000,Male,GM0484,Alphen aan den Rijn,2015JJ00,2015,53321,,545,,388,,157,2091,,402,1689,1942,,276,-53,1666,149,303,,53624
113070,3000,Male,GM0484,Alphen aan den Rijn,2016JJ00,2016,53624,,559,,422,,137,2610,,511,2099,2210,,373,-63,1837,400,540,,54164
113071,3000,Male,GM0484,Alphen aan den Rijn,2017JJ00,2017,54164,,565,,394,,171,2476,,446,2030,2245,,344,-47,1901,231,399,,54563
113072,3000,Male,GM0484,Alphen aan den Rijn,2018JJ00,2018,54563,,544,,422,,122,2760,,609,2151,2161,,447,-99,1714,599,720,,55283
113073,3000,Male,GM0484,Alphen aan den Rijn,2019JJ00,2019,55283,,558,,439,,119,2558,,565,1993,2219,,450,-50,1769,339,458,,55741
113074,3000,Male,GM0484,Alphen aan den Rijn,2020JJ00,2020,55741,,573,,478,,95,2643,,440,2203,2376,,362,-45,2014,267,358,,56099
113075,3000,Male,GM0484,Alphen aan den Rijn,2021JJ00,2021,56099,,583,,501,,82,2495,,454,2041,2381,,318,-64,2063,114,197,,56296
113076,3000,Male,GM0484,Alphen aan den Rijn,2022JJ00,2022,56296,,550,,502,,48,2991,,784,2207,2493,,475,-187,2018,498,544,,56840
113077,3000,Male,GM0484,Alphen aan den Rijn,2023JJ00,2023,56840,,596,,488,,108,2728,,497,2231,2440,,479,-168,1961,288,397,,57237
113230,3000,Male,GM1723,Alphen-Chaam,2012JJ00,2012,4825,,44,,43,,1,216,,18,198,161,,16,-1,145,55,56,,4881
113231,3000,Male,GM1723,Alphen-Chaam,2013JJ00,2013,4881,,32,,31,,1,248,,28,220,210,,19,0,191,38,39,,4920
113232,3000,Male,GM1723,Alphen-Chaam,2014JJ00,2014,4920,,38,,34,,4,238,,39,199,212,,28,-5,184,26,31,,4951
113233,3000,Male,GM1723,Alphen-Chaam,2015JJ00,2015,4951,,38,,36,,2,289,,32,257,184,,29,-4,155,105,107,,5058
113234,3000,Male,GM1723,Alphen-Chaam,2016JJ00,2016,5058,,46,,37,,9,285,,51,234,231,,28,-3,203,54,63,,5121
113235,3000,Male,GM1723,Alphen-Chaam,2017JJ00,2017,5121,,42,,45,,-3,280,,35,245,259,,24,-1,235,21,18,,5139
113236,3000,Male,GM1723,Alphen-Chaam,2018JJ00,2018,5139,,54,,34,,20,275,,41,234,240,,31,-6,209,35,55,,5194
113237,3000,Male,GM1723,Alphen-Chaam,2019JJ00,2019,5194,,38,,49,,-11,278,,40,238,258,,45,-3,213,20,10,,5204
113238,3000,Male,GM1723,Alphen-Chaam,2020JJ00,2020,5204,,52,,58,,-6,328,,43,285,258,,28,5,230,70,64,,5268
113239,3000,Male,GM1723,Alphen-Chaam,2021JJ00,2021,5268,,56,,46,,10,270,,30,240,233,,30,-9,203,37,47,,5315
113240,3000,Male,GM1723,Alphen-Chaam,2022JJ00,2022,5315,,46,,65,,-19,275,,49,226,235,,37,-5,198,40,22,,5337
113241,3000,Male,GM1723,Alphen-Chaam,2023JJ00,2023,5337,,36,,53,,-17,275,,43,232,267,,42,-3,225,8,-11,,5326
113319,3000,Male,GM1959,Altena,2019JJ00,2019,27876,,297,,207,,90,983,,172,811,789,,104,-22,685,194,287,,28163
113320,3000,Male,GM1959,Altena,2020JJ00,2020,28163,,277,,276,,1,1074,,165,909,875,,108,-34,767,199,200,,28363
113321,3000,Male,GM1959,Altena,2021JJ00,2021,28363,,329,,267,,62,1116,,159,957,858,,97,-20,761,258,320,,28683
113322,3000,Male,GM1959,Altena,2022JJ00,2022,28683,,282,,252,,30,1184,,349,835,852,,166,-36,686,332,361,,29044
113323,3000,Male,GM1959,Altena,2023JJ00,2023,29044,,296,,263,,33,1257,,339,918,967,,199,-60,768,290,323,,29367
113804,3000,Male,GM0060,Ameland,2012JJ00,2012,1753,,16,,12,,4,61,,8,53,68,,2,-1,66,-7,-3,,1750
113805,3000,Male,GM0060,Ameland,2013JJ00,2013,1750,,25,,14,,11,84,,7,77,89,,13,-7,76,-5,6,,1756
113806,3000,Male,GM0060,Ameland,2014JJ00,2014,1756,,17,,13,,4,84,,11,73,79,,2,2,77,5,8,,1764
113807,3000,Male,GM0060,Ameland,2015JJ00,2015,1764,,24,,17,,7,89,,14,75,69,,17,-1,52,20,28,,1792
113808,3000,Male,GM0060,Ameland,2016JJ00,2016,1792,,19,,18,,1,104,,14,90,98,,14,0,84,6,7,,1799
113809,3000,Male,GM0060,Ameland,2017JJ00,2017,1799,,19,,16,,3,107,,24,83,97,,7,0,90,10,13,,1812
113810,3000,Male,GM0060,Ameland,2018JJ00,2018,1812,,16,,23,,-7,117,,24,93,103,,16,0,87,14,7,,1819
113811,3000,Male,GM0060,Ameland,2019JJ00,2019,1819,,11,,14,,-3,137,,44,93,110,,33,-8,77,27,24,,1843
113812,3000,Male,GM0060,Ameland,2020JJ00,2020,1843,,20,,8,,12,131,,30,101,102,,33,-11,69,29,42,,1885
113813,3000,Male,GM0060,Ameland,2021JJ00,2021,1885,,19,,18,,1,135,,44,91,129,,47,-20,82,6,9,,1894
113814,3000,Male,GM0060,Ameland,2022JJ00,2022,1894,,16,,18,,-2,157,,81,76,111,,41,-14,70,46,44,,1938
113815,3000,Male,GM0060,Ameland,2023JJ00,2023,1938,,17,,25,,-8,127,,48,79,124,,30,-7,94,3,-5,,1933
113968,3000,Male,GM0307,Amersfoort,2012JJ00,2012,72849,,993,,453,,540,3064,,415,2649,2925,,512,-138,2413,139,677,,73526
113969,3000,Male,GM0307,Amersfoort,2013JJ00,2013,73526,,941,,486,,455,2985,,405,2580,2796,,429,-50,2367,189,649,,74175
113970,3000,Male,GM0307,Amersfoort,2014JJ00,2014,74175,,971,,505,,466,3370,,438,2932,3042,,490,-83,2552,328,792,,74967
113971,3000,Male,GM0307,Amersfoort,2015JJ00,2015,74967,,933,,534,,399,3511,,483,3028,3302,,509,-70,2793,209,602,,75569
113972,3000,Male,GM0307,Amersfoort,2016JJ00,2016,75569,,945,,483,,462,3704,,433,3271,3795,,484,-93,3311,-91,374,,75943
113973,3000,Male,GM0307,Amersfoort,2017JJ00,2017,75943,,910,,498,,412,3905,,480,3425,3781,,455,-48,3326,124,543,,76486
113974,3000,Male,GM0307,Amersfoort,2018JJ00,2018,76486,,915,,506,,409,3842,,477,3365,3702,,398,-80,3304,140,551,,77037
113975,3000,Male,GM0307,Amersfoort,2019JJ00,2019,77037,,890,,480,,410,3890,,584,3306,3685,,425,-60,3260,205,617,,77654
113976,3000,Male,GM0307,Amersfoort,2020JJ00,2020,77654,,888,,560,,328,3732,,428,3304,3900,,324,-46,3576,-168,153,,77807
113977,3000,Male,GM0307,Amersfoort,2021JJ00,2021,77807,,942,,589,,353,4153,,428,3725,3818,,278,-17,3540,335,690,,78497
113978,3000,Male,GM0307,Amersfoort,2022JJ00,2022,78497,,901,,593,,308,4492,,802,3690,3719,,417,-71,3302,773,1077,,79574
113979,3000,Male,GM0307,Amersfoort,2023JJ00,2023,79574,,850,,576,,274,4328,,502,3826,4004,,424,-89,3580,324,598,,80172
114214,3000,Male,GM0362,Amstelveen,2012JJ00,2012,39711,,378,,391,,-13,4031,,1447,2584,3506,,1458,-263,2048,525,516,,40227
114215,3000,Male,GM0362,Amstelveen,2013JJ00,2013,40227,,441,,362,,79,3829,,1445,2384,3670,,1566,-267,2104,159,231,,40458
114216,3000,Male,GM0362,Amstelveen,2014JJ00,2014,40458,,463,,342,,121,4661,,1638,3023,3672,,1426,-212,2246,989,1119,,41577
114217,3000,Male,GM0362,Amstelveen,2015JJ00,2015,41577,,429,,364,,65,4906,,1730,3176,4207,,1623,-340,2584,699,760,,42337
114218,3000,Male,GM0362,Amstelveen,2016JJ00,2016,42337,,471,,401,,70,4795,,1723,3072,4468,,1612,-232,2856,327,402,,42739
114219,3000,Male,GM0362,Amstelveen,2017JJ00,2017,42739,,410,,356,,54,5099,,1947,3152,4828,,1703,-182,3125,271,328,,43067
114220,3000,Male,GM0362,Amstelveen,2018JJ00,2018,43067,,409,,356,,53,5412,,2225,3187,4874,,1690,-194,3184,538,583,,43650
114221,3000,Male,GM0362,Amstelveen,2019JJ00,2019,43650,,444,,367,,77,5588,,2359,3229,5185,,1750,-199,3435,403,475,,44125
114222,3000,Male,GM0362,Amstelveen,2020JJ00,2020,44125,,399,,412,,-13,4806,,1673,3133,5143,,1605,-128,3538,-337,-346,,43779
114223,3000,Male,GM0362,Amstelveen,2021JJ00,2021,43779,,426,,398,,28,5917,,2362,3555,5127,,1381,-113,3746,790,820,,44599
114224,3000,Male,GM0362,Amstelveen,2022JJ00,2022,44599,,376,,426,,-50,6824,,3345,3479,5784,,1491,-159,4293,1040,980,,45579
114225,3000,Male,GM0362,Amstelveen,2023JJ00,2023,45579,,360,,398,,-38,5920,,2489,3431,5723,,1538,-122,4185,197,165,,45744
114378,3000,Male,GM0363,Amsterdam,2012JJ00,2012,389005,,5595,,2629,,2966,26553,,10457,16096,25294,,10640,-3420,14654,1259,4256,,393261
114379,3000,Male,GM0363,Amsterdam,2013JJ00,2013,393261,,5809,,2628,,3181,27443,,10515,16928,24628,,9906,-2550,14722,2815,6086,,399347
114380,3000,Male,GM0363,Amsterdam,2014JJ00,2014,399424,,5709,,2549,,3160,29362,,12079,17283,27096,,10165,-2285,16931,2266,5457,,404881
114381,3000,Male,GM0363,Amsterdam,2015JJ00,2015,404881,,5792,,2663,,3129,32179,,13455,18724,28582,,9385,-659,19197,3597,6727,,411608
114382,3000,Male,GM0363,Amsterdam,2016JJ00,2016,411608,,5672,,2744,,2928,34155,,15051,19104,30530,,9870,-840,20660,3625,6519,,418127
114383,3000,Male,GM0363,Amsterdam,2017JJ00,2017,418127,,5637,,2526,,3111,35569,,17749,17820,33705,,11461,-2352,22244,1864,4987,,423114
114384,3000,Male,GM0363,Amsterdam,2018JJ00,2018,423114,,5433,,2710,,2723,36673,,19472,17201,34699,,11713,-1649,22986,1974,4673,,427787
114385,3000,Male,GM0363,Amsterdam,2019JJ00,2019,427787,,5414,,2670,,2744,38760,,21242,17518,36430,,11818,-1269,24612,2330,5092,,432879
114386,3000,Male,GM0363,Amsterdam,2020JJ00,2020,432879,,5317,,3040,,2277,34117,,15665,18452,35696,,10003,150,25693,-1579,671,,433550
114387,3000,Male,GM0363,Amsterdam,2021JJ00,2021,433550,,5551,,3186,,2365,37856,,18246,19610,36141,,9729,183,26412,1715,4032,,437582
114388,3000,Male,GM0363,Amsterdam,2022JJ00,2022,437582,,5096,,3083,,2013,43170,,23863,19307,38561,,11286,-859,27275,4609,6582,,454273
114389,3000,Male,GM0363,Amsterdam,2023JJ00,2023,454273,,4937,,3116,,1821,44363,,22560,21803,39540,,12950,-992,26590,4823,6493,,460766
114952,3000,Male,GM0200,Apeldoorn,2012JJ00,2012,77525,,763,,741,,22,2843,,385,2458,2775,,451,-99,2324,68,91,,77616
114953,3000,Male,GM0200,Apeldoorn,2013JJ00,2013,77616,,824,,729,,95,2816,,377,2439,2735,,373,-38,2362,81,180,,77796
114954,3000,Male,GM0200,Apeldoorn,2014JJ00,2014,77796,,760,,673,,87,3040,,403,2637,2782,,458,-127,2324,258,367,,78163
114955,3000,Male,GM0200,Apeldoorn,2015JJ00,2015,78163,,807,,674,,133,3173,,493,2680,2662,,361,-59,2301,511,646,,78809
114956,3000,Male,GM0200,Apeldoorn,2016JJ00,2016,78809,,836,,747,,89,3509,,479,3030,2913,,417,-104,2496,596,682,,79491
114957,3000,Male,GM0200,Apeldoorn,2017JJ00,2017,79491,,769,,723,,46,3544,,646,2898,2913,,424,-157,2489,631,671,,80162
114958,3000,Male,GM0200,Apeldoorn,2018JJ00,2018,80162,,754,,763,,-9,3583,,679,2904,2862,,363,-109,2499,721,718,,80880
114959,3000,Male,GM0200,Apeldoorn,2019JJ00,2019,80880,,779,,756,,23,3710,,629,3081,2983,,521,-170,2462,727,752,,81632
114960,3000,Male,GM0200,Apeldoorn,2020JJ00,2020,81632,,808,,843,,-35,3795,,540,3255,3238,,401,-120,2837,557,525,,82157
114961,3000,Male,GM0200,Apeldoorn,2021JJ00,2021,82157,,844,,857,,-13,3666,,562,3104,3162,,375,-111,2787,504,485,,82642
114962,3000,Male,GM0200,Apeldoorn,2022JJ00,2022,82642,,793,,899,,-106,4326,,1289,3037,3356,,522,-144,2834,970,863,,83505
114963,3000,Male,GM0200,Apeldoorn,2023JJ00,2023,83505,,727,,879,,-152,4227,,1047,3180,3465,,688,-265,2777,762,596,,84101
115116,3000,Male,GM0003,Appingedam,2012JJ00,2012,5822,,60,,58,,2,254,,10,244,244,,15,-3,229,10,13,,5835
115117,3000,Male,GM0003,Appingedam,2013JJ00,2013,5835,,49,,70,,-21,246,,13,233,214,,9,1,205,32,11,,5846
115118,3000,Male,GM0003,Appingedam,2014JJ00,2014,5846,,51,,65,,-14,292,,20,272,317,,42,-19,275,-25,-39,,5807
115119,3000,Male,GM0003,Appingedam,2015JJ00,2015,5807,,43,,81,,-38,324,,28,296,290,,9,2,281,34,-5,,5802
115120,3000,Male,GM0003,Appingedam,2016JJ00,2016,5802,,53,,78,,-25,362,,42,320,338,,29,-12,309,24,0,,5802
115121,3000,Male,GM0003,Appingedam,2017JJ00,2017,5802,,50,,62,,-12,291,,13,278,330,,19,-11,311,-39,-51,,5751
115122,3000,Male,GM0003,Appingedam,2018JJ00,2018,5751,,41,,65,,-24,289,,18,271,301,,11,-7,290,-12,-31,,5720
115123,3000,Male,GM0003,Appingedam,2019JJ00,2019,5720,,40,,77,,-37,298,,35,263,310,,18,1,292,-12,-49,,5671
115124,3000,Male,GM0003,Appingedam,2020JJ00,2020,5671,,42,,76,,-34,305,,40,265,341,,8,2,333,-36,-60,,5611
115444,3000,Male,GM0202,Arnhem,2012JJ00,2012,74067,,982,,582,,400,4527,,715,3812,4641,,935,-319,3706,-114,292,,74359
115445,3000,Male,GM0202,Arnhem,2013JJ00,2013,74359,,958,,583,,375,4910,,787,4123,4615,,810,-180,3805,295,670,,75029
115446,3000,Male,GM0202,Arnhem,2014JJ00,2014,75029,,946,,591,,355,5050,,692,4358,4559,,802,-195,3757,491,843,,75872
115447,3000,Male,GM0202,Arnhem,2015JJ00,2015,75872,,897,,589,,308,5356,,824,4532,4923,,841,-254,4082,433,744,,76616
115448,3000,Male,GM0202,Arnhem,2016JJ00,2016,76616,,848,,580,,268,7235,,1737,5498,6418,,823,-257,5595,817,1091,,77707
115449,3000,Male,GM0202,Arnhem,2017JJ00,2017,77707,,839,,631,,208,6691,,1533,5158,6098,,839,-307,5259,593,802,,78509
115450,3000,Male,GM0202,Arnhem,2018JJ00,2018,78509,,849,,643,,206,6673,,1697,4976,5826,,709,-117,5117,847,1064,,79573
115451,3000,Male,GM0202,Arnhem,2019JJ00,2019,79573,,868,,616,,252,7751,,2889,4862,6780,,599,-33,6181,971,1232,,80805
115452,3000,Male,GM0202,Arnhem,2020JJ00,2020,80805,,796,,701,,95,7107,,2091,5016,6650,,688,-131,5962,457,571,,81376
115453,3000,Male,GM0202,Arnhem,2021JJ00,2021,81376,,883,,722,,161,7825,,2776,5049,7342,,748,-188,6594,483,656,,82032
115454,3000,Male,GM0202,Arnhem,2022JJ00,2022,82032,,839,,730,,109,8520,,3706,4814,7741,,903,-278,6838,779,895,,82927
115455,3000,Male,GM0202,Arnhem,2023JJ00,2023,82927,,836,,681,,155,9513,,4605,4908,8784,,939,-249,7845,729,914,,83841
115608,3000,Male,GM0106,Assen,2012JJ00,2012,32931,,383,,280,,103,1336,,144,1192,1361,,139,26,1222,-25,78,,33009
115609,3000,Male,GM0106,Assen,2013JJ00,2013,33009,,341,,262,,79,1332,,173,1159,1430,,145,4,1285,-98,-20,,32989
115610,3000,Male,GM0106,Assen,2014JJ00,2014,32989,,346,,248,,98,1374,,167,1207,1447,,159,-28,1288,-73,26,,33015
115611,3000,Male,GM0106,Assen,2015JJ00,2015,33015,,307,,296,,11,1459,,194,1265,1461,,158,-10,1303,-2,12,,33027
115612,3000,Male,GM0106,Assen,2016JJ00,2016,33027,,364,,295,,69,2075,,325,1750,1797,,177,-35,1620,278,341,,33368
115613,3000,Male,GM0106,Assen,2017JJ00,2017,33368,,338,,322,,16,1928,,181,1747,1840,,147,-35,1693,88,97,,33465
115614,3000,Male,GM0106,Assen,2018JJ00,2018,33465,,333,,326,,7,1936,,215,1721,1761,,133,-7,1628,175,178,,33643
115615,3000,Male,GM0106,Assen,2019JJ00,2019,33643,,319,,322,,-3,2112,,436,1676,1764,,125,-20,1639,348,338,,33981
115616,3000,Male,GM0106,Assen,2020JJ00,2020,33981,,318,,322,,-4,1966,,168,1798,1862,,104,-8,1758,104,97,,34078
115617,3000,Male,GM0106,Assen,2021JJ00,2021,34078,,334,,370,,-36,2096,,146,1950,2002,,188,-81,1814,94,48,,34126
115618,3000,Male,GM0106,Assen,2022JJ00,2022,34126,,298,,375,,-77,2151,,461,1690,1869,,159,-23,1710,282,208,,34334
115619,3000,Male,GM0106,Assen,2023JJ00,2023,34334,,309,,367,,-58,2431,,398,2033,2129,,273,-120,1856,302,242,,34576
115772,3000,Male,GM0743,Asten,2012JJ00,2012,8409,,74,,79,,-5,308,,94,214,278,,46,-10,232,30,25,,8434
115773,3000,Male,GM0743,Asten,2013JJ00,2013,8434,,85,,70,,15,311,,72,239,303,,75,-12,228,8,22,,8456
115774,3000,Male,GM0743,Asten,2014JJ00,2014,8456,,75,,74,,1,373,,139,234,323,,80,-24,243,50,50,,8506
115775,3000,Male,GM0743,Asten,2015JJ00,2015,8506,,59,,45,,14,399,,173,226,395,,114,-27,281,4,18,,8524
115776,3000,Male,GM0743,Asten,2016JJ00,2016,8524,,72,,80,,-8,463,,152,311,377,,120,-13,257,86,80,,8604
115777,3000,Male,GM0743,Asten,2017JJ00,2017,8604,,85,,87,,-2,435,,127,308,414,,97,-29,317,21,18,,8622
115778,3000,Male,GM0743,Asten,2018JJ00,2018,8622,,76,,83,,-7,366,,106,260,387,,118,-42,269,-21,-30,,8592
115779,3000,Male,GM0743,Asten,2019JJ00,2019,8592,,72,,78,,-6,423,,166,257,419,,123,-49,296,4,-2,,8590
115780,3000,Male,GM0743,Asten,2020JJ00,2020,8590,,81,,93,,-12,416,,114,302,398,,134,-45,264,18,12,,8602
115781,3000,Male,GM0743,Asten,2021JJ00,2021,8602,,87,,93,,-6,475,,125,350,375,,109,-47,266,100,93,,8695
115782,3000,Male,GM0743,Asten,2022JJ00,2022,8695,,73,,87,,-14,479,,169,310,384,,110,-26,274,95,81,,8776
115783,3000,Male,GM0743,Asten,2023JJ00,2023,8776,,89,,106,,-17,409,,116,293,373,,117,-46,256,36,19,,8795
116264,3000,Male,GM0744,Baarle-Nassau,2012JJ00,2012,3424,,32,,29,,3,117,,25,92,138,,33,0,105,-21,-17,,3407
116265,3000,Male,GM0744,Baarle-Nassau,2013JJ00,2013,3407,,32,,36,,-4,158,,41,117,204,,50,-17,154,-46,-49,,3358
116266,3000,Male,GM0744,Baarle-Nassau,2014JJ00,2014,3358,,20,,40,,-20,155,,24,131,140,,33,3,107,15,-5,,3353
116267,3000,Male,GM0744,Baarle-Nassau,2015JJ00,2015,3353,,29,,43,,-14,152,,27,125,145,,21,2,124,7,-8,,3345
116268,3000,Male,GM0744,Baarle-Nassau,2016JJ00,2016,3345,,27,,31,,-4,175,,35,140,134,,28,-4,106,41,36,,3381
116269,3000,Male,GM0744,Baarle-Nassau,2017JJ00,2017,3381,,29,,40,,-11,236,,43,193,159,,26,-2,133,77,66,,3447
116270,3000,Male,GM0744,Baarle-Nassau,2018JJ00,2018,3447,,28,,41,,-13,209,,38,171,166,,23,-2,143,43,30,,3477
116271,3000,Male,GM0744,Baarle-Nassau,2019JJ00,2019,3477,,27,,40,,-13,192,,38,154,198,,38,1,160,-6,-20,,3457
116272,3000,Male,GM0744,Baarle-Nassau,2020JJ00,2020,3457,,25,,54,,-29,220,,35,185,186,,48,-2,138,34,4,,3461
116273,3000,Male,GM0744,Baarle-Nassau,2021JJ00,2021,3461,,27,,43,,-16,215,,33,182,165,,36,5,129,50,33,,3494
116274,3000,Male,GM0744,Baarle-Nassau,2022JJ00,2022,3494,,28,,50,,-22,223,,57,166,138,,27,1,111,85,63,,3557
116275,3000,Male,GM0744,Baarle-Nassau,2023JJ00,2023,3557,,23,,53,,-30,225,,51,174,223,,64,-5,159,2,-28,,3529
116346,3000,Male,GM0308,Baarn,2012JJ00,2012,11709,,104,,140,,-36,498,,58,440,496,,56,-8,440,2,-34,,11675
116347,3000,Male,GM0308,Baarn,2013JJ00,2013,11675,,102,,147,,-45,541,,53,488,454,,64,-1,390,87,40,,11715
116348,3000,Male,GM0308,Baarn,2014JJ00,2014,11715,,99,,123,,-24,637,,70,567,571,,67,-4,504,66,46,,11761
116349,3000,Male,GM0308,Baarn,2015JJ00,2015,11761,,115,,150,,-35,638,,64,574,539,,43,7,496,99,65,,11826
116350,3000,Male,GM0308,Baarn,2016JJ00,2016,11826,,117,,140,,-23,670,,70,600,635,,60,-2,575,35,12,,11838
116351,3000,Male,GM0308,Baarn,2017JJ00,2017,11838,,111,,148,,-37,700,,74,626,588,,46,-3,542,112,78,,11916
116352,3000,Male,GM0308,Baarn,2018JJ00,2018,11916,,106,,144,,-38,613,,80,533,504,,52,-3,452,109,69,,11985
116353,3000,Male,GM0308,Baarn,2019JJ00,2019,11985,,124,,142,,-18,657,,96,561,594,,50,6,544,63,44,,12029
116354,3000,Male,GM0308,Baarn,2020JJ00,2020,12029,,103,,168,,-65,694,,48,646,619,,37,2,582,75,9,,12038
116355,3000,Male,GM0308,Baarn,2021JJ00,2021,12038,,114,,145,,-31,697,,70,627,647,,34,3,613,50,18,,12056
116356,3000,Male,GM0308,Baarn,2022JJ00,2022,12056,,113,,142,,-29,697,,103,594,588,,55,-6,533,109,79,,12135
116357,3000,Male,GM0308,Baarn,2023JJ00,2023,12135,,104,,149,,-45,707,,85,622,596,,67,-13,529,111,66,,12201
116756,3000,Male,GM0489,Barendrecht,2012JJ00,2012,23229,,288,,143,,145,962,,73,889,1011,,117,-15,894,-49,96,,23325
116757,3000,Male,GM0489,Barendrecht,2013JJ00,2013,23325,,265,,151,,114,904,,82,822,1011,,110,-11,901,-107,7,,23332
116758,3000,Male,GM0489,Barendrecht,2014JJ00,2014,23332,,240,,122,,118,976,,111,865,1006,,98,-5,908,-30,88,,23420
116759,3000,Male,GM0489,Barendrecht,2015JJ00,2015,23420,,209,,138,,71,1140,,82,1058,1063,,124,-36,939,77,150,,23570
116760,3000,Male,GM0489,Barendrecht,2016JJ00,2016,23570,,252,,160,,92,1362,,95,1267,1162,,132,-29,1030,200,290,,23860
116761,3000,Male,GM0489,Barendrecht,2017JJ00,2017,23860,,214,,147,,67,1227,,103,1124,1281,,101,-31,1180,-54,13,,23873
116762,3000,Male,GM0489,Barendrecht,2018JJ00,2018,23873,,229,,182,,47,1237,,110,1127,1160,,111,-12,1049,77,126,,23999
116763,3000,Male,GM0489,Barendrecht,2019JJ00,2019,23999,,218,,153,,65,1185,,128,1057,1257,,96,-17,1161,-72,-7,,23992
116764,3000,Male,GM0489,Barendrecht,2020JJ00,2020,23992,,216,,205,,11,1268,,120,1148,1341,,93,-14,1248,-73,-63,,23929
116765,3000,Male,GM0489,Barendrecht,2021JJ00,2021,23929,,233,,193,,40,1226,,88,1138,1215,,71,0,1144,11,54,,23983
116766,3000,Male,GM0489,Barendrecht,2022JJ00,2022,23983,,206,,173,,33,1222,,152,1070,1251,,119,-17,1132,-29,7,,23990
116767,3000,Male,GM0489,Barendrecht,2023JJ00,2023,23990,,199,,186,,13,1075,,134,941,1173,,97,1,1076,-98,-83,,23907
116838,3000,Male,GM0203,Barneveld,2012JJ00,2012,26617,,397,,187,,210,722,,75,647,832,,62,9,770,-110,101,,26718
116839,3000,Male,GM0203,Barneveld,2013JJ00,2013,26718,,443,,189,,254,773,,86,687,799,,66,9,733,-26,226,,26944
116840,3000,Male,GM0203,Barneveld,2014JJ00,2014,26954,,389,,190,,199,874,,79,795,859,,92,-4,767,15,216,,27170
116841,3000,Male,GM0203,Barneveld,2015JJ00,2015,27170,,385,,181,,204,1006,,112,894,859,,91,-11,768,147,353,,27523
116842,3000,Male,GM0203,Barneveld,2016JJ00,2016,27523,,431,,221,,210,1199,,105,1094,876,,100,1,776,323,533,,28056
116843,3000,Male,GM0203,Barneveld,2017JJ00,2017,28056,,421,,198,,223,1237,,139,1098,998,,117,-14,881,239,463,,28519
116844,3000,Male,GM0203,Barneveld,2018JJ00,2018,28519,,470,,218,,252,1122,,125,997,977,,72,23,905,145,398,,28917
116845,3000,Male,GM0203,Barneveld,2019JJ00,2019,28917,,427,,220,,207,1373,,153,1220,1001,,111,-17,890,372,579,,29496
116846,3000,Male,GM0203,Barneveld,2020JJ00,2020,29496,,434,,221,,213,1213,,139,1074,988,,83,-22,905,225,436,,29932
116847,3000,Male,GM0203,Barneveld,2021JJ00,2021,29932,,487,,245,,242,1179,,137,1042,1083,,100,-37,983,96,337,,30269
116848,3000,Male,GM0203,Barneveld,2022JJ00,2022,30269,,465,,233,,232,1270,,321,949,983,,127,-46,856,287,520,,30789
116849,3000,Male,GM0203,Barneveld,2023JJ00,2023,30789,,441,,239,,202,1322,,184,1138,1065,,123,-14,942,257,458,,31247
117330,3000,Male,GM0005,Bedum,2012JJ00,2012,5281,,53,,51,,2,201,,14,187,204,,7,-1,197,-3,-1,,5280
117331,3000,Male,GM0005,Bedum,2013JJ00,2013,5280,,44,,34,,10,203,,13,190,247,,16,-1,231,-44,-32,,5248
117332,3000,Male,GM0005,Bedum,2014JJ00,2014,5248,,57,,42,,15,212,,10,202,251,,13,-3,238,-39,-25,,5223
117333,3000,Male,GM0005,Bedum,2015JJ00,2015,5223,,51,,41,,10,244,,11,233,247,,15,-1,232,-3,7,,5230
117334,3000,Male,GM0005,Bedum,2016JJ00,2016,5230,,53,,63,,-10,272,,9,263,252,,10,-1,242,20,11,,5241
117335,3000,Male,GM0005,Bedum,2017JJ00,2017,5241,,52,,46,,6,228,,11,217,241,,9,0,232,-13,-6,,5235
117336,3000,Male,GM0005,Bedum,2018JJ00,2018,5235,,41,,48,,-7,229,,15,214,244,,16,-3,228,-15,-18,,5217
117494,3000,Male,GM0888,Beek (L.),2012JJ00,2012,7999,,74,,82,,-8,333,,23,310,370,,31,-4,339,-37,-46,,7953
117495,3000,Male,GM0888,Beek (L.),2013JJ00,2013,7953,,49,,77,,-28,344,,40,304,377,,41,-9,336,-33,-61,,7892
117496,3000,Male,GM0888,Beek (L.),2014JJ00,2014,7892,,71,,58,,13,353,,38,315,379,,45,-1,334,-26,-13,,7879
117497,3000,Male,GM0888,Beek (L.),2015JJ00,2015,7879,,60,,85,,-25,387,,36,351,415,,51,-16,364,-28,-53,,7826
117498,3000,Male,GM0888,Beek (L.),2016JJ00,2016,7826,,61,,66,,-5,421,,60,361,441,,46,-6,395,-20,-24,,7802
117499,3000,Male,GM0888,Beek (L.),2017JJ00,2017,7802,,63,,73,,-10,379,,24,355,419,,39,-3,380,-40,-50,,7752
117500,3000,Male,GM0888,Beek (L.),2018JJ00,2018,7752,,62,,78,,-16,466,,57,409,428,,23,0,405,38,22,,7774
117501,3000,Male,GM0888,Beek (L.),2019JJ00,2019,7774,,75,,101,,-26,410,,39,371,408,,32,9,376,2,-25,,7749
117502,3000,Male,GM0888,Beek (L.),2020JJ00,2020,7749,,63,,104,,-41,447,,52,395,415,,49,-8,366,32,-11,,7738
117503,3000,Male,GM0888,Beek (L.),2021JJ00,2021,7738,,66,,96,,-30,417,,25,392,426,,39,3,387,-9,-39,,7699
117504,3000,Male,GM0888,Beek (L.),2022JJ00,2022,7699,,72,,93,,-21,570,,139,431,397,,51,-7,346,173,151,,7850
117505,3000,Male,GM0888,Beek (L.),2023JJ00,2023,7850,,64,,94,,-30,552,,144,408,496,,111,-16,385,56,25,,7875
117747,3000,Male,GM1954,Beekdaelen,2019JJ00,2019,17785,,128,,201,,-73,1034,,85,949,915,,85,-18,830,119,47,,17832
117748,3000,Male,GM1954,Beekdaelen,2020JJ00,2020,17832,,156,,220,,-64,1079,,89,990,909,,72,-12,837,170,109,,17941
117749,3000,Male,GM1954,Beekdaelen,2021JJ00,2021,17941,,151,,244,,-93,1044,,88,956,1005,,81,-11,924,39,-54,,17887
117750,3000,Male,GM1954,Beekdaelen,2022JJ00,2022,17887,,154,,230,,-76,1069,,157,912,945,,111,-27,834,124,49,,17936
117751,3000,Male,GM1954,Beekdaelen,2023JJ00,2023,17936,,159,,226,,-67,1022,,125,897,979,,120,-31,859,43,-21,,17915
117822,3000,Male,GM0370,Beemster,2012JJ00,2012,4360,,42,,18,,24,206,,16,190,196,,16,-4,180,10,34,,4394
117823,3000,Male,GM0370,Beemster,2013JJ00,2013,4394,,40,,34,,6,222,,23,199,168,,19,-4,149,54,60,,4454
117824,3000,Male,GM0370,Beemster,2014JJ00,2014,4454,,38,,23,,15,176,,7,169,195,,18,-1,177,-19,-5,,4449
117825,3000,Male,GM0370,Beemster,2015JJ00,2015,4449,,41,,39,,2,202,,11,191,185,,17,-2,168,17,20,,4469
117826,3000,Male,GM0370,Beemster,2016JJ00,2016,4469,,46,,34,,12,333,,12,321,234,,12,1,222,99,111,,4580
117827,3000,Male,GM0370,Beemster,2017JJ00,2017,4580,,61,,38,,23,340,,14,326,188,,13,-5,175,152,176,,4756
117828,3000,Male,GM0370,Beemster,2018JJ00,2018,4756,,57,,44,,13,303,,15,288,223,,13,-1,210,80,93,,4849
117829,3000,Male,GM0370,Beemster,2019JJ00,2019,4849,,53,,30,,23,343,,11,332,212,,8,-2,204,131,154,,5003
117830,3000,Male,GM0370,Beemster,2020JJ00,2020,5003,,45,,38,,7,286,,11,275,239,,12,0,227,47,54,,5057
117831,3000,Male,GM0370,Beemster,2021JJ00,2021,5057,,57,,51,,6,510,,13,497,228,,17,0,211,282,280,,5337
118150,3000,Male,GM0889,Beesel,2012JJ00,2012,6920,,70,,58,,12,190,,29,161,240,,31,-6,209,-50,-38,,6882
118151,3000,Male,GM0889,Beesel,2013JJ00,2013,6882,,61,,50,,11,185,,20,165,216,,26,-5,190,-31,-19,,6863
118152,3000,Male,GM0889,Beesel,2014JJ00,2014,6863,,56,,52,,4,173,,19,154,231,,23,-4,208,-58,-54,,6809
118153,3000,Male,GM0889,Beesel,2015JJ00,2015,6809,,54,,52,,2,169,,26,143,243,,13,5,230,-74,-71,,6738
118154,3000,Male,GM0889,Beesel,2016JJ00,2016,6738,,51,,64,,-13,247,,34,213,204,,24,1,180,43,30,,6768
118155,3000,Male,GM0889,Beesel,2017JJ00,2017,6768,,55,,51,,4,228,,31,197,240,,11,3,229,-12,-7,,6761
118156,3000,Male,GM0889,Beesel,2018JJ00,2018,6761,,65,,60,,5,259,,25,234,219,,22,0,197,40,46,,6807
118157,3000,Male,GM0889,Beesel,2019JJ00,2019,6807,,40,,53,,-13,229,,24,205,238,,20,-3,218,-9,-22,,6785
118158,3000,Male,GM0889,Beesel,2020JJ00,2020,6785,,57,,60,,-3,266,,17,249,259,,31,-7,228,7,4,,6789
118159,3000,Male,GM0889,Beesel,2021JJ00,2021,6789,,45,,89,,-44,207,,24,183,218,,22,1,196,-11,-56,,6733
118160,3000,Male,GM0889,Beesel,2022JJ00,2022,6733,,63,,69,,-6,248,,58,190,214,,25,-8,189,34,29,,6762
118161,3000,Male,GM0889,Beesel,2023JJ00,2023,6762,,48,,63,,-15,230,,40,190,239,,25,-2,214,-9,-24,,6738
118478,3000,Male,GM0007,Bellingwedde,2012JJ00,2012,4645,,33,,49,,-16,244,,30,214,381,,90,-71,291,-137,-155,,4490
118479,3000,Male,GM0007,Bellingwedde,2013JJ00,2013,4490,,31,,52,,-21,190,,12,178,210,,19,-4,191,-20,-41,,4449
118480,3000,Male,GM0007,Bellingwedde,2014JJ00,2014,4449,,40,,48,,-8,534,,300,234,363,,22,5,341,171,166,,4615
118481,3000,Male,GM0007,Bellingwedde,2015JJ00,2015,4615,,27,,53,,-26,440,,156,284,491,,25,-2,466,-51,-78,,4537
118482,3000,Male,GM0007,Bellingwedde,2016JJ00,2016,4537,,29,,47,,-18,518,,126,392,505,,29,-5,476,13,-3,,4534
118483,3000,Male,GM0007,Bellingwedde,2017JJ00,2017,4534,,33,,59,,-26,349,,40,309,402,,44,-20,358,-53,-78,,4456
119056,3000,Male,GM1945,Berg en Dal,2016JJ00,2016,17190,,137,,206,,-69,995,,124,871,813,,87,-8,726,182,113,,17303
119057,3000,Male,GM1945,Berg en Dal,2017JJ00,2017,17303,,126,,213,,-87,968,,112,856,914,,93,-6,821,54,-34,,17269
119058,3000,Male,GM1945,Berg en Dal,2018JJ00,2018,17269,,134,,199,,-65,914,,120,794,805,,88,-7,717,109,40,,17309
119059,3000,Male,GM1945,Berg en Dal,2019JJ00,2019,17324,,143,,206,,-63,966,,109,857,807,,92,-15,715,159,98,,17422
119060,3000,Male,GM1945,Berg en Dal,2020JJ00,2020,17422,,137,,207,,-70,864,,89,775,774,,71,-6,703,90,19,,17441
119061,3000,Male,GM1945,Berg en Dal,2021JJ00,2021,17441,,166,,239,,-73,801,,91,710,782,,82,-7,700,19,-56,,17385
119062,3000,Male,GM1945,Berg en Dal,2022JJ00,2022,17385,,155,,224,,-69,1003,,263,740,728,,94,-10,634,275,204,,17589
119063,3000,Male,GM1945,Berg en Dal,2023JJ00,2023,17589,,128,,230,,-102,974,,161,813,894,,148,-42,746,80,-20,,17569
119216,3000,Male,GM0491,Bergambacht,2012JJ00,2012,4888,,48,,40,,8,162,,22,140,168,,8,0,160,-6,4,,4892
119217,3000,Male,GM0491,Bergambacht,2013JJ00,2013,4892,,42,,35,,7,223,,27,196,189,,20,-9,169,34,40,,4932
119218,3000,Male,GM0491,Bergambacht,2014JJ00,2014,4932,,53,,46,,7,253,,39,214,188,,16,-1,172,65,120,,5052
119298,3000,Male,GM1724,Bergeijk,2012JJ00,2012,9187,,66,,74,,-8,291,,43,248,254,,38,-11,216,37,29,,9216
119299,3000,Male,GM1724,Bergeijk,2013JJ00,2013,9216,,72,,57,,15,308,,48,260,283,,48,-7,235,25,39,,9255
119300,3000,Male,GM1724,Bergeijk,2014JJ00,2014,9255,,74,,71,,3,310,,52,258,322,,38,-1,284,-12,-10,,9245
119301,3000,Male,GM1724,Bergeijk,2015JJ00,2015,9245,,76,,88,,-12,394,,85,309,358,,63,-6,295,36,23,,9268
119302,3000,Male,GM1724,Bergeijk,2016JJ00,2016,9268,,81,,81,,0,404,,83,321,335,,48,-9,287,69,71,,9339
119303,3000,Male,GM1724,Bergeijk,2017JJ00,2017,9339,,65,,80,,-15,425,,93,332,366,,65,-2,301,59,40,,9379
119304,3000,Male,GM1724,Bergeijk,2018JJ00,2018,9379,,92,,69,,23,436,,109,327,398,,80,-13,318,38,61,,9440
119305,3000,Male,GM1724,Bergeijk,2019JJ00,2019,9440,,78,,80,,-2,499,,119,380,389,,79,-2,310,110,106,,9546
119306,3000,Male,GM1724,Bergeijk,2020JJ00,2020,9546,,81,,86,,-5,433,,84,349,369,,61,-16,308,64,59,,9605
119307,3000,Male,GM1724,Bergeijk,2021JJ00,2021,9605,,96,,95,,1,475,,94,381,409,,77,-20,332,66,68,,9673
119308,3000,Male,GM1724,Bergeijk,2022JJ00,2022,9673,,69,,97,,-28,477,,145,332,318,,70,-16,248,159,130,,9803
119309,3000,Male,GM1724,Bergeijk,2023JJ00,2023,9803,,63,,91,,-28,410,,104,306,356,,103,-36,253,54,28,,9831
119380,3000,Male,GM0893,Bergen (L.),2012JJ00,2012,6658,,60,,50,,10,219,,37,182,232,,44,-9,188,-13,-2,,6656
119381,3000,Male,GM0893,Bergen (L.),2013JJ00,2013,6656,,42,,58,,-16,180,,23,157,178,,18,3,160,2,-14,,6642
119382,3000,Male,GM0893,Bergen (L.),2014JJ00,2014,6642,,50,,68,,-18,171,,28,143,212,,23,3,189,-41,-61,,6581
119383,3000,Male,GM0893,Bergen (L.),2015JJ00,2015,6581,,43,,77,,-34,199,,25,174,233,,42,-2,191,-34,-67,,6514
119384,3000,Male,GM0893,Bergen (L.),2016JJ00,2016,6514,,47,,54,,-7,242,,38,204,218,,19,-1,199,24,18,,6532
119385,3000,Male,GM0893,Bergen (L.),2017JJ00,2017,6532,,55,,56,,-1,249,,27,222,227,,22,2,205,22,22,,6554
119386,3000,Male,GM0893,Bergen (L.),2018JJ00,2018,6554,,49,,75,,-26,266,,39,227,220,,21,4,199,46,21,,6575
119387,3000,Male,GM0893,Bergen (L.),2019JJ00,2019,6575,,49,,81,,-32,242,,44,198,237,,24,-4,213,5,-28,,6547
119388,3000,Male,GM0893,Bergen (L.),2020JJ00,2020,6547,,44,,69,,-25,292,,42,250,247,,28,1,219,45,21,,6568
119389,3000,Male,GM0893,Bergen (L.),2021JJ00,2021,6568,,60,,81,,-21,287,,38,249,235,,30,0,205,52,31,,6599
119390,3000,Male,GM0893,Bergen (L.),2022JJ00,2022,6599,,40,,72,,-32,283,,44,239,246,,35,-5,211,37,5,,6604
119391,3000,Male,GM0893,Bergen (L.),2023JJ00,2023,6604,,46,,65,,-19,285,,45,240,234,,28,0,206,51,32,,6636
119462,3000,Male,GM0373,Bergen (NH.),2012JJ00,2012,14870,,69,,196,,-127,577,,106,471,641,,139,-17,502,-64,-189,,14681
119463,3000,Male,GM0373,Bergen (NH.),2013JJ00,2013,14681,,82,,183,,-101,615,,102,513,641,,100,2,541,-26,-127,,14554
119464,3000,Male,GM0373,Bergen (NH.),2014JJ00,2014,14554,,85,,160,,-75,661,,137,524,645,,87,-8,558,16,-60,,14494
119465,3000,Male,GM0373,Bergen (NH.),2015JJ00,2015,14494,,67,,177,,-110,849,,190,659,767,,108,-9,659,82,-25,,14469
119466,3000,Male,GM0373,Bergen (NH.),2016JJ00,2016,14469,,79,,192,,-113,836,,119,717,810,,111,-16,699,26,-84,,14385
119467,3000,Male,GM0373,Bergen (NH.),2017JJ00,2017,14385,,83,,208,,-125,896,,107,789,687,,82,3,605,209,84,,14469
119468,3000,Male,GM0373,Bergen (NH.),2018JJ00,2018,14469,,68,,207,,-139,778,,107,671,641,,72,3,569,137,-2,,14467
119469,3000,Male,GM0373,Bergen (NH.),2019JJ00,2019,14467,,73,,201,,-128,727,,120,607,666,,52,11,614,61,-68,,14399
119470,3000,Male,GM0373,Bergen (NH.),2020JJ00,2020,14399,,78,,229,,-151,794,,104,690,726,,67,-6,659,68,-82,,14317
119471,3000,Male,GM0373,Bergen (NH.),2021JJ00,2021,14317,,79,,211,,-132,766,,106,660,662,,69,-3,593,104,-27,,14290
119472,3000,Male,GM0373,Bergen (NH.),2022JJ00,2022,14290,,77,,216,,-139,951,,249,702,661,,102,-1,559,290,150,,14440
119473,3000,Male,GM0373,Bergen (NH.),2023JJ00,2023,14440,,79,,218,,-139,823,,144,679,770,,147,-19,623,53,-88,,14352
119544,3000,Male,GM0748,Bergen op Zoom,2012JJ00,2012,32662,,327,,291,,36,1132,,251,881,1088,,230,-40,858,44,82,,32744
119545,3000,Male,GM0748,Bergen op Zoom,2013JJ00,2013,32744,,338,,278,,60,1202,,263,939,1129,,208,-8,921,73,137,,32881
119546,3000,Male,GM0748,Bergen op Zoom,2014JJ00,2014,32881,,326,,282,,44,1213,,266,947,1332,,328,-70,1004,-119,-80,,32801
119547,3000,Male,GM0748,Bergen op Zoom,2015JJ00,2015,32801,,308,,303,,5,1242,,252,990,1274,,287,-31,987,-32,-26,,32775
119548,3000,Male,GM0748,Bergen op Zoom,2016JJ00,2016,32775,,328,,327,,1,1339,,270,1069,1364,,278,-43,1086,-25,-30,,32745
119549,3000,Male,GM0748,Bergen op Zoom,2017JJ00,2017,32745,,340,,330,,10,1442,,255,1187,1323,,238,-57,1085,119,133,,32878
119550,3000,Male,GM0748,Bergen op Zoom,2018JJ00,2018,32878,,297,,294,,3,1569,,296,1273,1303,,218,-18,1085,266,274,,33152
119551,3000,Male,GM0748,Bergen op Zoom,2019JJ00,2019,33152,,332,,301,,31,1607,,327,1280,1322,,213,-17,1109,285,315,,33467
119552,3000,Male,GM0748,Bergen op Zoom,2020JJ00,2020,33467,,323,,392,,-69,1516,,332,1184,1376,,149,2,1227,140,72,,33539
119553,3000,Male,GM0748,Bergen op Zoom,2021JJ00,2021,33539,,354,,379,,-25,1549,,324,1225,1313,,248,-62,1065,236,206,,33745
119554,3000,Male,GM0748,Bergen op Zoom,2022JJ00,2022,33745,,324,,340,,-16,1829,,477,1352,1303,,303,-64,1000,526,504,,34249
119555,3000,Male,GM0748,Bergen op Zoom,2023JJ00,2023,34249,,311,,375,,-64,1916,,497,1419,1391,,272,-46,1119,525,454,,34703
120200,3000,Male,GM1859,Berkelland,2012JJ00,2012,22622,,175,,225,,-50,684,,53,631,725,,63,-11,662,-41,-89,,22533
120201,3000,Male,GM1859,Berkelland,2013JJ00,2013,22533,,162,,216,,-54,672,,46,626,684,,33,2,651,-12,-64,,22469
120202,3000,Male,GM1859,Berkelland,2014JJ00,2014,22469,,172,,195,,-23,664,,65,599,808,,60,-12,748,-144,-167,,22302
120203,3000,Male,GM1859,Berkelland,2015JJ00,2015,22302,,167,,215,,-48,754,,102,652,683,,35,-6,648,71,22,,22324
120204,3000,Male,GM1859,Berkelland,2016JJ00,2016,22324,,170,,211,,-41,692,,65,627,748,,45,-3,703,-56,-100,,22224
120205,3000,Male,GM1859,Berkelland,2017JJ00,2017,22224,,154,,238,,-84,701,,50,651,754,,55,-4,699,-53,-134,,22090
120206,3000,Male,GM1859,Berkelland,2018JJ00,2018,22090,,142,,252,,-110,698,,52,646,686,,46,-5,640,12,-99,,21991
120207,3000,Male,GM1859,Berkelland,2019JJ00,2019,21991,,160,,267,,-107,731,,66,665,719,,57,-4,662,12,-94,,21897
120208,3000,Male,GM1859,Berkelland,2020JJ00,2020,21897,,166,,239,,-73,790,,63,727,666,,47,-2,619,124,52,,21949
120209,3000,Male,GM1859,Berkelland,2021JJ00,2021,21949,,191,,246,,-55,727,,59,668,652,,44,1,608,75,21,,21970
120210,3000,Male,GM1859,Berkelland,2022JJ00,2022,21970,,186,,239,,-53,808,,139,669,650,,75,-11,575,158,106,,22076
120211,3000,Male,GM1859,Berkelland,2023JJ00,2023,22076,,168,,257,,-89,790,,133,657,753,,95,-32,658,37,-52,,22024
120528,3000,Male,GM1721,Bernheze,2012JJ00,2012,15023,,138,,107,,31,547,,81,466,563,,45,-15,518,-16,16,,15039
120529,3000,Male,GM1721,Bernheze,2013JJ00,2013,15039,,141,,122,,19,485,,74,411,581,,73,-17,508,-96,-77,,14962
120530,3000,Male,GM1721,Bernheze,2014JJ00,2014,14962,,142,,125,,17,601,,82,519,571,,71,-17,500,30,49,,15011
120531,3000,Male,GM1721,Bernheze,2015JJ00,2015,15011,,108,,129,,-21,680,,83,597,590,,62,-24,528,90,70,,15081
120532,3000,Male,GM1721,Bernheze,2016JJ00,2016,15081,,140,,144,,-4,765,,126,639,586,,66,-18,520,179,177,,15258
120533,3000,Male,GM1721,Bernheze,2017JJ00,2017,15258,,143,,129,,14,824,,129,695,705,,83,-22,622,119,134,,15392
120534,3000,Male,GM1721,Bernheze,2018JJ00,2018,15392,,145,,147,,-2,790,,167,623,653,,54,-14,599,137,137,,15529
120535,3000,Male,GM1721,Bernheze,2019JJ00,2019,15529,,148,,129,,19,943,,208,735,706,,151,-46,555,237,257,,15786
120536,3000,Male,GM1721,Bernheze,2020JJ00,2020,15786,,153,,187,,-34,850,,164,686,741,,115,-53,626,109,73,,15859
120537,3000,Male,GM1721,Bernheze,2021JJ00,2021,15859,,162,,136,,26,914,,147,767,742,,108,-47,634,172,197,,16056
120538,3000,Male,GM1721,Bernheze,2022JJ00,2022,16056,,148,,170,,-22,925,,248,677,683,,128,-43,555,242,220,,16276
120539,3000,Male,GM1721,Bernheze,2023JJ00,2023,16276,,154,,157,,-3,859,,254,605,690,,134,-34,556,169,166,,16442
120610,3000,Male,GM0568,Bernisse,2012JJ00,2012,6244,,37,,46,,-9,154,,13,141,177,,12,-3,165,-23,-32,,6212
120611,3000,Male,GM0568,Bernisse,2013JJ00,2013,6212,,49,,50,,-1,165,,17,148,209,,16,-5,193,-44,-46,,6166
120612,3000,Male,GM0568,Bernisse,2014JJ00,2014,6166,,65,,52,,13,167,,15,152,197,,10,2,187,-30,32,,6198
120692,3000,Male,GM0753,Best,2012JJ00,2012,14357,,138,,91,,47,441,,79,362,494,,62,-27,432,-53,-5,,14352
120693,3000,Male,GM0753,Best,2013JJ00,2013,14352,,114,,108,,6,443,,62,381,464,,58,1,406,-21,-14,,14338
120694,3000,Male,GM0753,Best,2014JJ00,2014,14338,,127,,95,,32,552,,98,454,507,,74,-10,433,45,78,,14416
120695,3000,Male,GM0753,Best,2015JJ00,2015,14416,,116,,107,,9,626,,98,528,515,,76,-14,439,111,122,,14538
120696,3000,Male,GM0753,Best,2016JJ00,2016,14538,,138,,104,,34,645,,78,567,602,,70,-16,532,43,75,,14613
120697,3000,Male,GM0753,Best,2017JJ00,2017,14613,,113,,107,,6,782,,175,607,635,,94,-15,541,147,152,,14765
120698,3000,Male,GM0753,Best,2018JJ00,2018,14765,,154,,125,,29,757,,187,570,628,,109,-33,519,129,162,,14927
120699,3000,Male,GM0753,Best,2019JJ00,2019,14927,,117,,136,,-19,761,,182,579,641,,111,-38,530,120,101,,15028
120700,3000,Male,GM0753,Best,2020JJ00,2020,15028,,149,,157,,-8,827,,183,644,777,,124,-52,653,50,43,,15071
120701,3000,Male,GM0753,Best,2021JJ00,2021,15071,,165,,103,,62,888,,208,680,776,,117,-26,659,112,171,,15242
120702,3000,Male,GM0753,Best,2022JJ00,2022,15242,,151,,130,,21,889,,245,644,740,,160,-31,580,149,170,,15412
120703,3000,Male,GM0753,Best,2023JJ00,2023,15412,,147,,124,,23,959,,289,670,792,,184,-23,608,167,195,,15607
120856,3000,Male,GM0209,Beuningen,2012JJ00,2012,12686,,113,,89,,24,425,,51,374,501,,42,-1,459,-76,-53,,12633
120857,3000,Male,GM0209,Beuningen,2013JJ00,2013,12633,,110,,77,,33,482,,37,445,517,,26,7,491,-35,-3,,12630
120858,3000,Male,GM0209,Beuningen,2014JJ00,2014,12630,,103,,79,,24,501,,44,457,504,,22,3,482,-3,21,,12651
120859,3000,Male,GM0209,Beuningen,2015JJ00,2015,12651,,96,,106,,-10,603,,50,553,615,,32,1,583,-12,-22,,12629
120860,3000,Male,GM0209,Beuningen,2016JJ00,2016,12629,,109,,87,,22,688,,47,641,644,,38,2,606,44,68,,12697
120861,3000,Male,GM0209,Beuningen,2017JJ00,2017,12697,,132,,97,,35,787,,57,730,635,,36,-3,599,152,186,,12883
120862,3000,Male,GM0209,Beuningen,2018JJ00,2018,12883,,121,,100,,21,644,,39,605,620,,41,-4,579,24,41,,12924
120863,3000,Male,GM0209,Beuningen,2019JJ00,2019,12924,,134,,123,,11,632,,66,566,633,,37,-6,596,-1,8,,12932
120864,3000,Male,GM0209,Beuningen,2020JJ00,2020,12932,,137,,96,,41,670,,37,633,596,,19,4,577,74,112,,13044
120865,3000,Male,GM0209,Beuningen,2021JJ00,2021,13044,,124,,100,,24,587,,32,555,555,,26,1,529,32,58,,13102
120866,3000,Male,GM0209,Beuningen,2022JJ00,2022,13102,,127,,123,,4,696,,131,565,566,,53,0,513,130,135,,13237
120867,3000,Male,GM0209,Beuningen,2023JJ00,2023,13237,,129,,110,,19,662,,53,609,579,,71,-25,508,83,100,,13337
121020,3000,Male,GM0375,Beverwijk,2012JJ00,2012,19719,,246,,194,,52,1106,,179,927,1018,,168,-62,850,88,142,,19861
121021,3000,Male,GM0375,Beverwijk,2013JJ00,2013,19861,,228,,195,,33,945,,161,784,985,,150,-18,835,-40,-7,,19854
121022,3000,Male,GM0375,Beverwijk,2014JJ00,2014,19854,,223,,149,,74,1061,,167,894,1073,,196,-55,877,-12,66,,19920
121023,3000,Male,GM0375,Beverwijk,2015JJ00,2015,19920,,234,,174,,60,1235,,223,1012,1183,,219,-62,964,52,109,,20029
121024,3000,Male,GM0375,Beverwijk,2016JJ00,2016,20029,,240,,166,,74,1357,,205,1152,1136,,198,-86,938,221,293,,20322
121025,3000,Male,GM0375,Beverwijk,2017JJ00,2017,20322,,245,,169,,76,1359,,209,1150,1254,,233,-86,1021,105,176,,20498
121026,3000,Male,GM0375,Beverwijk,2018JJ00,2018,20498,,203,,195,,8,1324,,248,1076,1245,,245,-61,1000,79,84,,20582
121027,3000,Male,GM0375,Beverwijk,2019JJ00,2019,20582,,239,,160,,79,1431,,239,1192,1190,,213,-53,977,241,324,,20906
121028,3000,Male,GM0375,Beverwijk,2020JJ00,2020,20906,,216,,230,,-14,1402,,250,1152,1241,,170,-25,1071,161,146,,21052
121029,3000,Male,GM0375,Beverwijk,2021JJ00,2021,21052,,246,,224,,22,1252,,173,1079,1168,,161,-32,1007,84,108,,21160
121030,3000,Male,GM0375,Beverwijk,2022JJ00,2022,21160,,220,,196,,24,1512,,301,1211,1228,,197,-59,1031,284,307,,21467
121031,3000,Male,GM0375,Beverwijk,2023JJ00,2023,21467,,248,,211,,37,1319,,283,1036,1193,,195,-47,998,126,164,,21631
121348,3000,Male,GM0063,het Bildt,2012JJ00,2012,5537,,49,,39,,10,289,,102,187,400,,52,-27,348,-111,-99,,5438
121349,3000,Male,GM0063,het Bildt,2013JJ00,2013,5438,,50,,33,,17,408,,233,175,429,,39,-20,390,-21,-2,,5436
121350,3000,Male,GM0063,het Bildt,2014JJ00,2014,5436,,34,,40,,-6,527,,299,228,545,,46,-27,499,-18,-24,,5412
121351,3000,Male,GM0063,het Bildt,2015JJ00,2015,5412,,37,,42,,-5,451,,186,265,518,,43,-34,475,-67,-74,,5338
121352,3000,Male,GM0063,het Bildt,2016JJ00,2016,5338,,60,,54,,6,466,,144,322,476,,17,-1,459,-10,-3,,5335
121353,3000,Male,GM0063,het Bildt,2017JJ00,2017,5335,,35,,50,,-15,531,,103,428,463,,52,-28,411,68,59,,5394
121430,3000,Male,GM0310,De Bilt,2012JJ00,2012,19981,,179,,198,,-19,1018,,113,905,990,,119,-25,871,28,11,,19992
121431,3000,Male,GM0310,De Bilt,2013JJ00,2013,19992,,193,,228,,-35,1071,,107,964,1017,,110,3,907,54,21,,20013
121432,3000,Male,GM0310,De Bilt,2014JJ00,2014,20013,,177,,201,,-24,1259,,119,1140,1145,,87,-12,1058,114,89,,20102
121433,3000,Male,GM0310,De Bilt,2015JJ00,2015,20102,,165,,214,,-49,1407,,119,1288,1234,,119,-4,1115,173,123,,20225
121434,3000,Male,GM0310,De Bilt,2016JJ00,2016,20225,,198,,254,,-56,1524,,127,1397,1260,,101,1,1159,264,209,,20434
121435,3000,Male,GM0310,De Bilt,2017JJ00,2017,20434,,187,,248,,-61,1384,,140,1244,1274,,98,8,1176,110,49,,20483
121436,3000,Male,GM0310,De Bilt,2018JJ00,2018,20483,,201,,233,,-32,1366,,146,1220,1261,,91,-10,1170,105,75,,20558
121437,3000,Male,GM0310,De Bilt,2019JJ00,2019,20558,,190,,227,,-37,1436,,180,1256,1205,,100,-16,1105,231,194,,20752
121438,3000,Male,GM0310,De Bilt,2020JJ00,2020,20752,,183,,237,,-54,1482,,135,1347,1278,,103,-15,1175,204,151,,20903
121439,3000,Male,GM0310,De Bilt,2021JJ00,2021,20903,,210,,263,,-53,1366,,156,1210,1264,,77,-4,1187,102,49,,20952
121440,3000,Male,GM0310,De Bilt,2022JJ00,2022,20952,,201,,233,,-32,1367,,216,1151,1165,,107,-7,1058,202,169,,21121
121441,3000,Male,GM0310,De Bilt,2023JJ00,2023,21121,,193,,225,,-32,1324,,182,1142,1303,,103,-3,1200,21,-11,,21110
121594,3000,Male,GM0585,Binnenmaas,2012JJ00,2012,14333,,132,,106,,26,634,,127,507,615,,55,-9,560,19,47,,14380
121595,3000,Male,GM0585,Binnenmaas,2013JJ00,2013,14380,,128,,105,,23,468,,42,426,657,,81,-48,576,-189,-166,,14214
121596,3000,Male,GM0585,Binnenmaas,2014JJ00,2014,14214,,135,,116,,19,445,,33,412,498,,28,3,470,-53,-34,,14180
121597,3000,Male,GM0585,Binnenmaas,2015JJ00,2015,14180,,115,,113,,2,555,,72,483,474,,46,-3,428,81,83,,14263
121598,3000,Male,GM0585,Binnenmaas,2016JJ00,2016,14263,,139,,134,,5,917,,167,750,748,,26,-2,722,169,176,,14439
121599,3000,Male,GM0585,Binnenmaas,2017JJ00,2017,14439,,153,,134,,19,836,,51,785,884,,75,-33,809,-48,-30,,14409
121600,3000,Male,GM0585,Binnenmaas,2018JJ00,2018,14409,,125,,124,,1,668,,42,626,574,,37,4,537,94,92,,14501
121676,3000,Male,GM1728,Bladel,2012JJ00,2012,9967,,97,,87,,10,331,,69,262,336,,38,-3,298,-5,5,,9972
121677,3000,Male,GM1728,Bladel,2013JJ00,2013,9972,,105,,76,,29,395,,72,323,341,,48,-12,293,54,83,,10055
121678,3000,Male,GM1728,Bladel,2014JJ00,2014,10055,,89,,83,,6,391,,75,316,367,,67,-24,300,24,28,,10083
121679,3000,Male,GM1728,Bladel,2015JJ00,2015,10083,,89,,99,,-10,401,,81,320,342,,63,-21,279,59,50,,10133
121680,3000,Male,GM1728,Bladel,2016JJ00,2016,10133,,93,,86,,7,442,,82,360,404,,65,-13,339,38,44,,10177
121681,3000,Male,GM1728,Bladel,2017JJ00,2017,10177,,91,,82,,9,437,,87,350,404,,68,-19,336,33,43,,10220
121682,3000,Male,GM1728,Bladel,2018JJ00,2018,10220,,73,,101,,-28,420,,84,336,387,,66,-19,321,33,7,,10227
121683,3000,Male,GM1728,Bladel,2019JJ00,2019,10227,,93,,83,,10,461,,113,348,350,,63,-12,287,111,121,,10348
121684,3000,Male,GM1728,Bladel,2020JJ00,2020,10348,,101,,125,,-24,482,,81,401,377,,67,-26,310,105,81,,10429
121685,3000,Male,GM1728,Bladel,2021JJ00,2021,10429,,92,,97,,-5,501,,90,411,400,,69,-21,331,101,96,,10525
121686,3000,Male,GM1728,Bladel,2022JJ00,2022,10525,,97,,108,,-11,510,,138,372,358,,60,-7,298,152,140,,10665
121687,3000,Male,GM1728,Bladel,2023JJ00,2023,10665,,99,,115,,-16,451,,151,300,415,,91,-26,324,36,20,,10685
121922,3000,Male,GM0376,Blaricum,2012JJ00,2012,4368,,29,,42,,-13,277,,18,259,238,,19,-6,219,39,24,,4392
121923,3000,Male,GM0376,Blaricum,2013JJ00,2013,4392,,26,,36,,-10,237,,20,217,224,,17,2,207,13,3,,4395
121924,3000,Male,GM0376,Blaricum,2014JJ00,2014,4395,,31,,45,,-14,338,,22,316,230,,25,-5,205,108,94,,4489
121925,3000,Male,GM0376,Blaricum,2015JJ00,2015,4489,,48,,49,,-1,445,,32,413,274,,30,1,244,171,169,,4658
121926,3000,Male,GM0376,Blaricum,2016JJ00,2016,4658,,52,,47,,5,578,,35,543,277,,26,2,251,301,305,,4963
121927,3000,Male,GM0376,Blaricum,2017JJ00,2017,4963,,57,,54,,3,639,,21,618,350,,22,-2,328,289,292,,5255
121928,3000,Male,GM0376,Blaricum,2018JJ00,2018,5255,,69,,56,,13,521,,59,462,332,,30,-3,302,189,200,,5455
121929,3000,Male,GM0376,Blaricum,2019JJ00,2019,5455,,68,,53,,15,522,,29,493,391,,25,-1,366,131,164,,5619
121930,3000,Male,GM0376,Blaricum,2020JJ00,2020,5619,,64,,40,,24,566,,31,535,357,,13,3,344,209,232,,5851
121931,3000,Male,GM0376,Blaricum,2021JJ00,2021,5851,,81,,63,,18,582,,23,559,396,,34,1,362,186,202,,6053
121932,3000,Male,GM0376,Blaricum,2022JJ00,2022,6053,,66,,50,,16,427,,60,367,404,,30,-1,374,23,39,,6092
121933,3000,Male,GM0376,Blaricum,2023JJ00,2023,6092,,70,,59,,11,473,,62,411,415,,29,0,386,58,69,,6161
122168,3000,Male,GM0377,Bloemendaal,2012JJ00,2012,10494,,57,,130,,-73,664,,61,603,548,,73,-9,475,116,42,,10536
122169,3000,Male,GM0377,Bloemendaal,2013JJ00,2013,10536,,53,,130,,-77,651,,79,572,621,,62,2,559,30,-47,,10489
122170,3000,Male,GM0377,Bloemendaal,2014JJ00,2014,10489,,57,,111,,-54,819,,98,721,656,,68,-7,588,163,109,,10598
122171,3000,Male,GM0377,Bloemendaal,2015JJ00,2015,10598,,69,,127,,-58,893,,80,813,744,,83,-2,661,149,94,,10692
122172,3000,Male,GM0377,Bloemendaal,2016JJ00,2016,10692,,64,,126,,-62,1056,,134,922,700,,78,-13,622,356,293,,10985
122173,3000,Male,GM0377,Bloemendaal,2017JJ00,2017,10985,,65,,127,,-62,1007,,120,887,746,,87,-11,659,261,196,,11181
122174,3000,Male,GM0377,Bloemendaal,2018JJ00,2018,11181,,77,,125,,-48,935,,103,832,750,,91,-9,659,185,140,,11321
122175,3000,Male,GM0377,Bloemendaal,2019JJ00,2019,11321,,68,,135,,-67,892,,113,779,761,,80,-1,681,131,63,,11384
122176,3000,Male,GM0377,Bloemendaal,2020JJ00,2020,11384,,57,,147,,-90,910,,100,810,822,,70,-1,752,88,-4,,11380
122177,3000,Male,GM0377,Bloemendaal,2021JJ00,2021,11380,,69,,152,,-83,943,,84,859,756,,53,-1,703,187,103,,11483
122178,3000,Male,GM0377,Bloemendaal,2022JJ00,2022,11483,,60,,155,,-95,941,,157,784,795,,103,-11,692,146,51,,11534
122179,3000,Male,GM0377,Bloemendaal,2023JJ00,2023,11534,,66,,170,,-104,839,,87,752,805,,95,-9,710,34,-70,,11464
122414,3000,Male,GM0055,Boarnsterhim,2012JJ00,2012,9721,,94,,61,,33,431,,27,404,409,,38,-5,371,22,58,,9779
122415,3000,Male,GM0055,Boarnsterhim,2013JJ00,2013,9779,,100,,68,,32,380,,30,350,432,,31,-5,401,-52,-22,,9757
122660,3000,Male,GM1901,Bodegraven-Reeuwijk,2012JJ00,2012,16439,,173,,108,,65,419,,54,365,533,,82,-29,451,-114,-48,,16391
122661,3000,Male,GM1901,Bodegraven-Reeuwijk,2013JJ00,2013,16391,,161,,130,,31,469,,64,405,483,,47,11,436,-14,17,,16408
122662,3000,Male,GM1901,Bodegraven-Reeuwijk,2014JJ00,2014,16408,,208,,112,,96,576,,91,485,516,,50,-7,466,60,156,,16564
122663,3000,Male,GM1901,Bodegraven-Reeuwijk,2015JJ00,2015,16564,,180,,120,,60,656,,86,570,551,,42,-1,509,105,166,,16730
122664,3000,Male,GM1901,Bodegraven-Reeuwijk,2016JJ00,2016,16730,,194,,106,,88,731,,77,654,648,,62,-11,586,83,171,,16901
122665,3000,Male,GM1901,Bodegraven-Reeuwijk,2017JJ00,2017,16901,,174,,128,,46,761,,88,673,717,,56,-16,661,44,91,,16992
122666,3000,Male,GM1901,Bodegraven-Reeuwijk,2018JJ00,2018,16992,,186,,138,,48,878,,101,777,687,,70,-20,617,191,236,,17228
122667,3000,Male,GM1901,Bodegraven-Reeuwijk,2019JJ00,2019,17228,,213,,139,,74,836,,126,710,713,,76,-18,637,123,199,,17427
122668,3000,Male,GM1901,Bodegraven-Reeuwijk,2020JJ00,2020,17427,,188,,131,,57,866,,129,737,699,,61,-3,638,167,224,,17651
122669,3000,Male,GM1901,Bodegraven-Reeuwijk,2021JJ00,2021,17651,,227,,146,,81,840,,124,716,682,,92,-27,590,158,237,,17888
122670,3000,Male,GM1901,Bodegraven-Reeuwijk,2022JJ00,2022,17888,,207,,153,,54,877,,138,739,732,,97,-19,635,145,200,,18088
122671,3000,Male,GM1901,Bodegraven-Reeuwijk,2023JJ00,2023,18088,,191,,163,,28,891,,160,731,776,,82,-16,694,115,145,,18233
122742,3000,Male,GM0755,Boekel,2012JJ00,2012,5095,,45,,39,,6,174,,32,142,133,,10,6,123,41,47,,5142
122743,3000,Male,GM0755,Boekel,2013JJ00,2013,5142,,41,,33,,8,169,,28,141,157,,7,2,150,12,20,,5162
122744,3000,Male,GM0755,Boekel,2014JJ00,2014,5162,,41,,57,,-16,183,,24,159,150,,9,0,141,33,17,,5179
122745,3000,Male,GM0755,Boekel,2015JJ00,2015,5179,,50,,46,,4,235,,30,205,190,,23,-9,167,45,48,,5227
122746,3000,Male,GM0755,Boekel,2016JJ00,2016,5227,,51,,52,,-1,278,,34,244,178,,21,-1,157,100,99,,5326
122747,3000,Male,GM0755,Boekel,2017JJ00,2017,5326,,46,,48,,-2,263,,37,226,205,,15,-1,190,58,56,,5382
122748,3000,Male,GM0755,Boekel,2018JJ00,2018,5382,,54,,43,,11,253,,28,225,244,,26,-7,218,9,20,,5402
122749,3000,Male,GM0755,Boekel,2019JJ00,2019,5402,,50,,46,,4,286,,41,245,195,,21,1,174,91,95,,5497
122750,3000,Male,GM0755,Boekel,2020JJ00,2020,5497,,62,,48,,14,292,,27,265,220,,34,-9,186,72,87,,5584
122751,3000,Male,GM0755,Boekel,2021JJ00,2021,5584,,77,,52,,25,250,,31,219,228,,29,-10,199,22,47,,5631
122752,3000,Male,GM0755,Boekel,2022JJ00,2022,5631,,76,,57,,19,250,,46,204,186,,40,-11,146,64,83,,5714
122753,3000,Male,GM0755,Boekel,2023JJ00,2023,5714,,69,,59,,10,273,,33,240,214,,29,-10,185,59,69,,5783
122824,3000,Male,GM0009,Ten Boer,2012JJ00,2012,3744,,53,,39,,14,137,,4,133,141,,6,0,135,-4,10,,3754
122825,3000,Male,GM0009,Ten Boer,2013JJ00,2013,3754,,34,,35,,-1,131,,7,124,155,,9,2,146,-24,-24,,3730
122826,3000,Male,GM0009,Ten Boer,2014JJ00,2014,3730,,36,,48,,-12,151,,12,139,170,,6,1,164,-19,-31,,3699
122827,3000,Male,GM0009,Ten Boer,2015JJ00,2015,3699,,32,,58,,-26,168,,11,157,181,,13,-6,168,-13,-39,,3660
122828,3000,Male,GM0009,Ten Boer,2016JJ00,2016,3660,,26,,53,,-27,155,,3,152,181,,14,-6,167,-26,-53,,3607
122829,3000,Male,GM0009,Ten Boer,2017JJ00,2017,3607,,23,,40,,-17,212,,6,206,185,,8,-3,177,27,9,,3616
122830,3000,Male,GM0009,Ten Boer,2018JJ00,2018,3616,,28,,44,,-16,201,,13,188,184,,9,-2,175,17,0,,3616
123316,3000,Male,GM1681,Borger-Odoorn,2012JJ00,2012,12894,,95,,131,,-36,542,,39,503,563,,34,3,529,-21,-56,,12838
123317,3000,Male,GM1681,Borger-Odoorn,2013JJ00,2013,12838,,118,,126,,-8,551,,35,516,586,,30,-6,556,-35,-44,,12794
123318,3000,Male,GM1681,Borger-Odoorn,2014JJ00,2014,12794,,88,,111,,-23,526,,30,496,561,,33,-2,528,-35,-58,,12736
123319,3000,Male,GM1681,Borger-Odoorn,2015JJ00,2015,12736,,102,,130,,-28,616,,33,583,633,,24,-2,609,-17,-44,,12692
123320,3000,Male,GM1681,Borger-Odoorn,2016JJ00,2016,12692,,79,,133,,-54,686,,48,638,677,,28,-1,649,9,-46,,12646
123321,3000,Male,GM1681,Borger-Odoorn,2017JJ00,2017,12646,,82,,148,,-66,791,,23,768,725,,22,1,703,66,0,,12646
123322,3000,Male,GM1681,Borger-Odoorn,2018JJ00,2018,12646,,108,,132,,-24,750,,29,721,670,,25,6,645,80,57,,12703
123323,3000,Male,GM1681,Borger-Odoorn,2019JJ00,2019,12703,,109,,134,,-25,826,,30,796,690,,31,-2,659,136,111,,12814
123324,3000,Male,GM1681,Borger-Odoorn,2020JJ00,2020,12814,,75,,141,,-66,792,,28,764,728,,37,-3,691,64,-2,,12812
123325,3000,Male,GM1681,Borger-Odoorn,2021JJ00,2021,12812,,113,,149,,-36,731,,28,703,638,,16,-1,622,93,60,,12872
123326,3000,Male,GM1681,Borger-Odoorn,2022JJ00,2022,12872,,87,,161,,-74,776,,96,680,570,,33,-3,537,206,132,,13004
123327,3000,Male,GM1681,Borger-Odoorn,2023JJ00,2023,13004,,95,,143,,-48,766,,75,691,661,,49,-4,612,105,57,,13061
123562,3000,Male,GM0147,Borne,2012JJ00,2012,10800,,114,,85,,29,474,,35,439,457,,71,-44,386,17,47,,10847
123563,3000,Male,GM0147,Borne,2013JJ00,2013,10847,,105,,96,,9,395,,28,367,355,,25,-4,330,40,50,,10897
123564,3000,Male,GM0147,Borne,2014JJ00,2014,10897,,110,,92,,18,408,,15,393,375,,34,-9,341,33,51,,10948
123565,3000,Male,GM0147,Borne,2015JJ00,2015,10948,,126,,89,,37,882,,384,498,654,,19,6,635,228,265,,11213
123566,3000,Male,GM0147,Borne,2016JJ00,2016,11213,,107,,100,,7,971,,245,726,780,,40,-15,740,191,198,,11411
123567,3000,Male,GM0147,Borne,2017JJ00,2017,11411,,131,,110,,21,789,,81,708,709,,52,-22,657,80,100,,11511
123568,3000,Male,GM0147,Borne,2018JJ00,2018,11511,,122,,97,,25,507,,36,471,482,,46,-15,436,25,50,,11561
123569,3000,Male,GM0147,Borne,2019JJ00,2019,11561,,132,,112,,20,663,,125,538,602,,41,-8,561,61,83,,11644
123570,3000,Male,GM0147,Borne,2020JJ00,2020,11644,,114,,130,,-16,664,,34,630,499,,43,-21,456,165,149,,11793
123571,3000,Male,GM0147,Borne,2021JJ00,2021,11793,,139,,121,,18,632,,27,605,482,,23,0,459,150,170,,11963
123572,3000,Male,GM0147,Borne,2022JJ00,2022,11963,,141,,142,,-1,654,,164,490,468,,43,-14,425,186,185,,12148
123573,3000,Male,GM0147,Borne,2023JJ00,2023,12148,,122,,105,,17,601,,66,535,516,,42,-4,474,85,101,,12249
123644,3000,Male,GM0654,Borsele,2012JJ00,2012,11491,,117,,97,,20,381,,36,345,425,,47,-17,378,-44,-29,,11462
123645,3000,Male,GM0654,Borsele,2013JJ00,2013,11462,,117,,91,,26,368,,32,336,450,,31,-1,419,-82,-53,,11409
123646,3000,Male,GM0654,Borsele,2014JJ00,2014,11409,,120,,84,,36,410,,35,375,438,,40,0,398,-28,8,,11417
123647,3000,Male,GM0654,Borsele,2015JJ00,2015,11417,,106,,89,,17,434,,44,390,423,,35,-2,388,11,26,,11443
123648,3000,Male,GM0654,Borsele,2016JJ00,2016,11443,,124,,81,,43,439,,35,404,453,,41,-6,412,-14,28,,11471
123649,3000,Male,GM0654,Borsele,2017JJ00,2017,11471,,119,,80,,39,532,,49,483,517,,42,-1,475,15,55,,11526
123650,3000,Male,GM0654,Borsele,2018JJ00,2018,11526,,108,,109,,-1,551,,72,479,519,,47,-12,472,32,31,,11557
123651,3000,Male,GM0654,Borsele,2019JJ00,2019,11557,,122,,92,,30,466,,53,413,504,,43,-4,461,-38,-8,,11549
123652,3000,Male,GM0654,Borsele,2020JJ00,2020,11549,,110,,92,,18,486,,47,439,479,,35,2,444,7,26,,11575
123653,3000,Male,GM0654,Borsele,2021JJ00,2021,11575,,113,,121,,-8,497,,46,451,465,,34,-2,431,32,24,,11599
123654,3000,Male,GM0654,Borsele,2022JJ00,2022,11599,,124,,109,,15,626,,106,520,478,,56,-10,422,148,163,,11762
123655,3000,Male,GM0654,Borsele,2023JJ00,2023,11762,,119,,107,,12,512,,84,428,542,,63,-6,479,-30,-19,,11743
123808,3000,Male,GM0499,Boskoop,2012JJ00,2012,7525,,84,,52,,32,273,,51,222,261,,40,2,221,12,45,,7570
123809,3000,Male,GM0499,Boskoop,2013JJ00,2013,7570,,75,,68,,7,262,,53,209,261,,31,2,230,1,5,,7575
123972,3000,Male,GM0756,Boxmeer,2012JJ00,2012,14192,,105,,118,,-13,481,,57,424,569,,58,-11,511,-88,-102,,14090
123973,3000,Male,GM0756,Boxmeer,2013JJ00,2013,14090,,100,,90,,10,468,,57,411,499,,78,-3,421,-31,-20,,14070
123974,3000,Male,GM0756,Boxmeer,2014JJ00,2014,14070,,98,,114,,-16,726,,319,407,546,,61,-2,485,180,163,,14233
123975,3000,Male,GM0756,Boxmeer,2015JJ00,2015,14233,,128,,101,,27,1136,,648,488,1047,,35,12,1012,89,116,,14349
123976,3000,Male,GM0756,Boxmeer,2016JJ00,2016,14349,,120,,127,,-7,1160,,467,693,1036,,52,0,984,124,120,,14469
123977,3000,Male,GM0756,Boxmeer,2017JJ00,2017,14469,,110,,131,,-21,888,,139,749,795,,91,-43,704,93,73,,14542
123978,3000,Male,GM0756,Boxmeer,2018JJ00,2018,14542,,114,,127,,-13,826,,171,655,781,,107,-39,674,45,31,,14573
123979,3000,Male,GM0756,Boxmeer,2019JJ00,2019,14573,,117,,136,,-19,873,,217,656,674,,106,-55,568,199,181,,14754
123980,3000,Male,GM0756,Boxmeer,2020JJ00,2020,14754,,125,,164,,-39,915,,94,821,740,,62,-11,678,175,136,,14890
123981,3000,Male,GM0756,Boxmeer,2021JJ00,2021,14890,,154,,138,,16,897,,79,818,864,,64,-16,800,33,57,,14947
124054,3000,Male,GM0757,Boxtel,2012JJ00,2012,14988,,135,,120,,15,575,,91,484,483,,54,-10,429,92,108,,15096
124055,3000,Male,GM0757,Boxtel,2013JJ00,2013,15096,,114,,124,,-10,556,,91,465,582,,84,-11,498,-26,-36,,15060
124056,3000,Male,GM0757,Boxtel,2014JJ00,2014,15060,,128,,125,,3,600,,99,501,607,,79,-22,528,-7,0,,15060
124057,3000,Male,GM0757,Boxtel,2015JJ00,2015,15060,,133,,146,,-13,664,,115,549,585,,86,-13,499,79,66,,15126
124058,3000,Male,GM0757,Boxtel,2016JJ00,2016,15126,,152,,161,,-9,764,,130,634,646,,85,-13,561,118,105,,15231
124059,3000,Male,GM0757,Boxtel,2017JJ00,2017,15231,,126,,139,,-13,698,,119,579,715,,95,-25,620,-17,-31,,15200
124060,3000,Male,GM0757,Boxtel,2018JJ00,2018,15200,,149,,160,,-11,773,,205,568,666,,88,-42,578,107,94,,15294
124061,3000,Male,GM0757,Boxtel,2019JJ00,2019,15294,,129,,144,,-15,726,,249,477,640,,106,-42,534,86,70,,15364
124062,3000,Male,GM0757,Boxtel,2020JJ00,2020,15364,,141,,195,,-54,770,,219,551,677,,102,-44,575,93,40,,15404
124063,3000,Male,GM0757,Boxtel,2021JJ00,2021,16444,,143,,199,,-56,869,,208,661,761,,160,-73,601,108,50,,16494
124064,3000,Male,GM0757,Boxtel,2022JJ00,2022,16494,,145,,188,,-43,1086,,298,788,713,,181,-66,532,373,333,,16827
124065,3000,Male,GM0757,Boxtel,2023JJ00,2023,16827,,139,,211,,-72,954,,200,754,773,,166,-83,607,181,114,,16941
124300,3000,Male,GM0758,Breda,2012JJ00,2012,85977,,936,,692,,244,4646,,1035,3611,3871,,851,-156,3020,775,1053,,87030
124301,3000,Male,GM0758,Breda,2013JJ00,2013,87030,,984,,756,,228,4563,,957,3606,4023,,732,-8,3291,540,765,,87795
124302,3000,Male,GM0758,Breda,2014JJ00,2014,87795,,959,,740,,219,4913,,1008,3905,4307,,893,-171,3414,606,825,,88620
124303,3000,Male,GM0758,Breda,2015JJ00,2015,88620,,995,,786,,209,5190,,1274,3916,4924,,846,-121,4078,266,471,,89091
124304,3000,Male,GM0758,Breda,2016JJ00,2016,89091,,938,,779,,159,5478,,1188,4290,5131,,893,-169,4238,347,503,,89594
124305,3000,Male,GM0758,Breda,2017JJ00,2017,89594,,957,,771,,186,5469,,1214,4255,4922,,878,-115,4044,547,734,,90328
124306,3000,Male,GM0758,Breda,2018JJ00,2018,90328,,913,,820,,93,5043,,1292,3751,4925,,920,-125,4005,118,208,,90536
124307,3000,Male,GM0758,Breda,2019JJ00,2019,90536,,856,,781,,75,4941,,1283,3658,4971,,1054,-228,3917,-30,33,,90569
124308,3000,Male,GM0758,Breda,2020JJ00,2020,90569,,834,,881,,-47,4876,,1104,3772,4783,,899,-170,3884,93,37,,90606
124309,3000,Male,GM0758,Breda,2021JJ00,2021,90606,,983,,891,,92,4844,,1123,3721,4549,,741,-31,3808,295,387,,90993
124310,3000,Male,GM0758,Breda,2022JJ00,2022,90993,,900,,835,,65,5484,,1661,3823,4608,,946,-137,3662,876,934,,91927
124311,3000,Male,GM0758,Breda,2023JJ00,2023,91927,,872,,895,,-23,5773,,1604,4169,4923,,1125,-182,3798,850,825,,92752
124792,3000,Male,GM0501,Brielle,2012JJ00,2012,7914,,61,,73,,-12,457,,79,378,358,,89,-19,269,99,87,,8001
124793,3000,Male,GM0501,Brielle,2013JJ00,2013,8001,,52,,55,,-3,322,,69,253,329,,64,2,265,-7,-10,,7991
124794,3000,Male,GM0501,Brielle,2014JJ00,2014,7991,,71,,77,,-6,408,,66,342,330,,57,5,273,78,69,,8060
124795,3000,Male,GM0501,Brielle,2015JJ00,2015,8060,,74,,67,,7,448,,71,377,354,,74,-6,280,94,103,,8163
124796,3000,Male,GM0501,Brielle,2016JJ00,2016,8163,,73,,88,,-15,524,,83,441,412,,82,-16,330,112,97,,8260
124797,3000,Male,GM0501,Brielle,2017JJ00,2017,8260,,59,,70,,-11,537,,62,475,402,,44,-4,358,135,122,,8382
124798,3000,Male,GM0501,Brielle,2018JJ00,2018,8382,,69,,75,,-6,486,,60,426,426,,65,-17,361,60,55,,8437
124799,3000,Male,GM0501,Brielle,2019JJ00,2019,8437,,84,,76,,8,479,,74,405,419,,39,1,380,60,67,,8504
124800,3000,Male,GM0501,Brielle,2020JJ00,2020,8504,,83,,94,,-11,522,,64,458,423,,38,-5,385,99,88,,8592
124801,3000,Male,GM0501,Brielle,2021JJ00,2021,8592,,83,,85,,-2,580,,84,496,433,,40,-9,393,147,144,,8736
124802,3000,Male,GM0501,Brielle,2022JJ00,2022,8736,,88,,95,,-7,531,,124,407,405,,64,-22,341,126,162,,8898
125120,3000,Male,GM1876,Bronckhorst,2012JJ00,2012,18598,,125,,183,,-58,536,,35,501,599,,30,-2,569,-63,-122,,18476
125121,3000,Male,GM1876,Bronckhorst,2013JJ00,2013,18476,,129,,180,,-51,530,,31,499,583,,41,1,542,-53,-104,,18372
125122,3000,Male,GM1876,Bronckhorst,2014JJ00,2014,18372,,125,,178,,-53,538,,32,506,585,,26,5,559,-47,-99,,18273
125123,3000,Male,GM1876,Bronckhorst,2015JJ00,2015,18273,,124,,177,,-53,636,,45,591,658,,26,7,632,-22,-75,,18198
125124,3000,Male,GM1876,Bronckhorst,2016JJ00,2016,18198,,120,,182,,-62,733,,44,689,716,,46,-3,670,17,-48,,18150
125125,3000,Male,GM1876,Bronckhorst,2017JJ00,2017,18150,,105,,178,,-73,778,,56,722,729,,40,-7,689,49,-26,,18124
125126,3000,Male,GM1876,Bronckhorst,2018JJ00,2018,18124,,130,,198,,-68,726,,51,675,728,,41,-3,687,-2,-70,,18054
125127,3000,Male,GM1876,Bronckhorst,2019JJ00,2019,18054,,120,,183,,-63,630,,35,595,667,,37,-4,630,-37,-99,,17955
125128,3000,Male,GM1876,Bronckhorst,2020JJ00,2020,17955,,124,,207,,-83,804,,55,749,670,,52,-11,618,134,52,,18007
125129,3000,Male,GM1876,Bronckhorst,2021JJ00,2021,18007,,125,,205,,-80,730,,43,687,621,,38,-4,583,109,30,,18037
125130,3000,Male,GM1876,Bronckhorst,2022JJ00,2022,18037,,119,,207,,-88,810,,146,664,639,,62,-2,577,171,83,,18120
125131,3000,Male,GM1876,Bronckhorst,2023JJ00,2023,18120,,117,,206,,-89,668,,103,565,661,,57,-2,604,7,-84,,18036
125366,3000,Male,GM0213,Brummen,2012JJ00,2012,10519,,87,,78,,9,352,,16,336,380,,23,4,357,-28,-19,,10500
125367,3000,Male,GM0213,Brummen,2013JJ00,2013,10500,,86,,85,,1,392,,25,367,419,,20,3,399,-27,-26,,10474
125368,3000,Male,GM0213,Brummen,2014JJ00,2014,10474,,71,,97,,-26,360,,32,328,433,,34,-1,399,-73,-100,,10374
125369,3000,Male,GM0213,Brummen,2015JJ00,2015,10374,,69,,97,,-28,405,,30,375,415,,29,2,386,-10,-41,,10333
125370,3000,Male,GM0213,Brummen,2016JJ00,2016,10333,,80,,116,,-36,475,,39,436,489,,18,0,471,-14,-51,,10282
125371,3000,Male,GM0213,Brummen,2017JJ00,2017,10282,,98,,88,,10,487,,42,445,500,,35,-7,465,-13,-1,,10281
125372,3000,Male,GM0213,Brummen,2018JJ00,2018,10281,,65,,97,,-32,474,,32,442,477,,21,-4,456,-3,-33,,10248
125373,3000,Male,GM0213,Brummen,2019JJ00,2019,10248,,71,,116,,-45,498,,34,464,451,,35,-12,416,47,3,,10251
125374,3000,Male,GM0213,Brummen,2020JJ00,2020,10251,,83,,110,,-27,570,,36,534,419,,29,-5,390,151,123,,10374
125375,3000,Male,GM0213,Brummen,2021JJ00,2021,10374,,72,,118,,-46,502,,26,476,462,,26,1,436,40,-6,,10368
125376,3000,Male,GM0213,Brummen,2022JJ00,2022,10368,,94,,158,,-64,508,,67,441,364,,25,-2,339,144,80,,10448
125377,3000,Male,GM0213,Brummen,2023JJ00,2023,10448,,85,,131,,-46,579,,40,539,424,,36,0,388,155,110,,10558
125448,3000,Male,GM0899,Brunssum,2012JJ00,2012,14233,,126,,165,,-39,585,,69,516,636,,31,22,605,-51,-92,,14141
125449,3000,Male,GM0899,Brunssum,2013JJ00,2013,14141,,119,,166,,-47,626,,77,549,604,,65,10,539,22,-25,,14116
125450,3000,Male,GM0899,Brunssum,2014JJ00,2014,14116,,125,,175,,-50,590,,63,527,670,,99,-21,571,-80,-128,,13988
125451,3000,Male,GM0899,Brunssum,2015JJ00,2015,13988,,107,,180,,-73,645,,63,582,690,,70,-10,620,-45,-117,,13871
125452,3000,Male,GM0899,Brunssum,2016JJ00,2016,13871,,97,,184,,-87,691,,63,628,603,,56,2,547,88,2,,13873
125453,3000,Male,GM0899,Brunssum,2017JJ00,2017,13873,,127,,198,,-71,703,,71,632,684,,56,0,628,19,-55,,13818
125454,3000,Male,GM0899,Brunssum,2018JJ00,2018,13818,,118,,177,,-59,773,,90,683,726,,72,-3,654,47,-12,,13806
125455,3000,Male,GM0899,Brunssum,2019JJ00,2019,13806,,112,,150,,-38,730,,84,646,791,,79,-18,712,-61,-100,,13706
125456,3000,Male,GM0899,Brunssum,2020JJ00,2020,13706,,89,,196,,-107,766,,86,680,740,,78,-12,662,26,-82,,13624
125457,3000,Male,GM0899,Brunssum,2021JJ00,2021,13624,,103,,197,,-94,813,,82,731,699,,60,3,639,114,19,,13643
125458,3000,Male,GM0899,Brunssum,2022JJ00,2022,13643,,99,,199,,-100,785,,123,662,730,,98,-28,632,55,-44,,13599
125459,3000,Male,GM0899,Brunssum,2023JJ00,2023,13599,,107,,196,,-89,795,,129,666,640,,96,-16,544,155,64,,13663
125776,3000,Male,GM0312,Bunnik,2012JJ00,2012,7141,,65,,65,,0,380,,23,357,328,,29,-7,299,52,53,,7194
125777,3000,Male,GM0312,Bunnik,2013JJ00,2013,7194,,64,,41,,23,359,,27,332,345,,41,0,304,14,39,,7233
125778,3000,Male,GM0312,Bunnik,2014JJ00,2014,7233,,64,,57,,7,443,,32,411,440,,35,-2,405,3,11,,7244
125779,3000,Male,GM0312,Bunnik,2015JJ00,2015,7244,,75,,52,,23,423,,39,384,388,,23,0,365,35,60,,7304
125780,3000,Male,GM0312,Bunnik,2016JJ00,2016,7304,,82,,54,,28,553,,37,516,379,,31,-2,348,174,201,,7505
125781,3000,Male,GM0312,Bunnik,2017JJ00,2017,7505,,69,,55,,14,411,,29,382,399,,28,-4,371,12,25,,7530
125782,3000,Male,GM0312,Bunnik,2018JJ00,2018,7530,,66,,49,,17,395,,35,360,425,,32,-9,393,-30,-12,,7518
125783,3000,Male,GM0312,Bunnik,2019JJ00,2019,7518,,83,,45,,38,361,,38,323,390,,24,-9,366,-29,8,,7526
125784,3000,Male,GM0312,Bunnik,2020JJ00,2020,7526,,60,,67,,-7,478,,31,447,402,,39,-8,363,76,70,,7596
125785,3000,Male,GM0312,Bunnik,2021JJ00,2021,7596,,71,,78,,-7,503,,40,463,384,,22,-4,362,119,113,,7709
125786,3000,Male,GM0312,Bunnik,2022JJ00,2022,7709,,67,,63,,4,586,,104,482,387,,25,3,362,199,203,,7912
125787,3000,Male,GM0312,Bunnik,2023JJ00,2023,7912,,70,,78,,-8,457,,58,399,408,,45,-10,363,49,39,,7951
125858,3000,Male,GM0313,Bunschoten,2012JJ00,2012,10118,,149,,63,,86,184,,35,149,205,,44,-14,161,-21,64,,10182
125859,3000,Male,GM0313,Bunschoten,2013JJ00,2013,10182,,124,,73,,51,221,,98,123,192,,25,-2,167,29,81,,10263
125860,3000,Male,GM0313,Bunschoten,2014JJ00,2014,10263,,134,,69,,65,248,,101,147,257,,64,-11,193,-9,58,,10321
125861,3000,Male,GM0313,Bunschoten,2015JJ00,2015,10321,,130,,68,,62,289,,78,211,277,,77,-12,200,12,74,,10395
125862,3000,Male,GM0313,Bunschoten,2016JJ00,2016,10395,,113,,64,,49,357,,139,218,310,,78,-15,232,47,98,,10493
125863,3000,Male,GM0313,Bunschoten,2017JJ00,2017,10493,,146,,67,,79,321,,85,236,273,,57,-11,216,48,127,,10620
125864,3000,Male,GM0313,Bunschoten,2018JJ00,2018,10620,,136,,74,,62,385,,132,253,302,,106,-24,196,83,144,,10764
125865,3000,Male,GM0313,Bunschoten,2019JJ00,2019,10764,,146,,77,,69,376,,129,247,309,,59,0,250,67,134,,10898
125866,3000,Male,GM0313,Bunschoten,2020JJ00,2020,10898,,129,,103,,26,340,,104,236,289,,74,-27,215,51,76,,10974
125867,3000,Male,GM0313,Bunschoten,2021JJ00,2021,10974,,156,,70,,86,390,,93,297,312,,62,-18,250,78,165,,11139
125868,3000,Male,GM0313,Bunschoten,2022JJ00,2022,11139,,132,,104,,28,365,,127,238,333,,95,-14,238,32,62,,11201
125869,3000,Male,GM0313,Bunschoten,2023JJ00,2023,11201,,123,,77,,46,367,,91,276,323,,79,-23,244,44,89,,11290
125940,3000,Male,GM0214,Buren,2012JJ00,2012,12984,,119,,113,,6,468,,50,418,482,,31,-11,451,-14,-8,,12976
125941,3000,Male,GM0214,Buren,2013JJ00,2013,12976,,128,,111,,17,530,,48,482,534,,49,3,485,-4,13,,12989
125942,3000,Male,GM0214,Buren,2014JJ00,2014,12989,,120,,94,,26,582,,68,514,535,,49,-4,486,47,72,,13061
125943,3000,Male,GM0214,Buren,2015JJ00,2015,13061,,113,,116,,-3,604,,51,553,556,,43,-4,513,48,48,,13109
125944,3000,Male,GM0214,Buren,2016JJ00,2016,13109,,131,,95,,36,736,,60,676,667,,48,-11,619,69,103,,13212
125945,3000,Male,GM0214,Buren,2017JJ00,2017,13212,,101,,105,,-4,759,,54,705,748,,45,-8,703,11,7,,13219
125946,3000,Male,GM0214,Buren,2018JJ00,2018,13219,,94,,96,,-2,738,,58,680,640,,42,-9,598,98,95,,13314
125947,3000,Male,GM0214,Buren,2019JJ00,2019,13314,,127,,104,,23,769,,68,701,682,,63,-15,619,87,111,,13425
125948,3000,Male,GM0214,Buren,2020JJ00,2020,13425,,127,,129,,-2,855,,82,773,692,,46,-7,646,163,161,,13586
125949,3000,Male,GM0214,Buren,2021JJ00,2021,13586,,130,,150,,-20,772,,77,695,683,,63,-18,620,89,71,,13657
125950,3000,Male,GM0214,Buren,2022JJ00,2022,13657,,105,,125,,-20,979,,217,762,696,,83,-11,613,283,260,,13917
125951,3000,Male,GM0214,Buren,2023JJ00,2023,13917,,132,,112,,20,789,,182,607,776,,141,-51,635,13,36,,13953
126104,3000,Male,GM0381,Bussum,2012JJ00,2012,15472,,159,,149,,10,987,,125,862,916,,96,-16,820,71,79,,15551
126105,3000,Male,GM0381,Bussum,2013JJ00,2013,15551,,153,,141,,12,1017,,133,884,1001,,140,-29,861,16,29,,15580
126106,3000,Male,GM0381,Bussum,2014JJ00,2014,15580,,176,,145,,31,1213,,126,1087,1107,,147,-20,960,106,136,,15716
126107,3000,Male,GM0381,Bussum,2015JJ00,2015,15716,,154,,149,,5,1289,,145,1144,1160,,153,-29,1007,129,139,,15855
126514,3000,Male,GM0502,Capelle aan den IJssel,2012JJ00,2012,31923,,385,,284,,101,1767,,238,1529,1902,,295,-68,1607,-135,-31,,31892
126515,3000,Male,GM0502,Capelle aan den IJssel,2013JJ00,2013,31892,,360,,279,,81,1867,,234,1633,1865,,346,-90,1519,2,81,,31973
126516,3000,Male,GM0502,Capelle aan den IJssel,2014JJ00,2014,31973,,408,,238,,170,1901,,257,1644,1915,,307,-78,1608,-14,157,,32130
126517,3000,Male,GM0502,Capelle aan den IJssel,2015JJ00,2015,32130,,353,,288,,65,2032,,291,1741,2075,,351,-95,1724,-43,22,,32152
126518,3000,Male,GM0502,Capelle aan den IJssel,2016JJ00,2016,32152,,343,,269,,74,2102,,275,1827,2248,,436,-148,1812,-146,-72,,32080
126519,3000,Male,GM0502,Capelle aan den IJssel,2017JJ00,2017,32080,,353,,263,,90,2274,,263,2011,2087,,281,-41,1806,187,275,,32355
126520,3000,Male,GM0502,Capelle aan den IJssel,2018JJ00,2018,32355,,330,,280,,50,2140,,294,1846,2275,,283,-77,1992,-135,-84,,32271
126521,3000,Male,GM0502,Capelle aan den IJssel,2019JJ00,2019,32271,,337,,273,,64,2191,,344,1847,2018,,260,-47,1758,173,234,,32505
126522,3000,Male,GM0502,Capelle aan den IJssel,2020JJ00,2020,32505,,315,,305,,10,2201,,261,1940,2144,,222,-11,1922,57,65,,32570
126523,3000,Male,GM0502,Capelle aan den IJssel,2021JJ00,2021,32570,,372,,339,,33,2175,,314,1861,2246,,247,-54,1999,-71,-39,,32531
126524,3000,Male,GM0502,Capelle aan den IJssel,2022JJ00,2022,32531,,359,,326,,33,2348,,477,1871,2211,,272,-53,1939,137,164,,32695
126525,3000,Male,GM0502,Capelle aan den IJssel,2023JJ00,2023,32695,,348,,363,,-15,2480,,517,1963,2278,,274,-27,2004,202,184,,32879
126596,3000,Male,GM0383,Castricum,2012JJ00,2012,16853,,123,,135,,-12,565,,67,498,560,,75,-19,485,5,-9,,16844
126597,3000,Male,GM0383,Castricum,2013JJ00,2013,16844,,141,,153,,-12,502,,51,451,536,,48,2,488,-34,-48,,16796
126598,3000,Male,GM0383,Castricum,2014JJ00,2014,16796,,120,,159,,-39,661,,53,608,574,,38,3,536,87,45,,16841
126599,3000,Male,GM0383,Castricum,2015JJ00,2015,16841,,136,,182,,-46,715,,52,663,566,,46,0,520,149,104,,16945
126600,3000,Male,GM0383,Castricum,2016JJ00,2016,16945,,147,,153,,-6,947,,62,885,633,,61,2,572,314,309,,17254
126601,3000,Male,GM0383,Castricum,2017JJ00,2017,17254,,144,,176,,-32,924,,70,854,655,,57,0,598,269,236,,17490
126602,3000,Male,GM0383,Castricum,2018JJ00,2018,17490,,147,,168,,-21,752,,87,665,586,,64,-13,522,166,144,,17634
126603,3000,Male,GM0383,Castricum,2019JJ00,2019,17634,,156,,159,,-3,759,,64,695,637,,59,-3,578,122,120,,17754
126604,3000,Male,GM0383,Castricum,2020JJ00,2020,17754,,157,,168,,-11,844,,64,780,784,,53,-5,731,60,52,,17806
126605,3000,Male,GM0383,Castricum,2021JJ00,2021,17806,,170,,192,,-22,779,,57,722,678,,60,-2,618,101,78,,17884
126606,3000,Male,GM0383,Castricum,2022JJ00,2022,17884,,134,,205,,-71,790,,111,679,699,,83,-9,616,91,19,,17903
126607,3000,Male,GM0383,Castricum,2023JJ00,2023,17903,,146,,194,,-48,772,,81,691,710,,91,-6,619,62,17,,17920
126842,3000,Male,GM0109,Coevorden,2012JJ00,2012,17914,,162,,193,,-31,798,,184,614,872,,98,-41,774,-74,-104,,17810
126843,3000,Male,GM0109,Coevorden,2013JJ00,2013,17810,,139,,179,,-40,814,,204,610,825,,120,-80,705,-11,-50,,17760
126844,3000,Male,GM0109,Coevorden,2014JJ00,2014,17760,,153,,181,,-28,854,,289,565,900,,78,-24,822,-46,-71,,17689
126845,3000,Male,GM0109,Coevorden,2015JJ00,2015,17689,,146,,188,,-42,1006,,266,740,1014,,88,-20,926,-8,-46,,17643
126846,3000,Male,GM0109,Coevorden,2016JJ00,2016,17643,,155,,208,,-53,973,,235,738,973,,64,-9,909,0,-49,,17594
126847,3000,Male,GM0109,Coevorden,2017JJ00,2017,17594,,135,,180,,-45,1056,,117,939,1042,,61,-5,981,14,-28,,17566
126848,3000,Male,GM0109,Coevorden,2018JJ00,2018,17566,,148,,183,,-35,1065,,114,951,895,,56,5,839,170,137,,17703
126849,3000,Male,GM0109,Coevorden,2019JJ00,2019,17703,,153,,197,,-44,979,,75,904,1046,,154,-89,892,-67,-110,,17593
126850,3000,Male,GM0109,Coevorden,2020JJ00,2020,17593,,150,,202,,-52,974,,67,907,890,,70,-18,820,84,33,,17626
126851,3000,Male,GM0109,Coevorden,2021JJ00,2021,17626,,154,,218,,-64,1055,,47,1008,852,,57,-28,795,203,142,,17768
126852,3000,Male,GM0109,Coevorden,2022JJ00,2022,17768,,134,,205,,-71,988,,167,821,810,,81,-7,729,178,109,,17877
126853,3000,Male,GM0109,Coevorden,2023JJ00,2023,17877,,124,,206,,-82,1083,,107,976,905,,97,-12,808,178,98,,17975
127006,3000,Male,GM1706,Cranendonck,2012JJ00,2012,10338,,111,,85,,26,259,,48,211,363,,63,-13,300,-104,-79,,10259
127007,3000,Male,GM1706,Cranendonck,2013JJ00,2013,10259,,92,,92,,0,321,,60,261,319,,70,-9,249,2,4,,10263
127008,3000,Male,GM1706,Cranendonck,2014JJ00,2014,10263,,87,,86,,1,463,,190,273,392,,78,-23,314,71,74,,10337
127009,3000,Male,GM1706,Cranendonck,2015JJ00,2015,10337,,85,,83,,2,624,,348,276,543,,39,-1,504,81,82,,10419
127010,3000,Male,GM1706,Cranendonck,2016JJ00,2016,10419,,97,,112,,-15,3011,,2335,676,3015,,57,1,2958,-4,-15,,10404
127011,3000,Male,GM1706,Cranendonck,2017JJ00,2017,10404,,85,,97,,-12,1922,,1590,332,2108,,92,-36,2016,-186,-197,,10207
127012,3000,Male,GM1706,Cranendonck,2018JJ00,2018,10207,,90,,106,,-16,756,,456,300,664,,45,7,619,92,74,,10281
127013,3000,Male,GM1706,Cranendonck,2019JJ00,2019,10281,,75,,94,,-19,1633,,1209,424,1246,,55,3,1191,387,375,,10656
127014,3000,Male,GM1706,Cranendonck,2020JJ00,2020,10656,,98,,129,,-31,2589,,2181,408,2569,,57,6,2512,20,-1,,10655
127015,3000,Male,GM1706,Cranendonck,2021JJ00,2021,10655,,74,,120,,-46,3173,,2814,359,3346,,49,14,3297,-173,-209,,10446
127016,3000,Male,GM1706,Cranendonck,2022JJ00,2022,10446,,93,,83,,10,4375,,3932,443,4305,,102,-10,4203,70,89,,10535
127017,3000,Male,GM1706,Cranendonck,2023JJ00,2023,10535,,99,,110,,-11,6330,,5818,512,6295,,91,-23,6204,35,40,,10575
127088,3000,Male,GM0611,Cromstrijen,2012JJ00,2012,6345,,53,,46,,7,183,,15,168,204,,29,-6,175,-21,-14,,6331
127089,3000,Male,GM0611,Cromstrijen,2013JJ00,2013,6331,,47,,47,,0,217,,10,207,216,,26,-7,190,1,0,,6331
127090,3000,Male,GM0611,Cromstrijen,2014JJ00,2014,6331,,54,,51,,3,230,,19,211,188,,12,-1,176,42,43,,6374
127091,3000,Male,GM0611,Cromstrijen,2015JJ00,2015,6374,,44,,49,,-5,197,,19,178,233,,26,-8,207,-36,-41,,6333
127092,3000,Male,GM0611,Cromstrijen,2016JJ00,2016,6333,,55,,61,,-6,243,,13,230,226,,8,6,218,17,12,,6345
127093,3000,Male,GM0611,Cromstrijen,2017JJ00,2017,6345,,45,,69,,-24,264,,13,251,236,,8,0,228,28,2,,6347
127094,3000,Male,GM0611,Cromstrijen,2018JJ00,2018,6347,,46,,52,,-6,303,,14,289,237,,14,0,223,66,56,,6403
127170,3000,Male,GM1684,Cuijk,2012JJ00,2012,12328,,121,,103,,18,418,,67,351,410,,68,-10,342,8,26,,12354
127171,3000,Male,GM1684,Cuijk,2013JJ00,2013,12354,,129,,103,,26,374,,54,320,380,,48,4,332,-6,22,,12376
127172,3000,Male,GM1684,Cuijk,2014JJ00,2014,12376,,143,,106,,37,403,,46,357,497,,66,8,431,-94,-58,,12318
127173,3000,Male,GM1684,Cuijk,2015JJ00,2015,12318,,104,,122,,-18,458,,60,398,530,,122,-41,408,-72,-89,,12229
127174,3000,Male,GM1684,Cuijk,2016JJ00,2016,12229,,115,,117,,-2,534,,70,464,452,,68,-15,384,82,81,,12310
127175,3000,Male,GM1684,Cuijk,2017JJ00,2017,12310,,101,,107,,-6,610,,79,531,505,,57,-21,448,105,98,,12408
127176,3000,Male,GM1684,Cuijk,2018JJ00,2018,12408,,123,,104,,19,547,,66,481,561,,86,-18,475,-14,5,,12413
127177,3000,Male,GM1684,Cuijk,2019JJ00,2019,12413,,114,,110,,4,613,,86,527,479,,74,-17,405,134,140,,12553
127178,3000,Male,GM1684,Cuijk,2020JJ00,2020,12553,,119,,143,,-24,661,,78,583,501,,54,-7,447,160,136,,12689
127179,3000,Male,GM1684,Cuijk,2021JJ00,2021,12689,,120,,126,,-6,591,,83,508,450,,62,-10,388,141,135,,12824
127334,3000,Male,GM0216,Culemborg,2012JJ00,2012,13687,,167,,100,,67,490,,65,425,501,,50,2,451,-11,57,,13744
127335,3000,Male,GM0216,Culemborg,2013JJ00,2013,13744,,133,,90,,43,435,,52,383,539,,69,-13,470,-104,-62,,13682
127336,3000,Male,GM0216,Culemborg,2014JJ00,2014,13682,,120,,99,,21,525,,55,470,566,,57,-2,509,-41,-20,,13662
127337,3000,Male,GM0216,Culemborg,2015JJ00,2015,13662,,135,,113,,22,595,,73,522,549,,80,-22,469,46,69,,13731
127338,3000,Male,GM0216,Culemborg,2016JJ00,2016,13731,,119,,96,,23,748,,54,694,642,,90,-34,552,106,130,,13861
127339,3000,Male,GM0216,Culemborg,2017JJ00,2017,13861,,145,,105,,40,733,,65,668,667,,55,-5,612,66,108,,13969
127340,3000,Male,GM0216,Culemborg,2018JJ00,2018,13969,,145,,115,,30,732,,89,643,583,,36,7,547,149,178,,14147
127341,3000,Male,GM0216,Culemborg,2019JJ00,2019,14147,,148,,117,,31,837,,126,711,642,,43,2,599,195,227,,14374
127342,3000,Male,GM0216,Culemborg,2020JJ00,2020,14374,,147,,119,,28,704,,76,628,668,,80,-25,588,36,63,,14437
127343,3000,Male,GM0216,Culemborg,2021JJ00,2021,14437,,197,,120,,77,713,,84,629,656,,53,-9,603,57,134,,14571
127344,3000,Male,GM0216,Culemborg,2022JJ00,2022,14571,,148,,122,,26,811,,91,720,658,,62,-4,596,153,180,,14751
127345,3000,Male,GM0216,Culemborg,2023JJ00,2023,14751,,145,,116,,29,730,,89,641,684,,62,-18,622,46,75,,14826
127498,3000,Male,GM0148,Dalfsen,2012JJ00,2012,13933,,139,,100,,39,422,,52,370,408,,42,-5,366,14,53,,13986
127499,3000,Male,GM0148,Dalfsen,2013JJ00,2013,13986,,144,,127,,17,402,,37,365,390,,38,-5,352,12,30,,14016
127500,3000,Male,GM0148,Dalfsen,2014JJ00,2014,14016,,130,,109,,21,445,,38,407,472,,46,-11,426,-27,-5,,14011
127501,3000,Male,GM0148,Dalfsen,2015JJ00,2015,14011,,165,,105,,60,525,,41,484,458,,46,-5,412,67,127,,14138
127502,3000,Male,GM0148,Dalfsen,2016JJ00,2016,14138,,118,,104,,14,523,,35,488,454,,38,-3,416,69,82,,14220
127503,3000,Male,GM0148,Dalfsen,2017JJ00,2017,14220,,151,,130,,21,598,,38,560,558,,47,-5,511,40,59,,14279
127504,3000,Male,GM0148,Dalfsen,2018JJ00,2018,14279,,142,,113,,29,583,,55,528,499,,30,-1,469,84,116,,14395
127505,3000,Male,GM0148,Dalfsen,2019JJ00,2019,14395,,137,,113,,24,504,,30,474,481,,28,0,453,23,46,,14441
127506,3000,Male,GM0148,Dalfsen,2020JJ00,2020,14441,,140,,144,,-4,643,,48,595,478,,40,-3,438,165,162,,14603
127507,3000,Male,GM0148,Dalfsen,2021JJ00,2021,14603,,150,,133,,17,586,,38,548,457,,31,-1,426,129,148,,14751
127508,3000,Male,GM0148,Dalfsen,2022JJ00,2022,14751,,145,,148,,-3,674,,176,498,472,,73,-4,399,202,199,,14950
127509,3000,Male,GM0148,Dalfsen,2023JJ00,2023,14950,,121,,165,,-44,647,,128,519,560,,60,0,500,87,42,,14992
127662,3000,Male,GM1891,Dantumadiel,2012JJ00,2012,9646,,87,,80,,7,254,,10,244,322,,16,0,306,-68,-62,,9584
127663,3000,Male,GM1891,Dantumadiel,2013JJ00,2013,9584,,89,,89,,0,286,,9,277,329,,10,2,319,-43,-43,,9541
127664,3000,Male,GM1891,Dantumadiel,2014JJ00,2014,9541,,100,,95,,5,296,,14,282,287,,7,2,280,9,14,,9555
127665,3000,Male,GM1891,Dantumadiel,2015JJ00,2015,9555,,85,,90,,-5,325,,8,317,341,,11,1,330,-16,-21,,9534
127666,3000,Male,GM1891,Dantumadiel,2016JJ00,2016,9534,,105,,74,,31,335,,16,319,365,,12,2,353,-30,2,,9536
127667,3000,Male,GM1891,Dantumadiel,2017JJ00,2017,9536,,89,,106,,-17,345,,14,331,350,,10,1,340,-5,-21,,9515
127668,3000,Male,GM1891,Dantumadiel,2018JJ00,2018,9515,,83,,108,,-25,395,,14,381,371,,20,-3,351,24,0,,9515
127669,3000,Male,GM1891,Dantumadiel,2019JJ00,2019,9515,,93,,100,,-7,393,,13,380,369,,9,1,360,24,16,,9531
127670,3000,Male,GM1891,Dantumadiel,2020JJ00,2020,9531,,98,,103,,-5,355,,11,344,353,,9,0,344,2,-2,,9529
127671,3000,Male,GM1891,Dantumadiel,2021JJ00,2021,9529,,81,,137,,-56,392,,20,372,318,,11,-2,307,74,18,,9547
127672,3000,Male,GM1891,Dantumadiel,2022JJ00,2022,9547,,93,,94,,-1,456,,92,364,364,,35,-8,329,92,91,,9638
127673,3000,Male,GM1891,Dantumadiel,2023JJ00,2023,9638,,96,,124,,-28,433,,94,339,414,,39,0,375,19,-9,,9629
127826,3000,Male,GM0503,Delft,2012JJ00,2012,52300,,499,,361,,138,4914,,1780,3134,4708,,1559,-537,3149,206,335,,52635
127827,3000,Male,GM0503,Delft,2013JJ00,2013,52635,,484,,341,,143,5296,,1925,3371,4672,,1478,-359,3194,624,758,,53393
127828,3000,Male,GM0503,Delft,2014JJ00,2014,53393,,481,,354,,127,5642,,2069,3573,5112,,1629,-395,3483,530,642,,54035
127829,3000,Male,GM0503,Delft,2015JJ00,2015,54035,,469,,367,,102,5544,,2269,3275,5737,,2114,-741,3623,-193,-97,,53938
127830,3000,Male,GM0503,Delft,2016JJ00,2016,53938,,487,,348,,139,5611,,2311,3300,5683,,1843,-520,3840,-72,57,,53995
127831,3000,Male,GM0503,Delft,2017JJ00,2017,53995,,441,,377,,64,6315,,2568,3747,5915,,1946,-519,3969,400,453,,54448
127832,3000,Male,GM0503,Delft,2018JJ00,2018,54448,,477,,392,,85,6174,,2648,3526,5864,,1814,-319,4050,310,383,,54831
127833,3000,Male,GM0503,Delft,2019JJ00,2019,54831,,459,,351,,108,6046,,2583,3463,6250,,1972,-381,4278,-204,-98,,54733
127834,3000,Male,GM0503,Delft,2020JJ00,2020,54733,,448,,410,,38,6163,,2217,3946,6266,,1911,-405,4355,-103,-76,,54657
127835,3000,Male,GM0503,Delft,2021JJ00,2021,54657,,485,,384,,101,6711,,2613,4098,6215,,1554,-282,4661,496,591,,55248
127836,3000,Male,GM0503,Delft,2022JJ00,2022,55248,,402,,391,,11,6783,,2863,3920,5988,,1578,-194,4410,795,804,,56052
127837,3000,Male,GM0503,Delft,2023JJ00,2023,56052,,447,,400,,47,8199,,2784,5415,6183,,1744,-222,4439,2016,2056,,58108
127908,3000,Male,GM0010,Delfzijl,2012JJ00,2012,13155,,123,,155,,-32,653,,188,465,747,,144,-96,603,-94,-123,,13032
127909,3000,Male,GM0010,Delfzijl,2013JJ00,2013,13032,,103,,162,,-59,596,,188,408,706,,117,-53,589,-110,-169,,12863
127910,3000,Male,GM0010,Delfzijl,2014JJ00,2014,12863,,92,,148,,-56,820,,372,448,857,,88,-33,769,-37,-92,,12771
127911,3000,Male,GM0010,Delfzijl,2015JJ00,2015,12771,,95,,154,,-59,798,,298,500,944,,110,-51,834,-146,-200,,12571
127912,3000,Male,GM0010,Delfzijl,2016JJ00,2016,12571,,115,,170,,-55,955,,226,729,910,,71,-26,839,45,-11,,12560
127913,3000,Male,GM0010,Delfzijl,2017JJ00,2017,12560,,109,,159,,-50,768,,100,668,804,,88,-47,716,-36,-85,,12475
127914,3000,Male,GM0010,Delfzijl,2018JJ00,2018,12475,,112,,171,,-59,746,,170,576,753,,79,-21,674,-7,-67,,12408
127915,3000,Male,GM0010,Delfzijl,2019JJ00,2019,12408,,118,,157,,-39,791,,186,605,737,,81,-22,656,54,21,,12429
127916,3000,Male,GM0010,Delfzijl,2020JJ00,2020,12429,,117,,188,,-71,755,,162,593,702,,71,-6,631,53,-27,,12402
128072,3000,Male,GM0762,Deurne,2012JJ00,2012,16000,,165,,137,,28,456,,70,386,514,,49,-5,465,-58,-30,,15970
128073,3000,Male,GM0762,Deurne,2013JJ00,2013,15970,,140,,151,,-11,494,,51,443,559,,45,-6,514,-65,-76,,15894
128074,3000,Male,GM0762,Deurne,2014JJ00,2014,15894,,176,,149,,27,594,,89,505,565,,78,-16,487,29,55,,15949
128075,3000,Male,GM0762,Deurne,2015JJ00,2015,15949,,153,,143,,10,609,,94,515,529,,75,-8,454,80,89,,16038
128076,3000,Male,GM0762,Deurne,2016JJ00,2016,16038,,167,,161,,6,636,,96,540,611,,52,-17,559,25,33,,16071
128077,3000,Male,GM0762,Deurne,2017JJ00,2017,16071,,154,,144,,10,644,,80,564,549,,73,-19,476,95,109,,16180
128078,3000,Male,GM0762,Deurne,2018JJ00,2018,16180,,141,,151,,-10,659,,101,558,527,,78,-13,449,132,122,,16302
128079,3000,Male,GM0762,Deurne,2019JJ00,2019,16302,,160,,137,,23,587,,110,477,547,,75,-16,472,40,62,,16364
128080,3000,Male,GM0762,Deurne,2020JJ00,2020,16364,,146,,196,,-50,569,,93,476,555,,62,-4,493,14,-36,,16328
128081,3000,Male,GM0762,Deurne,2021JJ00,2021,16328,,149,,185,,-36,637,,91,546,508,,55,2,453,129,93,,16421
128082,3000,Male,GM0762,Deurne,2022JJ00,2022,16421,,137,,164,,-27,728,,203,525,489,,73,-18,416,239,211,,16632
128083,3000,Male,GM0762,Deurne,2023JJ00,2023,16632,,146,,194,,-48,697,,176,521,561,,131,-67,430,136,85,,16717
128154,3000,Male,GM0150,Deventer,2012JJ00,2012,48552,,581,,348,,233,1956,,546,1410,2201,,389,-91,1812,-245,-7,,48545
128155,3000,Male,GM0150,Deventer,2013JJ00,2013,48545,,527,,378,,149,2109,,639,1470,2345,,530,-229,1815,-236,-88,,48457
128156,3000,Male,GM0150,Deventer,2014JJ00,2014,48457,,544,,379,,165,2396,,769,1627,2327,,406,-111,1921,69,231,,48688
128157,3000,Male,GM0150,Deventer,2015JJ00,2015,48688,,514,,420,,94,2632,,742,1890,2478,,365,-47,2113,154,250,,48938
128158,3000,Male,GM0150,Deventer,2016JJ00,2016,48938,,521,,388,,133,2779,,652,2127,2785,,655,-354,2130,-6,126,,49064
128159,3000,Male,GM0150,Deventer,2017JJ00,2017,49064,,509,,442,,67,2702,,538,2164,2554,,384,-106,2170,148,213,,49277
128160,3000,Male,GM0150,Deventer,2018JJ00,2018,49277,,482,,442,,40,2533,,598,1935,2431,,336,-67,2095,102,153,,49430
128161,3000,Male,GM0150,Deventer,2019JJ00,2019,49430,,479,,439,,40,2669,,644,2025,2374,,440,-100,1934,295,333,,49763
128162,3000,Male,GM0150,Deventer,2020JJ00,2020,49763,,498,,517,,-19,2614,,449,2165,2325,,287,-11,2038,289,269,,50032
128163,3000,Male,GM0150,Deventer,2021JJ00,2021,50032,,535,,448,,87,2573,,482,2091,2505,,363,-70,2142,68,164,,50196
128164,3000,Male,GM0150,Deventer,2022JJ00,2022,50196,,523,,499,,24,2889,,706,2183,2256,,296,-37,1960,633,658,,50854
128165,3000,Male,GM0150,Deventer,2023JJ00,2023,50854,,501,,488,,13,2916,,576,2340,2538,,516,-187,2022,378,392,,51246
128318,3000,Male,GM0384,Diemen,2012JJ00,2012,12045,,145,,91,,54,1174,,279,895,1049,,215,-41,834,125,181,,12226
128319,3000,Male,GM0384,Diemen,2013JJ00,2013,12226,,116,,90,,26,1510,,319,1191,1148,,263,-66,885,362,389,,12615
128320,3000,Male,GM0384,Diemen,2014JJ00,2014,12615,,114,,74,,40,1681,,340,1341,1275,,293,-9,982,406,445,,13060
128321,3000,Male,GM0384,Diemen,2015JJ00,2015,13060,,142,,89,,53,1536,,329,1207,1484,,362,-89,1122,52,106,,13166
128322,3000,Male,GM0384,Diemen,2016JJ00,2016,13166,,152,,103,,49,1600,,348,1252,1563,,360,-82,1203,37,85,,13251
128323,3000,Male,GM0384,Diemen,2017JJ00,2017,13251,,143,,97,,46,1893,,440,1453,1457,,237,-21,1220,436,474,,13725
128324,3000,Male,GM0384,Diemen,2018JJ00,2018,13725,,153,,86,,67,2059,,490,1569,1586,,328,-36,1258,473,538,,14263
128325,3000,Male,GM0384,Diemen,2019JJ00,2019,14263,,176,,107,,69,2326,,653,1673,1610,,346,-62,1264,716,786,,15049
128326,3000,Male,GM0384,Diemen,2020JJ00,2020,15049,,173,,137,,36,2279,,521,1758,2024,,431,-55,1593,255,288,,15337
128327,3000,Male,GM0384,Diemen,2021JJ00,2021,15337,,189,,128,,61,2348,,655,1693,2150,,380,-78,1770,198,260,,15597
128328,3000,Male,GM0384,Diemen,2022JJ00,2022,15597,,170,,121,,49,2586,,896,1690,2203,,496,-113,1707,383,424,,16021
128329,3000,Male,GM0384,Diemen,2023JJ00,2023,16021,,157,,114,,43,2050,,603,1447,2016,,445,-114,1571,34,76,,16097
128738,3000,Male,GM1980,Dijk en Waard,2022JJ00,2022,44005,,399,,349,,50,2624,,431,2193,2058,,249,-68,1809,566,612,,44617
128739,3000,Male,GM1980,Dijk en Waard,2023JJ00,2023,44617,,433,,381,,52,2535,,300,2235,2110,,282,-111,1828,425,473,,45090
128810,3000,Male,GM1774,Dinkelland,2012JJ00,2012,13247,,100,,107,,-7,323,,49,274,328,,36,4,292,-5,-11,,13236
128811,3000,Male,GM1774,Dinkelland,2013JJ00,2013,13236,,117,,116,,1,325,,39,286,317,,44,-5,273,8,9,,13245
128812,3000,Male,GM1774,Dinkelland,2014JJ00,2014,13245,,109,,122,,-13,330,,46,284,358,,39,-2,319,-28,-42,,13203
128813,3000,Male,GM1774,Dinkelland,2015JJ00,2015,13203,,106,,115,,-9,536,,178,358,414,,51,-1,363,122,115,,13318
128814,3000,Male,GM1774,Dinkelland,2016JJ00,2016,13318,,111,,111,,0,667,,145,522,573,,30,-4,543,94,94,,13412
128815,3000,Male,GM1774,Dinkelland,2017JJ00,2017,13412,,122,,116,,6,454,,34,420,456,,48,-5,408,-2,5,,13417
128816,3000,Male,GM1774,Dinkelland,2018JJ00,2018,13417,,112,,105,,7,423,,45,378,416,,39,-4,377,7,15,,13432
128817,3000,Male,GM1774,Dinkelland,2019JJ00,2019,13432,,127,,124,,3,398,,46,352,319,,30,-4,289,79,81,,13513
128818,3000,Male,GM1774,Dinkelland,2020JJ00,2020,13513,,138,,138,,0,422,,46,376,332,,31,-3,301,90,92,,13605
128819,3000,Male,GM1774,Dinkelland,2021JJ00,2021,13605,,123,,129,,-6,389,,53,336,381,,38,-6,343,8,3,,13608
128820,3000,Male,GM1774,Dinkelland,2022JJ00,2022,13608,,126,,149,,-23,461,,131,330,368,,52,-2,316,93,70,,13678
128821,3000,Male,GM1774,Dinkelland,2023JJ00,2023,13678,,148,,148,,0,435,,69,366,415,,50,-13,365,20,19,,13697
129138,3000,Male,GM0504,Dirksland,2012JJ00,2012,4237,,42,,35,,7,134,,14,120,123,,12,-2,111,11,38,,4275
129302,3000,Male,GM0221,Doesburg,2012JJ00,2012,5656,,50,,48,,2,273,,25,248,285,,20,-2,265,-12,-10,,5646
129303,3000,Male,GM0221,Doesburg,2013JJ00,2013,5646,,33,,60,,-27,223,,20,203,241,,19,-3,222,-18,-45,,5601
129304,3000,Male,GM0221,Doesburg,2014JJ00,2014,5601,,37,,46,,-9,236,,16,220,286,,30,4,256,-50,-58,,5543
129305,3000,Male,GM0221,Doesburg,2015JJ00,2015,5543,,47,,54,,-7,298,,20,278,310,,45,-6,265,-12,-18,,5525
129306,3000,Male,GM0221,Doesburg,2016JJ00,2016,5525,,33,,56,,-23,311,,27,284,268,,16,2,252,43,19,,5544
129307,3000,Male,GM0221,Doesburg,2017JJ00,2017,5544,,48,,54,,-6,321,,23,298,319,,20,2,299,2,-5,,5539
129308,3000,Male,GM0221,Doesburg,2018JJ00,2018,5539,,46,,60,,-14,242,,22,220,309,,13,-2,296,-67,-81,,5458
129309,3000,Male,GM0221,Doesburg,2019JJ00,2019,5458,,35,,54,,-19,251,,25,226,280,,21,-5,259,-29,-48,,5410
129310,3000,Male,GM0221,Doesburg,2020JJ00,2020,5410,,36,,76,,-40,325,,29,296,310,,8,3,302,15,-26,,5384
129311,3000,Male,GM0221,Doesburg,2021JJ00,2021,5384,,32,,78,,-46,302,,31,271,282,,16,-1,266,20,-25,,5359
129312,3000,Male,GM0221,Doesburg,2022JJ00,2022,5359,,34,,53,,-19,321,,32,289,261,,34,-6,227,60,41,,5400
129313,3000,Male,GM0221,Doesburg,2023JJ00,2023,5400,,36,,46,,-10,320,,41,279,302,,25,-4,277,18,8,,5408
129384,3000,Male,GM0222,Doetinchem,2012JJ00,2012,27854,,261,,213,,48,1109,,99,1010,1143,,144,-39,999,-34,12,,27866
129385,3000,Male,GM0222,Doetinchem,2013JJ00,2013,27866,,245,,253,,-8,1071,,74,997,1091,,121,-27,970,-20,-28,,27838
129386,3000,Male,GM0222,Doetinchem,2014JJ00,2014,27838,,321,,220,,101,1125,,101,1024,1151,,105,-15,1046,-26,72,,27910
129387,3000,Male,GM0222,Doetinchem,2015JJ00,2015,27910,,263,,253,,10,1420,,317,1103,1142,,92,-1,1050,278,288,,28198
129388,3000,Male,GM0222,Doetinchem,2016JJ00,2016,28198,,276,,280,,-4,3527,,2240,1287,3462,,140,-34,3322,65,61,,28259
129389,3000,Male,GM0222,Doetinchem,2017JJ00,2017,28259,,286,,291,,-5,1439,,121,1318,1261,,114,-22,1147,178,175,,28434
129390,3000,Male,GM0222,Doetinchem,2018JJ00,2018,28434,,243,,272,,-29,1325,,111,1214,1170,,84,6,1086,155,124,,28558
129391,3000,Male,GM0222,Doetinchem,2019JJ00,2019,28558,,270,,285,,-15,1423,,156,1267,1176,,111,-23,1065,247,233,,28791
129392,3000,Male,GM0222,Doetinchem,2020JJ00,2020,28791,,224,,314,,-90,1355,,134,1221,1136,,67,4,1069,219,128,,28919
129393,3000,Male,GM0222,Doetinchem,2021JJ00,2021,28919,,300,,330,,-30,1302,,111,1191,1131,,106,-16,1025,171,143,,29062
129394,3000,Male,GM0222,Doetinchem,2022JJ00,2022,29062,,248,,295,,-47,1444,,220,1224,1085,,123,-14,962,359,313,,29375
129395,3000,Male,GM0222,Doetinchem,2023JJ00,2023,29375,,279,,299,,-20,1466,,181,1285,1146,,100,3,1046,320,300,,29675
129630,3000,Male,GM0766,Dongen,2012JJ00,2012,12499,,106,,95,,11,399,,47,352,319,,24,6,295,80,91,,12590
129631,3000,Male,GM0766,Dongen,2013JJ00,2013,12590,,126,,102,,24,384,,71,313,391,,58,-8,333,-7,17,,12607
129632,3000,Male,GM0766,Dongen,2014JJ00,2014,12607,,118,,108,,10,405,,51,354,398,,40,0,358,7,18,,12625
129633,3000,Male,GM0766,Dongen,2015JJ00,2015,12625,,115,,102,,13,461,,58,403,459,,60,-6,399,2,16,,12641
129634,3000,Male,GM0766,Dongen,2016JJ00,2016,12641,,112,,113,,-1,510,,77,433,421,,53,2,368,89,88,,12729
129635,3000,Male,GM0766,Dongen,2017JJ00,2017,12729,,118,,100,,18,620,,66,554,489,,57,-13,432,131,147,,12876
129636,3000,Male,GM0766,Dongen,2018JJ00,2018,12876,,138,,109,,29,604,,80,524,482,,48,-4,434,122,153,,13029
129637,3000,Male,GM0766,Dongen,2019JJ00,2019,13029,,125,,117,,8,552,,86,466,493,,73,-21,420,59,66,,13095
129638,3000,Male,GM0766,Dongen,2020JJ00,2020,13095,,134,,140,,-6,630,,77,553,499,,46,-5,453,131,124,,13219
129639,3000,Male,GM0766,Dongen,2021JJ00,2021,13219,,142,,147,,-5,538,,70,468,484,,51,-9,433,54,49,,13268
129640,3000,Male,GM0766,Dongen,2022JJ00,2022,13268,,129,,153,,-24,831,,352,479,475,,120,-29,355,356,330,,13598
129641,3000,Male,GM0766,Dongen,2023JJ00,2023,13598,,126,,127,,-1,483,,62,421,567,,141,-11,426,-84,-84,,13514
129712,3000,Male,GM0058,Dongeradeel,2012JJ00,2012,12190,,132,,112,,20,332,,26,306,399,,22,-1,377,-67,-47,,12143
129713,3000,Male,GM0058,Dongeradeel,2013JJ00,2013,12143,,118,,125,,-7,343,,24,319,396,,28,3,368,-53,-60,,12083
129714,3000,Male,GM0058,Dongeradeel,2014JJ00,2014,12083,,116,,105,,11,322,,34,288,413,,29,-6,384,-91,-80,,12003
129715,3000,Male,GM0058,Dongeradeel,2015JJ00,2015,12003,,112,,118,,-6,399,,50,349,421,,23,0,398,-22,-29,,11974
129716,3000,Male,GM0058,Dongeradeel,2016JJ00,2016,11974,,107,,120,,-13,437,,47,390,451,,58,-9,393,-14,-27,,11947
129717,3000,Male,GM0058,Dongeradeel,2017JJ00,2017,11947,,115,,114,,1,399,,29,370,464,,48,-6,416,-65,-65,,11882
129718,3000,Male,GM0058,Dongeradeel,2018JJ00,2018,11882,,108,,121,,-13,433,,51,382,398,,34,-8,364,35,28,,11910
130040,3000,Male,GM0505,Dordrecht,2012JJ00,2012,58553,,723,,497,,226,2429,,629,1800,2820,,766,-262,2054,-391,-170,,58383
130041,3000,Male,GM0505,Dordrecht,2013JJ00,2013,58383,,674,,481,,193,2423,,600,1823,2451,,486,-14,1965,-28,171,,58554
130042,3000,Male,GM0505,Dordrecht,2014JJ00,2014,58554,,684,,480,,204,2581,,568,2013,2697,,676,-163,2021,-116,92,,58646
130043,3000,Male,GM0505,Dordrecht,2015JJ00,2015,58646,,626,,515,,111,2439,,509,1930,2607,,454,-29,2153,-168,-64,,58582
130044,3000,Male,GM0505,Dordrecht,2016JJ00,2016,58582,,568,,487,,81,2644,,497,2147,2621,,403,-32,2218,23,102,,58684
130045,3000,Male,GM0505,Dordrecht,2017JJ00,2017,58684,,614,,545,,69,2749,,532,2217,2924,,535,-136,2389,-175,-107,,58577
130046,3000,Male,GM0505,Dordrecht,2018JJ00,2018,58577,,601,,571,,30,2840,,629,2211,2776,,518,-169,2258,64,94,,58671
130047,3000,Male,GM0505,Dordrecht,2019JJ00,2019,58671,,637,,540,,97,2858,,662,2196,2581,,482,-103,2099,277,373,,59044
130048,3000,Male,GM0505,Dordrecht,2020JJ00,2020,59044,,600,,639,,-39,2817,,590,2227,2805,,336,-50,2469,12,-25,,59019
130049,3000,Male,GM0505,Dordrecht,2021JJ00,2021,59019,,682,,630,,52,3079,,610,2469,2844,,399,-34,2445,235,286,,59305
130050,3000,Male,GM0505,Dordrecht,2022JJ00,2022,59305,,626,,601,,25,3718,,1266,2452,2780,,500,-85,2280,938,959,,60264
130051,3000,Male,GM0505,Dordrecht,2023JJ00,2023,60264,,605,,575,,30,3361,,776,2585,3108,,681,-237,2427,253,280,,60544
130122,3000,Male,GM0498,Drechterland,2012JJ00,2012,9796,,97,,84,,13,398,,55,343,416,,41,-13,375,-18,-7,,9789
130123,3000,Male,GM0498,Drechterland,2013JJ00,2013,9789,,80,,68,,12,317,,55,262,384,,35,-8,349,-67,-52,,9737
130124,3000,Male,GM0498,Drechterland,2014JJ00,2014,9737,,101,,83,,18,430,,90,340,425,,63,-13,362,5,22,,9759
130125,3000,Male,GM0498,Drechterland,2015JJ00,2015,9759,,89,,71,,18,482,,65,417,448,,50,-8,398,34,52,,9811
130126,3000,Male,GM0498,Drechterland,2016JJ00,2016,9811,,98,,80,,18,514,,51,463,507,,50,-9,457,7,24,,9835
130127,3000,Male,GM0498,Drechterland,2017JJ00,2017,9835,,91,,77,,14,574,,66,508,570,,58,-6,512,4,20,,9855
130128,3000,Male,GM0498,Drechterland,2018JJ00,2018,9855,,77,,70,,7,586,,73,513,530,,59,-17,471,56,64,,9919
130129,3000,Male,GM0498,Drechterland,2019JJ00,2019,9919,,88,,78,,10,564,,82,482,504,,59,-16,445,60,71,,9990
130130,3000,Male,GM0498,Drechterland,2020JJ00,2020,9990,,100,,87,,13,553,,88,465,521,,66,-15,455,32,45,,10035
130131,3000,Male,GM0498,Drechterland,2021JJ00,2021,10035,,105,,86,,19,511,,65,446,480,,48,-8,432,31,50,,10085
130132,3000,Male,GM0498,Drechterland,2022JJ00,2022,10085,,108,,87,,21,733,,179,554,544,,70,-13,474,189,207,,10292
130133,3000,Male,GM0498,Drechterland,2023JJ00,2023,10292,,91,,97,,-6,618,,119,499,562,,94,-25,468,56,51,,10343
130696,3000,Male,GM1719,Drimmelen,2012JJ00,2012,13335,,100,,110,,-10,421,,68,353,362,,53,-11,309,59,50,,13385
130697,3000,Male,GM1719,Drimmelen,2013JJ00,2013,13385,,121,,112,,9,345,,37,308,407,,79,-12,328,-62,-52,,13333
130698,3000,Male,GM1719,Drimmelen,2014JJ00,2014,13333,,109,,113,,-4,440,,67,373,414,,52,-7,362,26,22,,13355
130699,3000,Male,GM1719,Drimmelen,2015JJ00,2015,13355,,112,,122,,-10,510,,99,411,421,,54,-6,367,89,79,,13434
130700,3000,Male,GM1719,Drimmelen,2016JJ00,2016,13434,,97,,109,,-12,547,,84,463,498,,50,-2,448,49,38,,13472
130701,3000,Male,GM1719,Drimmelen,2017JJ00,2017,13472,,129,,103,,26,634,,147,487,564,,101,-16,463,70,96,,13568
130702,3000,Male,GM1719,Drimmelen,2018JJ00,2018,13568,,95,,123,,-28,589,,155,434,539,,105,-5,434,50,22,,13590
130703,3000,Male,GM1719,Drimmelen,2019JJ00,2019,13590,,115,,128,,-13,633,,188,445,576,,140,-26,436,57,44,,13634
130704,3000,Male,GM1719,Drimmelen,2020JJ00,2020,13634,,100,,140,,-40,671,,179,492,626,,155,-25,471,45,5,,13639
130705,3000,Male,GM1719,Drimmelen,2021JJ00,2021,13639,,110,,130,,-20,674,,176,498,588,,151,-12,437,86,68,,13707
130706,3000,Male,GM1719,Drimmelen,2022JJ00,2022,13707,,125,,150,,-25,912,,302,610,623,,211,-23,412,289,266,,13973
130707,3000,Male,GM1719,Drimmelen,2023JJ00,2023,13973,,135,,157,,-22,836,,288,548,724,,250,-20,474,112,91,,14064
130778,3000,Male,GM0303,Dronten,2012JJ00,2012,20523,,211,,120,,91,1231,,322,909,1222,,143,-59,1079,9,101,,20624
130779,3000,Male,GM0303,Dronten,2013JJ00,2013,20624,,200,,120,,80,1356,,540,816,1605,,513,-379,1092,-249,-163,,20461
130780,3000,Male,GM0303,Dronten,2014JJ00,2014,20461,,202,,119,,83,1475,,664,811,1605,,201,-85,1404,-130,-45,,20416
130781,3000,Male,GM0303,Dronten,2015JJ00,2015,20416,,185,,137,,48,1787,,709,1078,1751,,194,-74,1557,36,85,,20501
130782,3000,Male,GM0303,Dronten,2016JJ00,2016,20501,,186,,149,,37,1701,,535,1166,1735,,146,-11,1589,-34,1,,20502
130783,3000,Male,GM0303,Dronten,2017JJ00,2017,20502,,175,,140,,35,1329,,221,1108,1414,,201,-95,1213,-85,-49,,20453
130784,3000,Male,GM0303,Dronten,2018JJ00,2018,20453,,205,,163,,42,1303,,256,1047,1334,,124,-35,1210,-31,16,,20469
130785,3000,Male,GM0303,Dronten,2019JJ00,2019,20469,,217,,155,,62,1559,,409,1150,1259,,147,-24,1112,300,363,,20832
130786,3000,Male,GM0303,Dronten,2020JJ00,2020,20832,,222,,169,,53,1430,,238,1192,1250,,120,-37,1130,180,230,,21062
130787,3000,Male,GM0303,Dronten,2021JJ00,2021,21062,,236,,180,,56,1796,,332,1464,1393,,268,-81,1125,403,462,,21524
130788,3000,Male,GM0303,Dronten,2022JJ00,2022,21524,,192,,193,,-1,1797,,439,1358,1477,,304,-112,1173,320,319,,21843
130789,3000,Male,GM0303,Dronten,2023JJ00,2023,21843,,214,,170,,44,2026,,225,1801,1555,,287,-85,1268,471,519,,22362
130942,3000,Male,GM0225,Druten,2012JJ00,2012,9036,,73,,67,,6,323,,33,290,328,,28,-5,300,-5,1,,9037
130943,3000,Male,GM0225,Druten,2013JJ00,2013,9037,,79,,60,,19,304,,26,278,327,,22,-8,305,-23,-4,,9033
130944,3000,Male,GM0225,Druten,2014JJ00,2014,9033,,76,,57,,19,362,,36,326,316,,24,-3,292,46,66,,9099
130945,3000,Male,GM0225,Druten,2015JJ00,2015,9099,,89,,57,,32,375,,32,343,358,,41,-10,317,17,48,,9147
130946,3000,Male,GM0225,Druten,2016JJ00,2016,9147,,73,,68,,5,442,,46,396,350,,23,-6,327,92,98,,9245
130947,3000,Male,GM0225,Druten,2017JJ00,2017,9245,,89,,92,,-3,465,,27,438,380,,27,-8,353,85,80,,9325
130948,3000,Male,GM0225,Druten,2018JJ00,2018,9325,,82,,74,,8,429,,41,388,389,,17,1,372,40,48,,9373
130949,3000,Male,GM0225,Druten,2019JJ00,2019,9373,,95,,79,,16,465,,60,405,408,,30,-6,378,57,72,,9445
130950,3000,Male,GM0225,Druten,2020JJ00,2020,9445,,76,,72,,4,487,,60,427,432,,47,-22,385,55,59,,9504
130951,3000,Male,GM0225,Druten,2021JJ00,2021,9504,,108,,87,,21,466,,45,421,377,,37,-9,340,89,110,,9614
130952,3000,Male,GM0225,Druten,2022JJ00,2022,9614,,89,,83,,6,588,,165,423,403,,71,-22,332,185,189,,9803
130953,3000,Male,GM0225,Druten,2023JJ00,2023,9803,,85,,100,,-15,466,,87,379,406,,60,-13,346,60,44,,9847
131188,3000,Male,GM0226,Duiven,2012JJ00,2012,12514,,109,,71,,38,496,,51,445,532,,31,-7,501,-36,4,,12518
131189,3000,Male,GM0226,Duiven,2013JJ00,2013,12518,,122,,84,,38,530,,27,503,491,,39,-5,452,39,78,,12596
131190,3000,Male,GM0226,Duiven,2014JJ00,2014,12596,,106,,81,,25,477,,29,448,522,,37,0,485,-45,-20,,12576
131191,3000,Male,GM0226,Duiven,2015JJ00,2015,12576,,90,,80,,10,456,,26,430,534,,21,-7,513,-78,-68,,12508
131192,3000,Male,GM0226,Duiven,2016JJ00,2016,12508,,102,,85,,17,642,,41,601,636,,34,-3,602,6,20,,12528
131193,3000,Male,GM0226,Duiven,2017JJ00,2017,12528,,94,,97,,-3,647,,39,608,609,,40,-7,569,38,33,,12561
131194,3000,Male,GM0226,Duiven,2018JJ00,2018,12561,,99,,96,,3,567,,37,530,619,,32,-8,587,-52,-45,,12516
131195,3000,Male,GM0226,Duiven,2019JJ00,2019,12516,,104,,93,,11,545,,33,512,660,,41,-5,619,-115,-106,,12410
131196,3000,Male,GM0226,Duiven,2020JJ00,2020,12410,,97,,97,,0,592,,39,553,598,,20,-3,578,-6,-7,,12403
131197,3000,Male,GM0226,Duiven,2021JJ00,2021,12403,,105,,105,,0,528,,23,505,612,,28,-2,584,-84,-83,,12320
131198,3000,Male,GM0226,Duiven,2022JJ00,2022,12320,,107,,121,,-14,563,,59,504,538,,49,-11,489,25,12,,12332
131199,3000,Male,GM0226,Duiven,2023JJ00,2023,12332,,105,,90,,15,550,,78,472,604,,51,-7,553,-54,-40,,12292
131762,3000,Male,GM1711,Echt-Susteren,2012JJ00,2012,16096,,128,,161,,-33,650,,156,494,677,,101,-28,576,-27,-61,,16035
131763,3000,Male,GM1711,Echt-Susteren,2013JJ00,2013,16035,,123,,158,,-35,661,,183,478,660,,98,-25,562,1,-32,,16003
131764,3000,Male,GM1711,Echt-Susteren,2014JJ00,2014,16003,,121,,164,,-43,857,,325,532,798,,108,-8,690,59,13,,16016
131765,3000,Male,GM1711,Echt-Susteren,2015JJ00,2015,16016,,129,,190,,-61,864,,284,580,795,,96,-15,699,69,11,,16027
131766,3000,Male,GM1711,Echt-Susteren,2016JJ00,2016,16027,,121,,171,,-50,840,,228,612,824,,99,-19,725,16,-30,,15997
131767,3000,Male,GM1711,Echt-Susteren,2017JJ00,2017,15997,,116,,182,,-66,916,,200,716,877,,114,-26,763,39,-28,,15969
131768,3000,Male,GM1711,Echt-Susteren,2018JJ00,2018,15969,,114,,179,,-65,809,,158,651,848,,141,-60,707,-39,-101,,15868
131769,3000,Male,GM1711,Echt-Susteren,2019JJ00,2019,15868,,113,,176,,-63,823,,190,633,805,,116,-34,689,18,-45,,15823
131770,3000,Male,GM1711,Echt-Susteren,2020JJ00,2020,15823,,119,,190,,-71,878,,114,764,733,,68,-1,665,145,75,,15898
131771,3000,Male,GM1711,Echt-Susteren,2021JJ00,2021,15898,,136,,207,,-71,908,,99,809,850,,108,-29,742,58,-15,,15883
131772,3000,Male,GM1711,Echt-Susteren,2022JJ00,2022,15883,,125,,216,,-91,1077,,194,883,841,,146,-41,695,236,147,,16030
131773,3000,Male,GM1711,Echt-Susteren,2023JJ00,2023,16030,,112,,204,,-92,895,,115,780,777,,125,-30,652,118,25,,16055
131926,3000,Male,GM0385,Edam-Volendam,2012JJ00,2012,14368,,153,,110,,43,199,,33,166,257,,48,-9,209,-58,-15,,14353
131927,3000,Male,GM0385,Edam-Volendam,2013JJ00,2013,14353,,155,,106,,49,268,,33,235,221,,46,-6,175,47,96,,14449
131928,3000,Male,GM0385,Edam-Volendam,2014JJ00,2014,14449,,135,,95,,40,247,,22,225,201,,33,-3,168,46,86,,14535
131929,3000,Male,GM0385,Edam-Volendam,2015JJ00,2015,14535,,140,,105,,35,257,,31,226,238,,50,-16,188,19,59,,14594
131930,3000,Male,GM0385,Edam-Volendam,2016JJ00,2016,17692,,170,,114,,56,509,,81,428,352,,35,4,317,157,219,,17911
131931,3000,Male,GM0385,Edam-Volendam,2017JJ00,2017,17911,,177,,126,,51,451,,85,366,421,,87,-39,334,30,82,,17993
131932,3000,Male,GM0385,Edam-Volendam,2018JJ00,2018,17993,,136,,153,,-17,464,,78,386,402,,75,-19,327,62,46,,18039
131933,3000,Male,GM0385,Edam-Volendam,2019JJ00,2019,18039,,168,,143,,25,468,,65,403,433,,53,-23,380,35,58,,18097
131934,3000,Male,GM0385,Edam-Volendam,2020JJ00,2020,18097,,156,,194,,-38,489,,75,414,417,,61,-14,356,72,36,,18133
131935,3000,Male,GM0385,Edam-Volendam,2021JJ00,2021,18133,,196,,169,,27,531,,53,478,440,,65,-11,375,91,118,,18251
131936,3000,Male,GM0385,Edam-Volendam,2022JJ00,2022,18251,,161,,172,,-11,543,,175,368,406,,63,-7,343,137,127,,18378
131937,3000,Male,GM0385,Edam-Volendam,2023JJ00,2023,18378,,176,,151,,25,555,,70,485,488,,75,-6,413,67,93,,18471
132008,3000,Male,GM0228,Ede,2012JJ00,2012,53371,,616,,432,,184,2389,,380,2009,2073,,221,-31,1852,316,506,,53877
132009,3000,Male,GM0228,Ede,2013JJ00,2013,53877,,626,,419,,207,2373,,375,1998,2159,,270,3,1889,214,424,,54301
132010,3000,Male,GM0228,Ede,2014JJ00,2014,54301,,631,,414,,217,2664,,375,2289,2388,,327,-55,2061,276,489,,54790
132011,3000,Male,GM0228,Ede,2015JJ00,2015,54790,,674,,408,,266,2632,,370,2262,2391,,326,-48,2065,241,511,,55301
132012,3000,Male,GM0228,Ede,2016JJ00,2016,55301,,689,,417,,272,2949,,328,2621,2609,,321,-73,2288,340,613,,55914
132013,3000,Male,GM0228,Ede,2017JJ00,2017,55914,,685,,450,,235,3057,,522,2535,2524,,294,-44,2230,533,775,,56689
132014,3000,Male,GM0228,Ede,2018JJ00,2018,56689,,694,,443,,251,2942,,360,2582,2705,,463,-86,2242,237,486,,57175
132015,3000,Male,GM0228,Ede,2019JJ00,2019,57175,,715,,460,,255,2996,,400,2596,2413,,271,-52,2142,583,836,,58011
132016,3000,Male,GM0228,Ede,2020JJ00,2020,58011,,689,,489,,200,2876,,355,2521,2357,,206,-6,2151,519,723,,58734
132017,3000,Male,GM0228,Ede,2021JJ00,2021,58734,,756,,534,,222,3011,,447,2564,2410,,246,-17,2164,601,821,,59555
132018,3000,Male,GM0228,Ede,2022JJ00,2022,59555,,722,,521,,201,3261,,765,2496,2387,,348,-52,2039,874,1071,,60626
132019,3000,Male,GM0228,Ede,2023JJ00,2023,60626,,684,,506,,178,3236,,527,2709,2727,,495,-170,2232,509,684,,61310
132172,3000,Male,GM0317,Eemnes,2012JJ00,2012,4365,,39,,24,,15,160,,12,148,173,,18,-3,155,-13,2,,4367
132173,3000,Male,GM0317,Eemnes,2013JJ00,2013,4367,,32,,27,,5,135,,14,121,166,,20,3,146,-31,-27,,4340
132174,3000,Male,GM0317,Eemnes,2014JJ00,2014,4340,,37,,27,,10,162,,19,143,154,,31,-3,123,8,19,,4359
132175,3000,Male,GM0317,Eemnes,2015JJ00,2015,4359,,32,,25,,7,232,,11,221,211,,25,-6,186,21,30,,4389
132176,3000,Male,GM0317,Eemnes,2016JJ00,2016,4389,,35,,31,,4,234,,13,221,193,,17,1,176,41,45,,4434
132177,3000,Male,GM0317,Eemnes,2017JJ00,2017,4434,,42,,33,,9,280,,27,253,247,,20,2,227,33,44,,4478
132178,3000,Male,GM0317,Eemnes,2018JJ00,2018,4478,,52,,31,,21,217,,17,200,216,,12,4,204,1,23,,4501
132179,3000,Male,GM0317,Eemnes,2019JJ00,2019,4501,,37,,36,,1,270,,28,242,201,,10,3,191,69,70,,4571
132180,3000,Male,GM0317,Eemnes,2020JJ00,2020,4571,,37,,28,,9,270,,16,254,258,,17,-3,241,12,21,,4592
132181,3000,Male,GM0317,Eemnes,2021JJ00,2021,4592,,47,,49,,-2,293,,27,266,248,,21,-3,227,45,43,,4635
132182,3000,Male,GM0317,Eemnes,2022JJ00,2022,4635,,42,,45,,-3,308,,43,265,241,,23,2,218,67,64,,4699
132183,3000,Male,GM0317,Eemnes,2023JJ00,2023,4699,,46,,34,,12,271,,28,243,209,,13,1,196,62,75,,4774
132263,3000,Male,GM1979,Eemsdelta,2021JJ00,2021,22841,,204,,334,,-130,1091,,154,937,1043,,116,-21,927,48,-81,,22760
132264,3000,Male,GM1979,Eemsdelta,2022JJ00,2022,22760,,188,,292,,-104,1319,,261,1058,1233,,159,-51,1074,86,-17,,22743
132265,3000,Male,GM1979,Eemsdelta,2023JJ00,2023,22743,,189,,294,,-105,1183,,187,996,1144,,121,-28,1023,39,-62,,22681
132336,3000,Male,GM1651,Eemsmond,2012JJ00,2012,8255,,81,,86,,-5,315,,127,188,348,,89,-11,259,-33,-38,,8217
132337,3000,Male,GM1651,Eemsmond,2013JJ00,2013,8217,,62,,76,,-14,338,,147,191,397,,122,-21,275,-59,-73,,8144
132338,3000,Male,GM1651,Eemsmond,2014JJ00,2014,8144,,58,,69,,-11,222,,22,200,327,,68,-14,259,-105,-117,,8027
132339,3000,Male,GM1651,Eemsmond,2015JJ00,2015,8027,,63,,67,,-4,321,,46,275,295,,16,-5,279,26,23,,8050
132340,3000,Male,GM1651,Eemsmond,2016JJ00,2016,8050,,65,,81,,-16,303,,63,240,363,,46,-18,317,-60,-76,,7974
132341,3000,Male,GM1651,Eemsmond,2017JJ00,2017,7974,,64,,88,,-24,320,,42,278,333,,46,-13,287,-13,-37,,7937
132342,3000,Male,GM1651,Eemsmond,2018JJ00,2018,7937,,48,,65,,-17,354,,73,281,388,,46,-3,342,-34,-54,,7883
132500,3000,Male,GM0770,Eersel,2012JJ00,2012,9220,,56,,64,,-8,309,,37,272,297,,30,-4,267,12,5,,9225
132501,3000,Male,GM0770,Eersel,2013JJ00,2013,9225,,80,,88,,-8,322,,41,281,350,,32,-9,318,-28,-37,,9188
132502,3000,Male,GM0770,Eersel,2014JJ00,2014,9188,,89,,85,,4,422,,53,369,328,,36,-4,292,94,100,,9288
132503,3000,Male,GM0770,Eersel,2015JJ00,2015,9288,,88,,80,,8,437,,55,382,355,,41,-9,314,82,89,,9377
132504,3000,Male,GM0770,Eersel,2016JJ00,2016,9377,,92,,117,,-25,429,,49,380,370,,55,-12,315,59,34,,9411
132505,3000,Male,GM0770,Eersel,2017JJ00,2017,9411,,72,,81,,-9,459,,58,401,378,,45,-6,333,81,76,,9487
132506,3000,Male,GM0770,Eersel,2018JJ00,2018,9487,,89,,73,,16,554,,67,487,382,,39,-7,343,172,187,,9674
132507,3000,Male,GM0770,Eersel,2019JJ00,2019,9674,,77,,83,,-6,464,,70,394,347,,28,-1,319,117,111,,9785
132508,3000,Male,GM0770,Eersel,2020JJ00,2020,9785,,82,,115,,-33,520,,79,441,387,,49,-20,338,133,100,,9885
132509,3000,Male,GM0770,Eersel,2021JJ00,2021,9885,,109,,100,,9,500,,64,436,376,,44,-1,332,124,133,,10018
132510,3000,Male,GM0770,Eersel,2022JJ00,2022,10018,,74,,94,,-20,499,,130,369,409,,54,-5,355,90,67,,10085
132511,3000,Male,GM0770,Eersel,2023JJ00,2023,10085,,106,,110,,-4,527,,153,374,406,,76,-22,330,121,116,,10201
133156,3000,Male,GM1903,Eijsden-Margraten,2012JJ00,2012,12498,,92,,135,,-43,595,,62,533,532,,71,-15,461,63,18,,12516
133157,3000,Male,GM1903,Eijsden-Margraten,2013JJ00,2013,12516,,92,,98,,-6,543,,83,460,554,,64,-2,490,-11,-17,,12499
133158,3000,Male,GM1903,Eijsden-Margraten,2014JJ00,2014,12499,,91,,99,,-8,545,,61,484,589,,75,-11,514,-44,-53,,12446
133159,3000,Male,GM1903,Eijsden-Margraten,2015JJ00,2015,12446,,100,,127,,-27,641,,74,567,550,,80,-10,470,91,64,,12510
133160,3000,Male,GM1903,Eijsden-Margraten,2016JJ00,2016,12510,,102,,127,,-25,732,,87,645,623,,79,-5,544,109,84,,12594
133161,3000,Male,GM1903,Eijsden-Margraten,2017JJ00,2017,12594,,146,,122,,24,774,,78,696,601,,80,-19,521,173,198,,12792
133162,3000,Male,GM1903,Eijsden-Margraten,2018JJ00,2018,12792,,122,,135,,-13,731,,110,621,666,,84,-11,582,65,51,,12843
133163,3000,Male,GM1903,Eijsden-Margraten,2019JJ00,2019,12843,,127,,126,,1,732,,73,659,675,,93,-6,582,57,60,,12903
133164,3000,Male,GM1903,Eijsden-Margraten,2020JJ00,2020,12903,,132,,156,,-24,768,,77,691,667,,73,0,594,101,76,,12979
133165,3000,Male,GM1903,Eijsden-Margraten,2021JJ00,2021,12979,,128,,133,,-5,595,,56,539,630,,78,-1,552,-35,-41,,12938
133166,3000,Male,GM1903,Eijsden-Margraten,2022JJ00,2022,12938,,129,,131,,-2,767,,136,631,701,,114,-2,587,66,65,,13003
133167,3000,Male,GM1903,Eijsden-Margraten,2023JJ00,2023,13003,,115,,137,,-22,722,,107,615,684,,92,-5,592,38,15,,13018
133238,3000,Male,GM0772,Eindhoven,2012JJ00,2012,110743,,1173,,922,,251,7433,,2470,4963,7086,,2249,-697,4837,347,589,,111332
133239,3000,Male,GM0772,Eindhoven,2013JJ00,2013,111332,,1160,,920,,240,8206,,2688,5518,7021,,2150,-401,4871,1185,1435,,112767
133240,3000,Male,GM0772,Eindhoven,2014JJ00,2014,112767,,1158,,945,,213,8635,,2860,5775,7577,,2344,-464,5233,1058,1267,,114034
133241,3000,Male,GM0772,Eindhoven,2015JJ00,2015,114034,,1215,,992,,223,9236,,3497,5739,8446,,2366,-443,6080,790,1018,,115052
133242,3000,Male,GM0772,Eindhoven,2016JJ00,2016,115052,,1218,,958,,260,9958,,3541,6417,8971,,2641,-505,6330,987,1255,,116307
133243,3000,Male,GM0772,Eindhoven,2017JJ00,2017,116307,,1152,,1003,,149,10362,,3936,6426,9225,,2506,-401,6719,1137,1286,,117593
133244,3000,Male,GM0772,Eindhoven,2018JJ00,2018,117593,,1114,,939,,175,10566,,4616,5950,9179,,2710,-460,6469,1387,1564,,119157
133245,3000,Male,GM0772,Eindhoven,2019JJ00,2019,119157,,1179,,974,,205,10760,,4905,5855,9335,,2556,-354,6779,1425,1622,,120779
133246,3000,Male,GM0772,Eindhoven,2020JJ00,2020,120779,,1125,,1104,,21,10334,,3966,6368,9484,,2440,-262,7044,850,872,,121651
133247,3000,Male,GM0772,Eindhoven,2021JJ00,2021,121651,,1200,,1061,,139,11243,,4991,6252,9568,,2414,-264,7154,1675,1804,,123455
133248,3000,Male,GM0772,Eindhoven,2022JJ00,2022,123455,,1125,,1042,,83,12781,,6875,5906,9893,,2666,-291,7227,2888,2961,,126416
133249,3000,Male,GM0772,Eindhoven,2023JJ00,2023,126416,,1093,,1114,,-21,11990,,5570,6420,10384,,2858,-432,7526,1606,1565,,127981
133320,3000,Male,GM0230,Elburg,2012JJ00,2012,11105,,160,,86,,74,338,,29,309,381,,42,-11,339,-43,32,,11137
133321,3000,Male,GM0230,Elburg,2013JJ00,2013,11137,,147,,93,,54,380,,31,349,364,,29,-11,335,16,71,,11208
133322,3000,Male,GM0230,Elburg,2014JJ00,2014,11208,,163,,100,,63,405,,44,361,360,,37,-13,323,45,109,,11317
133323,3000,Male,GM0230,Elburg,2015JJ00,2015,11317,,143,,89,,54,424,,44,380,425,,48,-27,377,-1,53,,11370
133324,3000,Male,GM0230,Elburg,2016JJ00,2016,11370,,151,,78,,73,473,,29,444,449,,27,-6,422,24,98,,11468
133325,3000,Male,GM0230,Elburg,2017JJ00,2017,11468,,117,,86,,31,519,,35,484,507,,30,-8,477,12,44,,11512
133326,3000,Male,GM0230,Elburg,2018JJ00,2018,11512,,131,,90,,41,497,,44,453,534,,40,-13,494,-37,4,,11516
133327,3000,Male,GM0230,Elburg,2019JJ00,2019,11516,,139,,115,,24,486,,56,430,472,,39,-8,433,14,39,,11555
133328,3000,Male,GM0230,Elburg,2020JJ00,2020,11555,,122,,120,,2,661,,80,581,456,,23,2,433,205,207,,11762
133329,3000,Male,GM0230,Elburg,2021JJ00,2021,11762,,131,,104,,27,588,,34,554,447,,43,-18,404,141,169,,11931
133330,3000,Male,GM0230,Elburg,2022JJ00,2022,11931,,130,,99,,31,551,,136,415,474,,69,-20,405,77,109,,12040
133331,3000,Male,GM0230,Elburg,2023JJ00,2023,12040,,122,,110,,12,429,,82,347,500,,66,-18,434,-71,-59,,11981
133894,3000,Male,GM0114,Emmen,2012JJ00,2012,53915,,470,,549,,-79,1624,,290,1334,1790,,373,-159,1417,-166,-253,,53662
133895,3000,Male,GM0114,Emmen,2013JJ00,2013,53662,,417,,546,,-129,1570,,283,1287,1629,,264,-83,1365,-59,-189,,53473
133896,3000,Male,GM0114,Emmen,2014JJ00,2014,53473,,480,,536,,-56,1525,,253,1272,1532,,290,-94,1242,-7,-74,,53399
133897,3000,Male,GM0114,Emmen,2015JJ00,2015,53399,,448,,502,,-54,1675,,290,1385,1620,,271,-96,1349,55,-9,,53390
133898,3000,Male,GM0114,Emmen,2016JJ00,2016,53390,,501,,561,,-60,1928,,311,1617,1794,,290,-65,1504,134,71,,53461
133899,3000,Male,GM0114,Emmen,2017JJ00,2017,53461,,447,,582,,-135,1879,,269,1610,1867,,238,-55,1629,12,-130,,53331
133900,3000,Male,GM0114,Emmen,2018JJ00,2018,53331,,402,,609,,-207,1890,,281,1609,1725,,201,-21,1524,165,-42,,53289
133901,3000,Male,GM0114,Emmen,2019JJ00,2019,53289,,462,,549,,-87,1926,,350,1576,1774,,270,-81,1504,152,48,,53337
133902,3000,Male,GM0114,Emmen,2020JJ00,2020,53337,,447,,651,,-204,1824,,207,1617,1644,,220,-40,1424,180,-41,,53296
133903,3000,Male,GM0114,Emmen,2021JJ00,2021,53296,,481,,668,,-187,2252,,259,1993,1536,,223,-55,1313,716,518,,53814
133904,3000,Male,GM0114,Emmen,2022JJ00,2022,53814,,467,,658,,-191,2375,,554,1821,1676,,226,-70,1450,699,487,,54301
133905,3000,Male,GM0114,Emmen,2023JJ00,2023,54301,,439,,687,,-248,2361,,591,1770,1742,,359,-89,1383,619,352,,54653
134140,3000,Male,GM0388,Enkhuizen,2012JJ00,2012,9129,,113,,78,,35,407,,71,336,386,,57,-3,329,21,57,,9186
134141,3000,Male,GM0388,Enkhuizen,2013JJ00,2013,9186,,102,,87,,15,399,,55,344,362,,46,-5,316,37,52,,9238
134142,3000,Male,GM0388,Enkhuizen,2014JJ00,2014,9238,,90,,82,,8,410,,67,343,428,,48,-3,380,-18,-10,,9228
134143,3000,Male,GM0388,Enkhuizen,2015JJ00,2015,9228,,105,,89,,16,475,,80,395,412,,42,-1,370,63,80,,9308
134144,3000,Male,GM0388,Enkhuizen,2016JJ00,2016,9308,,91,,83,,8,442,,76,366,466,,68,-16,398,-24,-14,,9294
134145,3000,Male,GM0388,Enkhuizen,2017JJ00,2017,9294,,106,,78,,28,419,,51,368,451,,56,-2,395,-32,-4,,9290
134146,3000,Male,GM0388,Enkhuizen,2018JJ00,2018,9290,,81,,86,,-5,450,,76,374,448,,46,-4,402,2,-5,,9285
134147,3000,Male,GM0388,Enkhuizen,2019JJ00,2019,9285,,94,,96,,-2,497,,91,406,453,,74,-13,379,44,41,,9326
134148,3000,Male,GM0388,Enkhuizen,2020JJ00,2020,9326,,107,,103,,4,519,,90,429,484,,60,-9,424,35,39,,9365
134149,3000,Male,GM0388,Enkhuizen,2021JJ00,2021,9365,,82,,96,,-14,494,,72,422,485,,62,-10,423,9,-3,,9362
134150,3000,Male,GM0388,Enkhuizen,2022JJ00,2022,9362,,83,,105,,-22,575,,162,413,457,,76,-13,381,118,96,,9458
134151,3000,Male,GM0388,Enkhuizen,2023JJ00,2023,9458,,92,,104,,-12,511,,114,397,484,,75,-11,409,27,16,,9474
134222,3000,Male,GM0153,Enschede,2012JJ00,2012,80221,,825,,715,,110,4092,,1207,2885,3966,,1231,-218,2735,126,228,,80449
134223,3000,Male,GM0153,Enschede,2013JJ00,2013,80449,,809,,679,,130,4042,,1192,2850,4191,,1341,-304,2850,-149,-23,,80426
134224,3000,Male,GM0153,Enschede,2014JJ00,2014,80426,,918,,637,,281,4156,,1242,2914,4440,,1334,-303,3106,-284,-15,,80411
134225,3000,Male,GM0153,Enschede,2015JJ00,2015,80411,,865,,659,,206,4147,,1333,2814,4342,,1294,-257,3048,-195,8,,80419
134226,3000,Male,GM0153,Enschede,2016JJ00,2016,80419,,791,,685,,106,4531,,1414,3117,4560,,1381,-370,3179,-29,69,,80488
134227,3000,Male,GM0153,Enschede,2017JJ00,2017,80488,,739,,710,,29,4577,,1637,2940,4437,,1181,-156,3256,140,165,,80653
134228,3000,Male,GM0153,Enschede,2018JJ00,2018,80653,,686,,710,,-24,4792,,1810,2982,4269,,1163,-45,3106,523,495,,81148
134229,3000,Male,GM0153,Enschede,2019JJ00,2019,81148,,724,,765,,-41,5240,,2218,3022,4794,,1573,-434,3221,446,391,,81539
134230,3000,Male,GM0153,Enschede,2020JJ00,2020,81539,,685,,817,,-132,4902,,1886,3016,4632,,1369,-297,3263,270,139,,81678
134231,3000,Male,GM0153,Enschede,2021JJ00,2021,81678,,687,,771,,-84,5187,,2196,2991,4510,,1304,-236,3206,677,594,,82272
134232,3000,Male,GM0153,Enschede,2022JJ00,2022,82272,,633,,828,,-195,5342,,2446,2896,4886,,1489,-310,3397,456,254,,82526
134233,3000,Male,GM0153,Enschede,2023JJ00,2023,82526,,677,,805,,-128,5708,,2320,3388,5083,,1726,-474,3357,625,486,,83012
134304,3000,Male,GM0232,Epe,2012JJ00,2012,16047,,130,,151,,-21,514,,66,448,565,,51,-9,514,-51,-73,,15974
134305,3000,Male,GM0232,Epe,2013JJ00,2013,15974,,142,,151,,-9,541,,59,482,524,,47,-5,477,17,12,,15986
134306,3000,Male,GM0232,Epe,2014JJ00,2014,15986,,128,,167,,-39,542,,55,487,570,,53,-4,517,-28,-67,,15919
134307,3000,Male,GM0232,Epe,2015JJ00,2015,15919,,136,,139,,-3,592,,65,527,545,,52,-5,493,47,44,,15963
134308,3000,Male,GM0232,Epe,2016JJ00,2016,15963,,161,,162,,-1,727,,61,666,558,,34,12,524,169,168,,16131
134309,3000,Male,GM0232,Epe,2017JJ00,2017,16131,,145,,160,,-15,841,,61,780,632,,44,-6,588,209,192,,16323
134310,3000,Male,GM0232,Epe,2018JJ00,2018,16323,,165,,161,,4,732,,48,684,570,,48,-14,522,162,166,,16489
134311,3000,Male,GM0232,Epe,2019JJ00,2019,16489,,128,,176,,-48,639,,57,582,586,,39,-6,547,53,2,,16491
134312,3000,Male,GM0232,Epe,2020JJ00,2020,16491,,155,,180,,-25,709,,69,640,621,,29,6,592,88,61,,16552
134313,3000,Male,GM0232,Epe,2021JJ00,2021,16552,,170,,188,,-18,711,,66,645,642,,60,-25,582,69,51,,16603
134314,3000,Male,GM0232,Epe,2022JJ00,2022,16603,,149,,200,,-51,663,,133,530,631,,67,-11,564,32,-19,,16584
134315,3000,Male,GM0232,Epe,2023JJ00,2023,16584,,133,,194,,-61,618,,86,532,610,,66,3,544,8,-52,,16532
134386,3000,Male,GM0233,Ermelo,2012JJ00,2012,12866,,112,,122,,-10,625,,58,567,595,,46,-2,549,30,20,,12886
134387,3000,Male,GM0233,Ermelo,2013JJ00,2013,12886,,113,,141,,-28,635,,51,584,610,,20,12,590,25,-3,,12883
134388,3000,Male,GM0233,Ermelo,2014JJ00,2014,12883,,122,,118,,4,687,,53,634,624,,30,3,594,63,65,,12948
134389,3000,Male,GM0233,Ermelo,2015JJ00,2015,12948,,121,,127,,-6,820,,56,764,612,,40,5,572,208,201,,13149
134390,3000,Male,GM0233,Ermelo,2016JJ00,2016,13149,,116,,123,,-7,727,,42,685,691,,48,-5,643,36,29,,13178
134391,3000,Male,GM0233,Ermelo,2017JJ00,2017,13178,,136,,138,,-2,812,,80,732,678,,57,-16,621,134,133,,13311
134392,3000,Male,GM0233,Ermelo,2018JJ00,2018,13311,,127,,151,,-24,745,,86,659,695,,23,3,672,50,26,,13337
134393,3000,Male,GM0233,Ermelo,2019JJ00,2019,13337,,137,,143,,-6,838,,65,773,744,,29,8,715,94,89,,13426
134394,3000,Male,GM0233,Ermelo,2020JJ00,2020,13426,,102,,155,,-53,748,,56,692,686,,39,-5,647,62,11,,13437
134395,3000,Male,GM0233,Ermelo,2021JJ00,2021,13437,,118,,156,,-38,824,,77,747,646,,37,3,609,178,137,,13574
134396,3000,Male,GM0233,Ermelo,2022JJ00,2022,13574,,118,,169,,-51,810,,131,679,671,,53,-7,618,139,89,,13663
134397,3000,Male,GM0233,Ermelo,2023JJ00,2023,13663,,120,,146,,-26,823,,89,734,640,,84,-8,556,183,154,,13817
134878,3000,Male,GM0777,Etten-Leur,2012JJ00,2012,20803,,221,,146,,75,789,,114,675,760,,147,-23,613,29,104,,20907
134879,3000,Male,GM0777,Etten-Leur,2013JJ00,2013,20907,,197,,165,,32,780,,134,646,754,,116,-5,638,26,61,,20968
134880,3000,Male,GM0777,Etten-Leur,2014JJ00,2014,20968,,229,,149,,80,845,,145,700,860,,133,-28,727,-15,64,,21032
134881,3000,Male,GM0777,Etten-Leur,2015JJ00,2015,21032,,199,,171,,28,950,,157,793,861,,138,-22,723,89,118,,21150
134882,3000,Male,GM0777,Etten-Leur,2016JJ00,2016,21150,,207,,174,,33,946,,130,816,890,,137,-19,753,56,93,,21243
134883,3000,Male,GM0777,Etten-Leur,2017JJ00,2017,21243,,206,,191,,15,1100,,142,958,886,,100,-11,786,214,229,,21472
134884,3000,Male,GM0777,Etten-Leur,2018JJ00,2018,21472,,220,,159,,61,970,,154,816,928,,136,-27,792,42,105,,21577
134885,3000,Male,GM0777,Etten-Leur,2019JJ00,2019,21577,,227,,194,,33,992,,183,809,921,,141,-29,780,71,103,,21680
134886,3000,Male,GM0777,Etten-Leur,2020JJ00,2020,21680,,201,,225,,-24,971,,152,819,983,,146,-43,837,-12,-39,,21641
134887,3000,Male,GM0777,Etten-Leur,2021JJ00,2021,21641,,216,,202,,14,943,,145,798,820,,119,-27,701,123,137,,21778
134888,3000,Male,GM0777,Etten-Leur,2022JJ00,2022,21778,,206,,204,,2,1110,,232,878,883,,172,-45,711,227,229,,22007
134889,3000,Male,GM0777,Etten-Leur,2023JJ00,2023,22007,,205,,232,,-27,1274,,234,1040,915,,197,-37,718,359,332,,22339
135288,3000,Male,GM1722,Ferwerderadiel,2012JJ00,2012,4532,,58,,37,,21,137,,18,119,166,,9,1,157,-29,-8,,4524
135289,3000,Male,GM1722,Ferwerderadiel,2013JJ00,2013,4524,,44,,45,,-1,121,,11,110,173,,12,0,161,-52,-54,,4470
135290,3000,Male,GM1722,Ferwerderadiel,2014JJ00,2014,4470,,45,,26,,19,153,,14,139,171,,14,-4,157,-18,1,,4471
135291,3000,Male,GM1722,Ferwerderadiel,2015JJ00,2015,4471,,49,,43,,6,161,,5,156,186,,6,-2,180,-25,-19,,4452
135292,3000,Male,GM1722,Ferwerderadiel,2016JJ00,2016,4452,,48,,28,,20,190,,12,178,189,,15,-2,174,1,21,,4473
135293,3000,Male,GM1722,Ferwerderadiel,2017JJ00,2017,4473,,36,,36,,0,192,,8,184,240,,2,0,238,-48,-49,,4424
135294,3000,Male,GM1722,Ferwerderadiel,2018JJ00,2018,4424,,56,,42,,14,158,,12,146,215,,8,-3,207,-57,-44,,4380
135616,3000,Male,GM0070,Franekeradeel,2012JJ00,2012,10302,,78,,104,,-26,427,,39,388,430,,35,-2,395,-3,-29,,10273
135617,3000,Male,GM0070,Franekeradeel,2013JJ00,2013,10273,,80,,91,,-11,439,,62,377,431,,28,5,403,8,-3,,10270
135618,3000,Male,GM0070,Franekeradeel,2014JJ00,2014,10270,,88,,82,,6,455,,77,378,523,,75,-18,448,-68,-61,,10209
135619,3000,Male,GM0070,Franekeradeel,2015JJ00,2015,10209,,85,,90,,-5,540,,90,450,541,,76,-13,465,-1,-6,,10203
135620,3000,Male,GM0070,Franekeradeel,2016JJ00,2016,10203,,91,,97,,-6,524,,60,464,555,,49,-3,506,-31,-36,,10167
135621,3000,Male,GM0070,Franekeradeel,2017JJ00,2017,10167,,97,,94,,3,546,,57,489,519,,50,-5,469,27,27,,10194
135700,3000,Male,GM1921,De Friese Meren,2014JJ00,2014,25892,,222,,197,,25,785,,118,667,875,,116,-14,759,-90,-74,,25818
135701,3000,Male,GM1921,De Friese Meren,2015JJ00,2015,25818,,208,,235,,-27,851,,64,787,812,,59,5,753,39,14,,25832
135784,3000,Male,GM1940,De Fryske Marren,2016JJ00,2016,25832,,227,,245,,-18,1070,,93,977,896,,79,-1,817,174,156,,25988
135785,3000,Male,GM1940,De Fryske Marren,2017JJ00,2017,25988,,234,,227,,7,1240,,124,1116,1167,,106,-31,1061,73,80,,26068
135786,3000,Male,GM1940,De Fryske Marren,2018JJ00,2018,26068,,211,,264,,-53,987,,171,816,1141,,120,-47,1021,-154,-208,,25860
135787,3000,Male,GM1940,De Fryske Marren,2019JJ00,2019,25860,,233,,217,,16,1074,,137,937,1010,,85,-22,925,64,80,,25940
135788,3000,Male,GM1940,De Fryske Marren,2020JJ00,2020,25940,,246,,261,,-15,1136,,95,1041,1006,,90,-19,916,130,116,,26056
135789,3000,Male,GM1940,De Fryske Marren,2021JJ00,2021,26056,,282,,278,,4,1216,,84,1132,1262,,65,-5,1197,-46,-40,,26016
135790,3000,Male,GM1940,De Fryske Marren,2022JJ00,2022,26016,,218,,261,,-43,1316,,212,1104,1097,,116,-20,981,219,180,,26196
135791,3000,Male,GM1940,De Fryske Marren,2023JJ00,2023,26196,,193,,277,,-84,1164,,127,1037,1088,,100,-6,988,76,-7,,26189
135944,3000,Male,GM0653,Gaasterlân-Sleat,2012JJ00,2012,5148,,53,,56,,-3,147,,11,136,134,,14,-2,120,13,10,,5158
135945,3000,Male,GM0653,Gaasterlân-Sleat,2013JJ00,2013,5158,,50,,60,,-10,157,,13,144,149,,11,0,138,8,-4,,5154
136272,3000,Male,GM0779,Geertruidenberg,2012JJ00,2012,10675,,128,,96,,32,319,,32,287,329,,35,-10,294,-10,22,,10697
136273,3000,Male,GM0779,Geertruidenberg,2013JJ00,2013,10697,,115,,110,,5,343,,30,313,329,,41,-12,288,14,18,,10715
136274,3000,Male,GM0779,Geertruidenberg,2014JJ00,2014,10715,,107,,86,,21,346,,25,321,359,,42,-11,317,-13,10,,10725
136275,3000,Male,GM0779,Geertruidenberg,2015JJ00,2015,10725,,90,,93,,-3,414,,36,378,386,,44,-10,342,28,26,,10751
136276,3000,Male,GM0779,Geertruidenberg,2016JJ00,2016,10751,,94,,133,,-39,387,,26,361,401,,30,-2,371,-14,-57,,10694
136277,3000,Male,GM0779,Geertruidenberg,2017JJ00,2017,10694,,107,,91,,16,435,,32,403,449,,28,-3,421,-14,1,,10695
136278,3000,Male,GM0779,Geertruidenberg,2018JJ00,2018,10695,,109,,100,,9,373,,38,335,401,,33,-14,368,-28,-20,,10675
136279,3000,Male,GM0779,Geertruidenberg,2019JJ00,2019,10675,,87,,108,,-21,425,,40,385,379,,28,-14,351,46,25,,10700
136280,3000,Male,GM0779,Geertruidenberg,2020JJ00,2020,10700,,99,,106,,-7,513,,36,477,397,,26,4,371,116,108,,10808
136281,3000,Male,GM0779,Geertruidenberg,2021JJ00,2021,10808,,116,,113,,3,505,,35,470,396,,15,2,381,109,111,,10919
136282,3000,Male,GM0779,Geertruidenberg,2022JJ00,2022,10919,,105,,100,,5,486,,122,364,413,,43,-10,370,73,77,,10996
136283,3000,Male,GM0779,Geertruidenberg,2023JJ00,2023,10996,,98,,115,,-17,394,,51,343,387,,54,-13,333,7,-10,,10986
136518,3000,Male,GM0236,Geldermalsen,2012JJ00,2012,13052,,118,,96,,22,391,,52,339,461,,37,-3,424,-70,-45,,13007
136519,3000,Male,GM0236,Geldermalsen,2013JJ00,2013,13007,,112,,89,,23,454,,49,405,469,,48,-9,421,-15,8,,13015
136520,3000,Male,GM0236,Geldermalsen,2014JJ00,2014,13015,,123,,101,,22,467,,38,429,467,,46,-4,421,0,24,,13039
136521,3000,Male,GM0236,Geldermalsen,2015JJ00,2015,13039,,121,,90,,31,506,,67,439,516,,46,-2,470,-10,22,,13061
136522,3000,Male,GM0236,Geldermalsen,2016JJ00,2016,13061,,127,,102,,25,612,,51,561,515,,44,-7,471,97,118,,13179
136523,3000,Male,GM0236,Geldermalsen,2017JJ00,2017,13179,,136,,106,,30,737,,66,671,638,,53,-4,585,99,129,,13308
136524,3000,Male,GM0236,Geldermalsen,2018JJ00,2018,13308,,147,,108,,39,656,,65,591,584,,42,-2,542,72,124,,13432
136682,3000,Male,GM1771,Geldrop-Mierlo,2012JJ00,2012,19123,,207,,144,,63,779,,104,675,758,,91,-14,667,21,86,,19209
136683,3000,Male,GM1771,Geldrop-Mierlo,2013JJ00,2013,19209,,217,,161,,56,805,,100,705,772,,94,-19,678,33,90,,19299
136684,3000,Male,GM1771,Geldrop-Mierlo,2014JJ00,2014,19299,,190,,171,,19,897,,84,813,912,,129,-45,783,-15,1,,19300
136685,3000,Male,GM1771,Geldrop-Mierlo,2015JJ00,2015,19300,,198,,172,,26,838,,88,750,874,,105,-31,769,-36,-12,,19288
136686,3000,Male,GM1771,Geldrop-Mierlo,2016JJ00,2016,19288,,194,,186,,8,998,,101,897,926,,80,-16,846,72,80,,19368
136687,3000,Male,GM1771,Geldrop-Mierlo,2017JJ00,2017,19368,,188,,182,,6,1172,,134,1038,1081,,88,-12,993,91,97,,19465
136688,3000,Male,GM1771,Geldrop-Mierlo,2018JJ00,2018,19465,,186,,200,,-14,1094,,125,969,905,,96,-17,809,189,177,,19642
136689,3000,Male,GM1771,Geldrop-Mierlo,2019JJ00,2019,19642,,203,,199,,4,1042,,139,903,969,,93,-9,876,73,79,,19721
136690,3000,Male,GM1771,Geldrop-Mierlo,2020JJ00,2020,19721,,189,,187,,2,1158,,145,1013,948,,70,-12,878,210,213,,19934
136691,3000,Male,GM1771,Geldrop-Mierlo,2021JJ00,2021,19934,,223,,197,,26,1084,,144,940,1053,,97,-8,956,31,53,,19987
136692,3000,Male,GM1771,Geldrop-Mierlo,2022JJ00,2022,19987,,209,,192,,17,1223,,290,933,1040,,129,-5,911,183,199,,20186
136693,3000,Male,GM1771,Geldrop-Mierlo,2023JJ00,2023,20186,,153,,186,,-33,1329,,264,1065,1187,,202,-70,985,142,108,,20294
136928,3000,Male,GM1652,Gemert-Bakel,2012JJ00,2012,14658,,170,,111,,59,448,,93,355,484,,84,-31,400,-36,23,,14681
136929,3000,Male,GM1652,Gemert-Bakel,2013JJ00,2013,14681,,154,,118,,36,521,,104,417,425,,45,-7,380,96,131,,14812
136930,3000,Male,GM1652,Gemert-Bakel,2014JJ00,2014,14812,,155,,120,,35,585,,165,420,510,,76,-27,434,75,109,,14921
136931,3000,Male,GM1652,Gemert-Bakel,2015JJ00,2015,14921,,154,,134,,20,598,,134,464,542,,83,-13,459,56,74,,14995
136932,3000,Male,GM1652,Gemert-Bakel,2016JJ00,2016,14995,,143,,123,,20,673,,124,549,521,,82,-26,439,152,177,,15172
136933,3000,Male,GM1652,Gemert-Bakel,2017JJ00,2017,15172,,151,,115,,36,771,,155,616,609,,81,-10,528,162,192,,15364
136934,3000,Male,GM1652,Gemert-Bakel,2018JJ00,2018,15364,,149,,120,,29,658,,130,528,634,,111,-35,523,24,52,,15416
136935,3000,Male,GM1652,Gemert-Bakel,2019JJ00,2019,15416,,152,,113,,39,683,,139,544,549,,78,-32,471,134,171,,15587
136936,3000,Male,GM1652,Gemert-Bakel,2020JJ00,2020,15587,,138,,162,,-24,656,,140,516,633,,133,-69,500,23,-1,,15586
136937,3000,Male,GM1652,Gemert-Bakel,2021JJ00,2021,15586,,171,,126,,45,704,,115,589,582,,107,-36,475,122,167,,15753
136938,3000,Male,GM1652,Gemert-Bakel,2022JJ00,2022,15753,,167,,158,,9,695,,225,470,550,,122,-61,428,145,154,,15907
136939,3000,Male,GM1652,Gemert-Bakel,2023JJ00,2023,15907,,157,,153,,4,667,,170,497,622,,126,-36,496,45,48,,15955
137256,3000,Male,GM0907,Gennep,2012JJ00,2012,8868,,57,,77,,-20,322,,41,281,325,,33,2,292,-3,-24,,8844
137257,3000,Male,GM0907,Gennep,2013JJ00,2013,8844,,83,,94,,-11,279,,36,243,299,,27,4,272,-20,-32,,8812
137258,3000,Male,GM0907,Gennep,2014JJ00,2014,8812,,85,,72,,13,288,,39,249,303,,21,-2,282,-15,0,,8812
137259,3000,Male,GM0907,Gennep,2015JJ00,2015,8812,,83,,93,,-10,322,,42,280,387,,27,1,360,-65,-77,,8735
137260,3000,Male,GM0907,Gennep,2016JJ00,2016,8735,,70,,110,,-40,362,,52,310,311,,30,-2,281,51,11,,8746
137261,3000,Male,GM0907,Gennep,2017JJ00,2017,8746,,67,,91,,-24,368,,30,338,384,,32,-11,352,-16,-40,,8706
137262,3000,Male,GM0907,Gennep,2018JJ00,2018,8706,,79,,103,,-24,376,,51,325,351,,34,-10,317,25,2,,8708
137263,3000,Male,GM0907,Gennep,2019JJ00,2019,8708,,51,,95,,-44,374,,47,327,377,,24,2,353,-3,-47,,8661
137264,3000,Male,GM0907,Gennep,2020JJ00,2020,8661,,60,,115,,-55,460,,109,351,360,,52,-5,308,100,44,,8705
137265,3000,Male,GM0907,Gennep,2021JJ00,2021,8705,,61,,103,,-42,451,,82,369,319,,50,-12,269,132,90,,8795
137266,3000,Male,GM0907,Gennep,2022JJ00,2022,8795,,77,,111,,-34,587,,246,341,362,,88,-15,274,225,190,,8985
137267,3000,Male,GM0907,Gennep,2023JJ00,2023,8985,,50,,108,,-58,409,,97,312,345,,67,-21,278,64,5,,8990
137666,3000,Male,GM0689,Giessenlanden,2012JJ00,2012,7378,,85,,54,,31,212,,25,187,267,,24,-9,243,-55,-24,,7354
137667,3000,Male,GM0689,Giessenlanden,2013JJ00,2013,7354,,70,,46,,24,217,,19,198,252,,21,-5,231,-35,-12,,7342
137668,3000,Male,GM0689,Giessenlanden,2014JJ00,2014,7342,,85,,49,,36,262,,22,240,284,,25,3,259,-22,15,,7357
137669,3000,Male,GM0689,Giessenlanden,2015JJ00,2015,7357,,75,,50,,25,317,,23,294,300,,19,0,281,17,42,,7399
137670,3000,Male,GM0689,Giessenlanden,2016JJ00,2016,7399,,64,,56,,8,313,,29,284,316,,23,-8,293,-3,5,,7404
137671,3000,Male,GM0689,Giessenlanden,2017JJ00,2017,7404,,61,,56,,5,337,,40,297,370,,26,0,344,-33,-32,,7372
137672,3000,Male,GM0689,Giessenlanden,2018JJ00,2018,7372,,56,,47,,9,320,,43,277,338,,30,-9,308,-18,-11,,7361
137994,3000,Male,GM0784,Gilze en Rijen,2012JJ00,2012,12885,,131,,92,,39,569,,66,503,480,,67,-27,413,89,131,,13016
137995,3000,Male,GM0784,Gilze en Rijen,2013JJ00,2013,13016,,118,,102,,16,576,,110,466,539,,62,-15,477,37,54,,13070
137996,3000,Male,GM0784,Gilze en Rijen,2014JJ00,2014,13070,,132,,118,,14,549,,107,442,586,,68,-28,518,-37,-20,,13050
137997,3000,Male,GM0784,Gilze en Rijen,2015JJ00,2015,13050,,107,,103,,4,817,,348,469,765,,71,-8,694,52,58,,13108
137998,3000,Male,GM0784,Gilze en Rijen,2016JJ00,2016,13108,,125,,126,,-1,2653,,1921,732,2639,,66,-23,2573,14,24,,13132
137999,3000,Male,GM0784,Gilze en Rijen,2017JJ00,2017,13132,,134,,111,,23,1167,,540,627,1148,,70,-15,1078,19,48,,13180
138000,3000,Male,GM0784,Gilze en Rijen,2018JJ00,2018,13180,,122,,122,,0,1287,,715,572,1277,,75,-20,1202,10,12,,13192
138001,3000,Male,GM0784,Gilze en Rijen,2019JJ00,2019,13192,,118,,105,,13,1208,,669,539,1242,,88,-30,1154,-34,-10,,13182
138002,3000,Male,GM0784,Gilze en Rijen,2020JJ00,2020,13182,,128,,118,,10,2178,,1304,874,2036,,78,-31,1958,142,165,,13347
138003,3000,Male,GM0784,Gilze en Rijen,2021JJ00,2021,13347,,127,,131,,-4,2764,,2028,736,2807,,114,-50,2693,-43,-37,,13310
138004,3000,Male,GM0784,Gilze en Rijen,2022JJ00,2022,13310,,121,,149,,-28,4256,,3572,684,4044,,69,-8,3975,212,193,,13503
138005,3000,Male,GM0784,Gilze en Rijen,2023JJ00,2023,13503,,141,,110,,31,5938,,5136,802,5642,,81,-3,5561,296,357,,13860
138076,3000,Male,GM0511,Goedereede,2012JJ00,2012,5624,,53,,44,,9,129,,17,112,163,,31,-8,132,-34,-27,,5597
138159,3000,Male,GM1924,Goeree-Overflakkee,2013JJ00,2013,23886,,246,,205,,41,468,,62,406,525,,57,1,468,-57,-32,,23854
138160,3000,Male,GM1924,Goeree-Overflakkee,2014JJ00,2014,23854,,260,,196,,64,471,,50,421,533,,67,-20,466,-62,3,,23857
138161,3000,Male,GM1924,Goeree-Overflakkee,2015JJ00,2015,23857,,215,,229,,-14,563,,61,502,519,,78,-22,441,44,31,,23888
138162,3000,Male,GM1924,Goeree-Overflakkee,2016JJ00,2016,23888,,239,,217,,22,657,,45,612,524,,68,-13,456,133,154,,24042
138163,3000,Male,GM1924,Goeree-Overflakkee,2017JJ00,2017,24042,,251,,221,,30,778,,123,655,569,,74,-5,495,209,238,,24280
138164,3000,Male,GM1924,Goeree-Overflakkee,2018JJ00,2018,24280,,209,,239,,-30,832,,94,738,578,,76,-19,502,254,226,,24506
138165,3000,Male,GM1924,Goeree-Overflakkee,2019JJ00,2019,24506,,260,,265,,-5,868,,98,770,640,,71,-8,569,228,223,,24729
138166,3000,Male,GM1924,Goeree-Overflakkee,2020JJ00,2020,24729,,244,,271,,-27,891,,84,807,594,,48,-10,546,297,270,,24999
138167,3000,Male,GM1924,Goeree-Overflakkee,2021JJ00,2021,24999,,235,,268,,-33,842,,85,757,628,,63,-7,565,214,181,,25180
138168,3000,Male,GM1924,Goeree-Overflakkee,2022JJ00,2022,25180,,221,,285,,-64,917,,239,678,625,,109,-2,516,292,230,,25410
138169,3000,Male,GM1924,Goeree-Overflakkee,2023JJ00,2023,25410,,247,,257,,-10,961,,126,835,672,,95,-10,577,289,276,,25686
138240,3000,Male,GM0664,Goes,2012JJ00,2012,18046,,150,,182,,-32,950,,256,694,874,,78,-15,796,76,47,,18093
138241,3000,Male,GM0664,Goes,2013JJ00,2013,18093,,160,,204,,-44,976,,243,733,989,,95,-19,894,-13,-57,,18036
138242,3000,Male,GM0664,Goes,2014JJ00,2014,18036,,188,,141,,47,953,,156,797,859,,110,-34,749,94,140,,18176
138243,3000,Male,GM0664,Goes,2015JJ00,2015,18176,,171,,178,,-7,937,,140,797,855,,105,-30,750,82,76,,18252
138244,3000,Male,GM0664,Goes,2016JJ00,2016,18252,,150,,166,,-16,952,,119,833,910,,79,-19,831,42,22,,18274
138245,3000,Male,GM0664,Goes,2017JJ00,2017,18274,,173,,176,,-3,1098,,110,988,906,,75,-11,831,192,183,,18457
138246,3000,Male,GM0664,Goes,2018JJ00,2018,18457,,163,,213,,-50,949,,136,813,911,,119,-65,792,38,-9,,18448
138247,3000,Male,GM0664,Goes,2019JJ00,2019,18448,,172,,191,,-19,1162,,144,1018,898,,95,-14,803,264,244,,18692
138248,3000,Male,GM0664,Goes,2020JJ00,2020,18692,,176,,216,,-40,1053,,145,908,804,,73,-11,731,249,208,,18900
138249,3000,Male,GM0664,Goes,2021JJ00,2021,18900,,180,,237,,-57,1033,,155,878,766,,122,-43,644,267,211,,19111
138250,3000,Male,GM0664,Goes,2022JJ00,2022,19111,,187,,255,,-68,1156,,220,936,871,,133,-25,738,285,218,,19329
138251,3000,Male,GM0664,Goes,2023JJ00,2023,19329,,167,,244,,-77,1155,,274,881,896,,117,-21,779,259,182,,19511
138322,3000,Male,GM0785,Goirle,2012JJ00,2012,11313,,107,,100,,7,440,,39,401,416,,15,4,401,24,31,,11344
138323,3000,Male,GM0785,Goirle,2013JJ00,2013,11344,,148,,84,,64,451,,41,410,428,,18,3,410,23,87,,11431
138324,3000,Male,GM0785,Goirle,2014JJ00,2014,11431,,116,,93,,23,422,,48,374,471,,46,-11,425,-49,-25,,11406
138325,3000,Male,GM0785,Goirle,2015JJ00,2015,11406,,112,,109,,3,532,,51,481,499,,39,-5,460,33,35,,11441
138326,3000,Male,GM0785,Goirle,2016JJ00,2016,11441,,115,,111,,4,581,,47,534,481,,31,-8,450,100,102,,11543
138327,3000,Male,GM0785,Goirle,2017JJ00,2017,11543,,113,,100,,13,638,,40,598,523,,22,0,501,115,128,,11671
138328,3000,Male,GM0785,Goirle,2018JJ00,2018,11707,,124,,98,,26,611,,45,566,517,,40,-3,477,94,124,,11831
138329,3000,Male,GM0785,Goirle,2019JJ00,2019,11831,,101,,102,,-1,537,,49,488,513,,37,-3,476,24,23,,11854
138330,3000,Male,GM0785,Goirle,2020JJ00,2020,11854,,110,,130,,-20,615,,61,554,556,,37,-1,519,59,39,,11893
138331,3000,Male,GM0785,Goirle,2021JJ00,2021,11893,,114,,135,,-21,597,,59,538,585,,43,2,542,12,-11,,11882
138332,3000,Male,GM0785,Goirle,2022JJ00,2022,11882,,99,,117,,-18,593,,94,499,503,,66,-6,437,90,73,,11955
138333,3000,Male,GM0785,Goirle,2023JJ00,2023,11955,,101,,132,,-31,639,,68,571,482,,63,-6,419,157,127,,12082
138408,3000,Male,GM1942,Gooise Meren,2016JJ00,2016,27278,,262,,257,,5,1779,,225,1554,1662,,188,-40,1474,117,120,,27398
138409,3000,Male,GM1942,Gooise Meren,2017JJ00,2017,27398,,246,,235,,11,1892,,245,1647,1699,,188,-19,1511,193,207,,27605
138410,3000,Male,GM1942,Gooise Meren,2018JJ00,2018,27605,,270,,263,,7,1933,,286,1647,1678,,192,-34,1486,255,265,,27870
138411,3000,Male,GM1942,Gooise Meren,2019JJ00,2019,27870,,250,,234,,16,1923,,291,1632,1771,,213,-23,1558,152,168,,28038
138412,3000,Male,GM1942,Gooise Meren,2020JJ00,2020,28038,,269,,315,,-46,2153,,261,1892,1802,,178,-35,1624,351,306,,28344
138413,3000,Male,GM1942,Gooise Meren,2021JJ00,2021,28344,,321,,264,,57,2067,,264,1803,1945,,219,-41,1726,122,172,,28516
138414,3000,Male,GM1942,Gooise Meren,2022JJ00,2022,28516,,258,,267,,-9,2408,,448,1960,1744,,218,-28,1526,664,655,,29171
138415,3000,Male,GM1942,Gooise Meren,2023JJ00,2023,29171,,261,,319,,-58,2067,,365,1702,1970,,255,-39,1715,97,49,,29220
138568,3000,Male,GM0512,Gorinchem,2012JJ00,2012,17248,,207,,133,,74,640,,86,554,679,,110,-9,569,-39,33,,17281
138569,3000,Male,GM0512,Gorinchem,2013JJ00,2013,17281,,191,,145,,46,694,,133,561,644,,124,-15,520,50,98,,17379
138570,3000,Male,GM0512,Gorinchem,2014JJ00,2014,17379,,198,,137,,61,771,,116,655,778,,150,-38,628,-7,53,,17432
138571,3000,Male,GM0512,Gorinchem,2015JJ00,2015,17432,,175,,190,,-15,806,,139,667,858,,144,-59,714,-52,-65,,17367
138572,3000,Male,GM0512,Gorinchem,2016JJ00,2016,17367,,207,,141,,66,1091,,171,920,878,,98,-9,780,213,280,,17647
138573,3000,Male,GM0512,Gorinchem,2017JJ00,2017,17647,,203,,143,,60,1209,,186,1023,1009,,104,-22,905,200,260,,17907
138574,3000,Male,GM0512,Gorinchem,2018JJ00,2018,17907,,199,,148,,51,1000,,165,835,787,,89,0,698,213,263,,18170
138575,3000,Male,GM0512,Gorinchem,2019JJ00,2019,18170,,190,,179,,11,1043,,198,845,830,,128,-27,702,213,223,,18393
138576,3000,Male,GM0512,Gorinchem,2020JJ00,2020,18393,,203,,168,,35,1036,,185,851,886,,129,-31,757,150,185,,18578
138577,3000,Male,GM0512,Gorinchem,2021JJ00,2021,18578,,185,,180,,5,1030,,166,864,926,,133,-36,793,104,110,,18688
138578,3000,Male,GM0512,Gorinchem,2022JJ00,2022,18688,,191,,154,,37,1475,,293,1182,1090,,127,-25,963,385,425,,19113
138579,3000,Male,GM0512,Gorinchem,2023JJ00,2023,19113,,184,,190,,-6,1300,,179,1121,1208,,154,-53,1054,92,86,,19199
138732,3000,Male,GM0513,Gouda,2012JJ00,2012,34856,,452,,300,,152,1113,,180,933,1419,,246,-75,1173,-306,-152,,34704
138733,3000,Male,GM0513,Gouda,2013JJ00,2013,34704,,453,,285,,168,1245,,221,1024,1385,,188,-30,1197,-140,29,,34733
138734,3000,Male,GM0513,Gouda,2014JJ00,2014,34733,,394,,284,,110,1348,,210,1138,1352,,166,4,1186,-4,105,,34838
138735,3000,Male,GM0513,Gouda,2015JJ00,2015,34838,,398,,297,,101,1473,,250,1223,1559,,227,-48,1332,-86,17,,34855
138736,3000,Male,GM0513,Gouda,2016JJ00,2016,34855,,400,,303,,97,2050,,619,1431,1795,,430,-89,1365,255,349,,35204
138737,3000,Male,GM0513,Gouda,2017JJ00,2017,35204,,407,,330,,77,2411,,588,1823,2004,,529,-200,1475,407,481,,35685
138738,3000,Male,GM0513,Gouda,2018JJ00,2018,35685,,394,,307,,87,2183,,509,1674,2053,,485,-184,1568,130,217,,35902
138739,3000,Male,GM0513,Gouda,2019JJ00,2019,35902,,383,,317,,66,2007,,509,1498,1923,,431,-33,1492,84,145,,36047
138740,3000,Male,GM0513,Gouda,2020JJ00,2020,36047,,404,,374,,30,2163,,456,1707,1993,,317,-32,1676,170,197,,36244
138741,3000,Male,GM0513,Gouda,2021JJ00,2021,36244,,411,,357,,54,2036,,389,1647,1879,,260,-105,1619,157,210,,36454
138742,3000,Male,GM0513,Gouda,2022JJ00,2022,36454,,413,,358,,55,2442,,541,1901,1940,,350,-160,1590,502,548,,37002
138743,3000,Male,GM0513,Gouda,2023JJ00,2023,37002,,410,,374,,36,2337,,448,1889,2112,,428,-207,1684,225,261,,37263
139060,3000,Male,GM0693,Graafstroom,2012JJ00,2012,5011,,65,,35,,30,184,,9,175,166,,26,-6,140,18,43,,5054
139306,3000,Male,GM0365,Graft-De Rijp,2012JJ00,2012,3229,,27,,23,,4,108,,11,97,115,,11,-1,104,-7,-3,,3226
139307,3000,Male,GM0365,Graft-De Rijp,2013JJ00,2013,3226,,28,,25,,3,99,,8,91,86,,0,5,86,13,16,,3242
139308,3000,Male,GM0365,Graft-De Rijp,2014JJ00,2014,3242,,26,,25,,1,108,,8,100,134,,21,-1,113,-26,-26,,3216
139552,3000,Male,GM0786,Grave,2012JJ00,2012,6607,,75,,53,,22,518,,132,386,580,,22,0,558,-62,-36,,6571
139553,3000,Male,GM0786,Grave,2013JJ00,2013,6571,,54,,55,,-1,577,,254,323,587,,14,2,573,-10,-11,,6560
139554,3000,Male,GM0786,Grave,2014JJ00,2014,6560,,61,,40,,21,681,,379,302,592,,20,8,572,89,112,,6672
139555,3000,Male,GM0786,Grave,2015JJ00,2015,6672,,65,,68,,-3,607,,286,321,725,,48,-27,677,-118,-122,,6550
139556,3000,Male,GM0786,Grave,2016JJ00,2016,6550,,46,,66,,-20,634,,187,447,845,,183,-161,662,-211,-229,,6321
139557,3000,Male,GM0786,Grave,2017JJ00,2017,6321,,57,,59,,-2,569,,61,508,567,,2,12,565,2,-1,,6320
139558,3000,Male,GM0786,Grave,2018JJ00,2018,6320,,51,,65,,-14,540,,62,478,508,,1,16,507,32,19,,6339
139559,3000,Male,GM0786,Grave,2019JJ00,2019,6339,,63,,70,,-7,506,,58,448,512,,30,-15,482,-6,-12,,6327
139560,3000,Male,GM0786,Grave,2020JJ00,2020,6327,,52,,81,,-29,627,,35,592,547,,24,-6,523,80,51,,6378
139561,3000,Male,GM0786,Grave,2021JJ00,2021,6378,,46,,77,,-31,625,,36,589,642,,-1,13,643,-17,-49,,6329
139798,3000,Male,GM0518,The Hague,2012JJ00,2012,247866,,3563,,1909,,1654,15396,,6589,8807,15189,,6070,-1875,9119,207,1872,,249738
139799,3000,Male,GM0518,The Hague,2013JJ00,2013,249738,,3400,,1815,,1585,16257,,7176,9081,16305,,7215,-2788,9090,-48,1570,,251308
139800,3000,Male,GM0518,The Hague,2014JJ00,2014,251308,,3501,,1846,,1655,16775,,7381,9394,15454,,5784,-1505,9670,1321,2879,,254187
139801,3000,Male,GM0518,The Hague,2015JJ00,2015,254187,,3480,,1972,,1508,17228,,7340,9888,15751,,5507,-904,10244,1477,2855,,257042
139802,3000,Male,GM0518,The Hague,2016JJ00,2016,257042,,3500,,1982,,1518,18402,,7877,10525,17074,,6167,-1761,10907,1328,2795,,259837
139803,3000,Male,GM0518,The Hague,2017JJ00,2017,259837,,3385,,1923,,1462,19437,,8680,10757,16700,,5438,-1010,11262,2737,4138,,263975
139804,3000,Male,GM0518,The Hague,2018JJ00,2018,263975,,3320,,1987,,1333,18983,,8928,10055,17334,,6009,-1481,11325,1649,2803,,266778
139805,3000,Male,GM0518,The Hague,2019JJ00,2019,266778,,3268,,2000,,1268,20753,,10357,10396,17671,,5461,-768,12210,3082,4343,,271121
139806,3000,Male,GM0518,The Hague,2020JJ00,2020,271121,,3210,,2217,,993,19609,,8482,11127,18997,,6479,-1847,12518,612,1565,,272686
139807,3000,Male,GM0518,The Hague,2021JJ00,2021,272686,,3104,,2286,,818,20063,,9076,10987,18061,,4626,-314,13435,2002,2804,,275490
139808,3000,Male,GM0518,The Hague,2022JJ00,2022,275490,,2970,,2250,,720,23678,,12328,11350,19528,,6431,-1264,13097,4150,4848,,280338
139809,3000,Male,GM0518,The Hague,2023JJ00,2023,280338,,2911,,2206,,705,21942,,10665,11277,20754,,7052,-1559,13702,1188,1855,,282193
140536,3000,Male,GM0241,Groesbeek,2012JJ00,2012,9253,,62,,106,,-44,489,,52,437,378,,48,0,330,111,68,,9321
140537,3000,Male,GM0241,Groesbeek,2013JJ00,2013,9321,,64,,108,,-44,482,,62,420,416,,33,3,383,66,24,,9345
140538,3000,Male,GM0241,Groesbeek,2014JJ00,2014,9345,,96,,124,,-28,455,,47,408,428,,48,-2,380,27,1,,9346
140539,3000,Male,GM0241,Groesbeek,2015JJ00,2015,16981,,134,,169,,-35,910,,115,795,666,,72,-1,594,244,209,,17190
140618,3000,Male,GM0014,Groningen Municipality,2012JJ00,2012,95629,,1029,,648,,381,8866,,2059,6807,7900,,1806,-366,6094,966,1351,,96980
140619,3000,Male,GM0014,Groningen Municipality,2013JJ00,2013,96980,,999,,620,,379,9114,,2024,7090,8052,,1775,-474,6277,1062,1444,,98424
140620,3000,Male,GM0014,Groningen Municipality,2014JJ00,2014,98424,,1032,,646,,386,9663,,2299,7364,8816,,2165,-673,6651,847,1233,,99657
140621,3000,Male,GM0014,Groningen Municipality,2015JJ00,2015,99657,,1028,,627,,401,9318,,2261,7057,9223,,2065,-489,7158,95,502,,100159
140622,3000,Male,GM0014,Groningen Municipality,2016JJ00,2016,100159,,1030,,621,,409,10128,,2712,7416,9909,,2249,-583,7660,219,625,,100784
140623,3000,Male,GM0014,Groningen Municipality,2017JJ00,2017,101315,,996,,684,,312,9692,,2739,6953,10010,,2281,-634,7729,-318,-16,,101299
140624,3000,Male,GM0014,Groningen Municipality,2018JJ00,2018,101299,,938,,643,,295,9439,,2981,6458,9380,,2111,-386,7269,59,361,,101660
140625,3000,Male,GM0014,Groningen Municipality,2019JJ00,2019,114937,,1099,,843,,256,10118,,3452,6666,9460,,2390,-449,7070,658,901,,115838
140626,3000,Male,GM0014,Groningen Municipality,2020JJ00,2020,115838,,1117,,868,,249,9601,,2863,6738,9509,,2560,-489,6949,92,339,,116177
140627,3000,Male,GM0014,Groningen Municipality,2021JJ00,2021,116177,,1154,,889,,265,9810,,3526,6284,9344,,2290,-283,7054,466,717,,116894
140628,3000,Male,GM0014,Groningen Municipality,2022JJ00,2022,116894,,1005,,958,,47,10194,,4046,6148,8937,,2258,-188,6679,1257,1304,,118198
140629,3000,Male,GM0014,Groningen Municipality,2023JJ00,2023,118198,,949,,904,,45,11812,,3540,8272,9138,,2465,-206,6673,2674,2714,,120912
140946,3000,Male,GM0015,Grootegast,2012JJ00,2012,6282,,60,,49,,11,170,,5,165,232,,8,4,224,-62,-50,,6232
140947,3000,Male,GM0015,Grootegast,2013JJ00,2013,6232,,49,,46,,3,173,,16,157,197,,13,-3,184,-24,-20,,6212
140948,3000,Male,GM0015,Grootegast,2014JJ00,2014,6212,,50,,51,,-1,208,,10,198,250,,18,-8,232,-42,-43,,6169
140949,3000,Male,GM0015,Grootegast,2015JJ00,2015,6169,,70,,50,,20,285,,16,269,282,,15,1,267,3,25,,6194
140950,3000,Male,GM0015,Grootegast,2016JJ00,2016,6194,,46,,46,,0,259,,13,246,260,,11,1,249,-1,-1,,6193
140951,3000,Male,GM0015,Grootegast,2017JJ00,2017,6193,,57,,53,,4,274,,13,261,294,,8,2,286,-20,-16,,6177
140952,3000,Male,GM0015,Grootegast,2018JJ00,2018,6177,,53,,40,,13,285,,18,267,275,,9,2,266,10,32,,6209
141192,3000,Male,GM1729,Gulpen-Wittem,2012JJ00,2012,7276,,44,,69,,-25,317,,43,274,318,,42,-1,276,-1,-27,,7249
141193,3000,Male,GM1729,Gulpen-Wittem,2013JJ00,2013,7249,,54,,77,,-23,324,,43,281,279,,38,-8,241,45,23,,7272
141194,3000,Male,GM1729,Gulpen-Wittem,2014JJ00,2014,7272,,47,,76,,-29,328,,51,277,280,,32,-3,248,48,20,,7292
141195,3000,Male,GM1729,Gulpen-Wittem,2015JJ00,2015,7292,,35,,78,,-43,613,,264,349,521,,35,-5,486,92,51,,7343
141196,3000,Male,GM1729,Gulpen-Wittem,2016JJ00,2016,7343,,62,,80,,-18,613,,138,475,703,,40,-6,663,-90,-107,,7236
141197,3000,Male,GM1729,Gulpen-Wittem,2017JJ00,2017,7236,,57,,88,,-31,315,,47,268,335,,28,-5,307,-20,-55,,7181
141198,3000,Male,GM1729,Gulpen-Wittem,2018JJ00,2018,7181,,48,,90,,-42,411,,42,369,332,,38,-3,294,79,37,,7218
141199,3000,Male,GM1729,Gulpen-Wittem,2019JJ00,2019,7218,,62,,87,,-25,330,,28,302,354,,46,-10,308,-24,-50,,7168
141200,3000,Male,GM1729,Gulpen-Wittem,2020JJ00,2020,7168,,55,,116,,-61,355,,45,310,308,,26,-9,282,47,-13,,7155
141201,3000,Male,GM1729,Gulpen-Wittem,2021JJ00,2021,7155,,50,,93,,-43,348,,47,301,336,,39,-4,297,12,-31,,7124
141202,3000,Male,GM1729,Gulpen-Wittem,2022JJ00,2022,7124,,35,,97,,-62,419,,92,327,381,,61,-19,320,38,-25,,7099
141203,3000,Male,GM1729,Gulpen-Wittem,2023JJ00,2023,7099,,50,,85,,-35,325,,39,286,344,,45,-12,299,-19,-55,,7044
141356,3000,Male,GM0158,Haaksbergen,2012JJ00,2012,12291,,103,,112,,-9,311,,23,288,361,,23,6,338,-50,-60,,12231
141357,3000,Male,GM0158,Haaksbergen,2013JJ00,2013,12231,,91,,109,,-18,354,,26,328,319,,9,16,310,35,17,,12248
141358,3000,Male,GM0158,Haaksbergen,2014JJ00,2014,12248,,106,,142,,-36,375,,21,354,378,,31,9,347,-3,-39,,12209
141359,3000,Male,GM0158,Haaksbergen,2015JJ00,2015,12209,,98,,125,,-27,402,,36,366,365,,33,4,332,37,11,,12220
141360,3000,Male,GM0158,Haaksbergen,2016JJ00,2016,12220,,89,,132,,-43,407,,38,369,399,,28,10,371,8,-34,,12186
141361,3000,Male,GM0158,Haaksbergen,2017JJ00,2017,12186,,93,,125,,-32,404,,30,374,410,,18,6,392,-6,-36,,12150
141362,3000,Male,GM0158,Haaksbergen,2018JJ00,2018,12150,,102,,111,,-9,403,,33,370,395,,24,2,371,8,-1,,12149
141363,3000,Male,GM0158,Haaksbergen,2019JJ00,2019,12149,,99,,122,,-23,426,,46,380,325,,13,6,312,101,78,,12227
141364,3000,Male,GM0158,Haaksbergen,2020JJ00,2020,12227,,94,,148,,-54,400,,26,374,416,,21,4,395,-16,-72,,12155
141365,3000,Male,GM0158,Haaksbergen,2021JJ00,2021,12155,,117,,148,,-31,405,,49,356,387,,32,4,355,18,-14,,12141
141366,3000,Male,GM0158,Haaksbergen,2022JJ00,2022,12141,,104,,149,,-45,468,,77,391,348,,35,0,313,120,75,,12216
141367,3000,Male,GM0158,Haaksbergen,2023JJ00,2023,12216,,95,,140,,-45,434,,67,367,421,,40,5,381,13,-30,,12186
141520,3000,Male,GM0788,Haaren,2012JJ00,2012,6958,,54,,57,,-3,313,,24,289,293,,32,-14,261,20,17,,6975
141521,3000,Male,GM0788,Haaren,2013JJ00,2013,6975,,38,,72,,-34,293,,30,263,255,,17,-1,238,38,0,,6975
141522,3000,Male,GM0788,Haaren,2014JJ00,2014,6975,,39,,47,,-8,289,,23,266,308,,29,-5,279,-19,-26,,6949
141523,3000,Male,GM0788,Haaren,2015JJ00,2015,6949,,35,,58,,-23,373,,12,361,332,,15,0,317,41,19,,6968
141524,3000,Male,GM0788,Haaren,2016JJ00,2016,6968,,50,,65,,-15,514,,59,455,370,,48,-5,322,144,127,,7095
141525,3000,Male,GM0788,Haaren,2017JJ00,2017,7095,,57,,66,,-9,479,,65,414,404,,68,-4,336,75,64,,7159
141526,3000,Male,GM0788,Haaren,2018JJ00,2018,7159,,63,,62,,1,375,,49,326,335,,19,-3,316,40,42,,7201
141527,3000,Male,GM0788,Haaren,2019JJ00,2019,7201,,56,,69,,-13,411,,47,364,314,,41,0,273,97,84,,7285
141528,3000,Male,GM0788,Haaren,2020JJ00,2020,7285,,69,,78,,-9,357,,32,325,355,,21,-1,334,2,-10,,7275
141602,3000,Male,GM0392,Haarlem,2012JJ00,2012,73922,,989,,649,,340,4095,,795,3300,3703,,755,-215,2948,392,733,,74655
141603,3000,Male,GM0392,Haarlem,2013JJ00,2013,74655,,960,,669,,291,4265,,746,3519,3434,,544,-21,2890,831,1124,,75779
141604,3000,Male,GM0392,Haarlem,2014JJ00,2014,75779,,983,,622,,361,4632,,812,3820,4301,,920,-315,3381,331,702,,76481
141605,3000,Male,GM0392,Haarlem,2015JJ00,2015,76481,,962,,659,,303,4985,,841,4144,4363,,676,-54,3687,622,916,,77397
141606,3000,Male,GM0392,Haarlem,2016JJ00,2016,77397,,983,,702,,281,5320,,1137,4183,4966,,778,-78,4188,354,634,,78031
141607,3000,Male,GM0392,Haarlem,2017JJ00,2017,78031,,944,,700,,244,5179,,1011,4168,5255,,842,-174,4413,-76,158,,78189
141608,3000,Male,GM0392,Haarlem,2018JJ00,2018,78189,,956,,684,,272,5287,,1067,4220,4747,,752,-52,3995,540,811,,79000
141609,3000,Male,GM0392,Haarlem,2019JJ00,2019,79000,,988,,643,,345,5715,,1341,4374,5147,,826,-152,4321,568,910,,79910
141610,3000,Male,GM0392,Haarlem,2020JJ00,2020,79910,,918,,695,,223,5366,,1041,4325,5661,,794,-130,4867,-295,-74,,79836
141611,3000,Male,GM0392,Haarlem,2021JJ00,2021,79836,,965,,723,,242,5470,,1036,4434,5510,,848,-157,4662,-40,193,,80029
141612,3000,Male,GM0392,Haarlem,2022JJ00,2022,80029,,931,,745,,186,6220,,1605,4615,5317,,892,-147,4425,903,1081,,81110
141613,3000,Male,GM0392,Haarlem,2023JJ00,2023,81110,,843,,733,,110,6459,,1391,5068,5429,,948,-143,4481,1030,1141,,82251
141684,3000,Male,GM0393,Haarlemmerliede en Spaarnwoude,2012JJ00,2012,2700,,22,,15,,7,176,,22,154,154,,10,3,144,22,29,,2729
141685,3000,Male,GM0393,Haarlemmerliede en Spaarnwoude,2013JJ00,2013,2729,,17,,15,,2,141,,16,125,151,,15,3,136,-10,-9,,2720
141686,3000,Male,GM0393,Haarlemmerliede en Spaarnwoude,2014JJ00,2014,2720,,18,,16,,2,185,,14,171,161,,19,-6,142,24,24,,2744
141687,3000,Male,GM0393,Haarlemmerliede en Spaarnwoude,2015JJ00,2015,2744,,31,,19,,12,165,,9,156,164,,22,-11,142,1,13,,2757
141688,3000,Male,GM0393,Haarlemmerliede en Spaarnwoude,2016JJ00,2016,2757,,24,,24,,0,236,,16,220,177,,20,-7,157,59,59,,2816
141689,3000,Male,GM0393,Haarlemmerliede en Spaarnwoude,2017JJ00,2017,2816,,30,,12,,18,281,,18,263,185,,15,-3,170,96,113,,2929
141690,3000,Male,GM0393,Haarlemmerliede en Spaarnwoude,2018JJ00,2018,2929,,30,,12,,18,327,,69,258,175,,12,1,163,152,170,,3099
141766,3000,Male,GM0394,Haarlemmermeer,2012JJ00,2012,71554,,752,,411,,341,2723,,651,2072,2904,,502,-43,2402,-181,157,,71711
141767,3000,Male,GM0394,Haarlemmermeer,2013JJ00,2013,71711,,724,,443,,281,2743,,726,2017,2962,,515,-43,2447,-219,65,,71776
141768,3000,Male,GM0394,Haarlemmermeer,2014JJ00,2014,71699,,623,,463,,160,3438,,1187,2251,3653,,573,-116,3080,-215,-57,,71642
141769,3000,Male,GM0394,Haarlemmermeer,2015JJ00,2015,71642,,659,,430,,229,3771,,1089,2682,3818,,687,-188,3131,-47,185,,71827
141770,3000,Male,GM0394,Haarlemmermeer,2016JJ00,2016,71827,,654,,459,,195,4686,,1405,3281,4070,,674,-154,3396,616,811,,72638
141771,3000,Male,GM0394,Haarlemmermeer,2017JJ00,2017,72638,,685,,452,,233,4555,,1269,3286,4156,,650,-112,3506,399,628,,73266
141772,3000,Male,GM0394,Haarlemmermeer,2018JJ00,2018,73266,,648,,506,,142,4622,,1490,3132,4375,,706,-170,3669,247,392,,73658
141773,3000,Male,GM0394,Haarlemmermeer,2019JJ00,2019,76757,,706,,488,,218,5355,,1839,3516,4654,,683,-130,3971,701,920,,77677
141774,3000,Male,GM0394,Haarlemmermeer,2020JJ00,2020,77677,,740,,597,,143,5305,,1333,3972,4561,,795,-239,3766,744,886,,78563
141775,3000,Male,GM0394,Haarlemmermeer,2021JJ00,2021,78563,,823,,584,,239,5003,,1172,3831,4533,,708,-205,3825,470,698,,79261
141776,3000,Male,GM0394,Haarlemmermeer,2022JJ00,2022,79261,,792,,568,,224,6347,,2217,4130,5140,,825,-150,4315,1207,1428,,80689
141777,3000,Male,GM0394,Haarlemmermeer,2023JJ00,2023,80689,,735,,595,,140,6373,,1801,4572,6090,,1007,-245,5083,283,417,,81106
142176,3000,Male,GM1655,Halderberge,2012JJ00,2012,14563,,113,,142,,-29,511,,78,433,548,,78,-28,470,-37,-67,,14496
142177,3000,Male,GM1655,Halderberge,2013JJ00,2013,14496,,137,,119,,18,599,,90,509,545,,55,-6,490,54,72,,14568
142178,3000,Male,GM1655,Halderberge,2014JJ00,2014,14568,,129,,128,,1,654,,88,566,604,,101,-17,503,50,48,,14616
142179,3000,Male,GM1655,Halderberge,2015JJ00,2015,14616,,131,,116,,15,674,,83,591,661,,97,-26,564,13,30,,14646
142180,3000,Male,GM1655,Halderberge,2016JJ00,2016,14646,,136,,154,,-18,717,,87,630,658,,85,-3,573,59,41,,14687
142181,3000,Male,GM1655,Halderberge,2017JJ00,2017,14687,,127,,155,,-28,889,,167,722,681,,82,-8,599,208,178,,14865
142182,3000,Male,GM1655,Halderberge,2018JJ00,2018,14865,,141,,153,,-12,954,,249,705,747,,154,-77,593,207,195,,15060
142183,3000,Male,GM1655,Halderberge,2019JJ00,2019,15060,,131,,156,,-25,852,,148,704,826,,199,-115,627,26,2,,15062
142184,3000,Male,GM1655,Halderberge,2020JJ00,2020,15062,,130,,173,,-43,796,,131,665,671,,98,-34,573,125,79,,15141
142185,3000,Male,GM1655,Halderberge,2021JJ00,2021,15141,,136,,193,,-57,893,,129,764,678,,123,-46,555,215,159,,15300
142186,3000,Male,GM1655,Halderberge,2022JJ00,2022,15300,,130,,169,,-39,861,,178,683,680,,116,-38,564,181,145,,15445
142187,3000,Male,GM1655,Halderberge,2023JJ00,2023,15445,,139,,162,,-23,815,,149,666,707,,102,-24,605,108,84,,15529
142504,3000,Male,GM0160,Hardenberg,2012JJ00,2012,30105,,314,,222,,92,694,,63,631,736,,86,-24,650,-42,50,,30155
142505,3000,Male,GM0160,Hardenberg,2013JJ00,2013,30155,,340,,249,,91,633,,63,570,741,,58,7,683,-108,-17,,30138
142506,3000,Male,GM0160,Hardenberg,2014JJ00,2014,30138,,337,,241,,96,668,,55,613,785,,58,-9,727,-117,-21,,30117
142507,3000,Male,GM0160,Hardenberg,2015JJ00,2015,30117,,346,,231,,115,778,,71,707,832,,49,18,783,-54,64,,30181
142508,3000,Male,GM0160,Hardenberg,2016JJ00,2016,30181,,311,,263,,48,1074,,92,982,846,,73,0,773,228,277,,30458
142509,3000,Male,GM0160,Hardenberg,2017JJ00,2017,30458,,335,,251,,84,1309,,142,1167,1164,,91,-14,1073,145,229,,30687
142510,3000,Male,GM0160,Hardenberg,2018JJ00,2018,30687,,284,,247,,37,1114,,136,978,1113,,101,-29,1012,1,38,,30725
142511,3000,Male,GM0160,Hardenberg,2019JJ00,2019,30725,,326,,226,,100,1198,,238,960,1095,,129,-27,966,103,202,,30927
142512,3000,Male,GM0160,Hardenberg,2020JJ00,2020,30927,,313,,278,,35,1202,,156,1046,1009,,90,-31,919,193,226,,31153
142513,3000,Male,GM0160,Hardenberg,2021JJ00,2021,31153,,366,,305,,61,1386,,87,1299,1196,,97,-34,1099,190,249,,31402
142514,3000,Male,GM0160,Hardenberg,2022JJ00,2022,31402,,312,,275,,37,1466,,167,1299,1183,,110,-24,1073,283,324,,31726
142515,3000,Male,GM0160,Hardenberg,2023JJ00,2023,31726,,308,,274,,34,1289,,99,1190,1077,,137,-48,940,212,247,,31973
142586,3000,Male,GM0243,Harderwijk,2012JJ00,2012,22376,,304,,151,,153,865,,108,757,930,,107,-36,823,-65,87,,22463
142587,3000,Male,GM0243,Harderwijk,2013JJ00,2013,22463,,277,,190,,87,840,,104,736,886,,102,-30,784,-46,40,,22503
142588,3000,Male,GM0243,Harderwijk,2014JJ00,2014,22503,,262,,162,,100,924,,101,823,978,,101,-9,877,-54,52,,22555
142589,3000,Male,GM0243,Harderwijk,2015JJ00,2015,22555,,280,,163,,117,1042,,121,921,1008,,100,-11,908,34,152,,22707
142590,3000,Male,GM0243,Harderwijk,2016JJ00,2016,22707,,272,,189,,83,1063,,109,954,936,,85,4,851,127,206,,22913
142591,3000,Male,GM0243,Harderwijk,2017JJ00,2017,22913,,245,,185,,60,1350,,157,1193,1188,,50,22,1138,162,225,,23138
142592,3000,Male,GM0243,Harderwijk,2018JJ00,2018,23138,,241,,188,,53,1594,,165,1429,1276,,112,-33,1164,318,372,,23510
142593,3000,Male,GM0243,Harderwijk,2019JJ00,2019,23510,,300,,185,,115,1610,,182,1428,1270,,120,-41,1150,340,454,,23964
142594,3000,Male,GM0243,Harderwijk,2020JJ00,2020,23964,,261,,218,,43,1518,,171,1347,1432,,163,-65,1269,86,125,,24089
142595,3000,Male,GM0243,Harderwijk,2021JJ00,2021,24089,,276,,239,,37,1435,,141,1294,1381,,139,-54,1242,54,88,,24177
142596,3000,Male,GM0243,Harderwijk,2022JJ00,2022,24177,,271,,191,,80,1290,,188,1102,1300,,130,-45,1170,-10,69,,24246
142597,3000,Male,GM0243,Harderwijk,2023JJ00,2023,24246,,216,,228,,-12,1468,,182,1286,1243,,138,-51,1105,225,212,,24458
142750,3000,Male,GM0523,Hardinxveld-Giessendam,2012JJ00,2012,8768,,118,,76,,42,212,,26,186,192,,13,-6,179,20,60,,8828
142751,3000,Male,GM0523,Hardinxveld-Giessendam,2013JJ00,2013,8828,,114,,66,,48,199,,28,171,240,,24,-8,216,-41,9,,8837
142752,3000,Male,GM0523,Hardinxveld-Giessendam,2014JJ00,2014,8837,,119,,58,,61,251,,26,225,256,,28,1,228,-5,56,,8893
142753,3000,Male,GM0523,Hardinxveld-Giessendam,2015JJ00,2015,8893,,108,,72,,36,261,,33,228,295,,22,-7,273,-34,3,,8896
142754,3000,Male,GM0523,Hardinxveld-Giessendam,2016JJ00,2016,8896,,108,,78,,30,328,,22,306,309,,19,-3,290,19,49,,8945
142755,3000,Male,GM0523,Hardinxveld-Giessendam,2017JJ00,2017,8945,,99,,76,,23,300,,16,284,280,,13,-2,267,20,42,,8987
142756,3000,Male,GM0523,Hardinxveld-Giessendam,2018JJ00,2018,8987,,123,,77,,46,321,,22,299,341,,17,-2,324,-20,27,,9014
142757,3000,Male,GM0523,Hardinxveld-Giessendam,2019JJ00,2019,9014,,123,,81,,42,341,,30,311,271,,14,-3,257,70,118,,9132
142758,3000,Male,GM0523,Hardinxveld-Giessendam,2020JJ00,2020,9132,,125,,103,,22,342,,27,315,334,,21,-2,313,8,30,,9162
142759,3000,Male,GM0523,Hardinxveld-Giessendam,2021JJ00,2021,9162,,131,,93,,38,390,,41,349,370,,18,-6,352,20,57,,9219
142760,3000,Male,GM0523,Hardinxveld-Giessendam,2022JJ00,2022,9219,,119,,84,,35,363,,107,256,348,,50,-9,298,15,50,,9269
142761,3000,Male,GM0523,Hardinxveld-Giessendam,2023JJ00,2023,9269,,116,,85,,31,347,,59,288,320,,53,-14,267,27,59,,9328
142832,3000,Male,GM0017,Haren,2012JJ00,2012,8729,,73,,115,,-42,640,,56,584,510,,66,-5,444,130,87,,8816
142833,3000,Male,GM0017,Haren,2013JJ00,2013,8816,,88,,120,,-32,670,,54,616,525,,44,-2,481,145,112,,8928
142834,3000,Male,GM0017,Haren,2014JJ00,2014,8928,,74,,88,,-14,641,,56,585,549,,47,-6,502,92,78,,9006
142835,3000,Male,GM0017,Haren,2015JJ00,2015,9006,,88,,113,,-25,1085,,415,670,954,,44,-5,910,131,108,,9114
142836,3000,Male,GM0017,Haren,2016JJ00,2016,9114,,87,,107,,-20,1084,,242,842,851,,53,1,798,233,215,,9329
142837,3000,Male,GM0017,Haren,2017JJ00,2017,9329,,88,,99,,-11,891,,56,835,731,,73,-30,658,160,149,,9478
142838,3000,Male,GM0017,Haren,2018JJ00,2018,9478,,76,,99,,-23,777,,63,714,573,,41,-4,532,204,183,,9661
142914,3000,Male,GM0395,Harenkarspel,2012JJ00,2012,8301,,71,,59,,12,271,,22,249,327,,34,-4,293,-56,-34,,8267
142996,3000,Male,GM0072,Harlingen,2012JJ00,2012,7957,,87,,87,,0,333,,37,296,317,,26,-1,291,16,16,,7973
142997,3000,Male,GM0072,Harlingen,2013JJ00,2013,7973,,64,,84,,-20,315,,23,292,332,,31,-11,301,-17,-37,,7936
142998,3000,Male,GM0072,Harlingen,2014JJ00,2014,7936,,63,,82,,-19,320,,26,294,309,,25,-6,284,11,-8,,7928
142999,3000,Male,GM0072,Harlingen,2015JJ00,2015,7928,,64,,90,,-26,389,,52,337,319,,26,-6,293,70,42,,7970
143000,3000,Male,GM0072,Harlingen,2016JJ00,2016,7970,,68,,90,,-22,397,,22,375,350,,27,-7,323,47,23,,7993
143001,3000,Male,GM0072,Harlingen,2017JJ00,2017,7993,,55,,95,,-40,403,,23,380,407,,19,-2,388,-4,-44,,7949
143002,3000,Male,GM0072,Harlingen,2018JJ00,2018,7949,,60,,76,,-16,339,,32,307,349,,17,4,332,-10,-25,,7924
143003,3000,Male,GM0072,Harlingen,2019JJ00,2019,7924,,61,,77,,-16,371,,34,337,399,,30,-3,369,-28,-45,,7879
143004,3000,Male,GM0072,Harlingen,2020JJ00,2020,7879,,56,,88,,-32,414,,51,363,335,,11,6,324,79,47,,7926
143005,3000,Male,GM0072,Harlingen,2021JJ00,2021,7926,,66,,97,,-31,407,,48,359,336,,16,-3,320,71,40,,7966
143006,3000,Male,GM0072,Harlingen,2022JJ00,2022,7966,,50,,124,,-74,508,,97,411,285,,35,-12,250,223,149,,8115
143007,3000,Male,GM0072,Harlingen,2023JJ00,2023,8115,,64,,105,,-41,454,,48,406,372,,46,-10,326,82,39,,8154
143324,3000,Male,GM0244,Hattem,2012JJ00,2012,5785,,53,,58,,-5,189,,13,176,215,,12,1,203,-26,-31,,5754
143325,3000,Male,GM0244,Hattem,2013JJ00,2013,5754,,71,,47,,24,197,,11,186,218,,21,2,197,-21,3,,5757
143326,3000,Male,GM0244,Hattem,2014JJ00,2014,5757,,71,,52,,19,265,,25,240,214,,13,-1,201,51,70,,5827
143327,3000,Male,GM0244,Hattem,2015JJ00,2015,5827,,48,,60,,-12,273,,21,252,248,,25,0,223,25,12,,5839
143328,3000,Male,GM0244,Hattem,2016JJ00,2016,5839,,67,,53,,14,306,,16,290,229,,23,-2,206,77,92,,5931
143329,3000,Male,GM0244,Hattem,2017JJ00,2017,5931,,60,,44,,16,303,,21,282,242,,13,2,229,61,77,,6008
143330,3000,Male,GM0244,Hattem,2018JJ00,2018,6008,,56,,48,,8,305,,15,290,268,,14,-1,254,37,44,,6052
143331,3000,Male,GM0244,Hattem,2019JJ00,2019,6052,,51,,66,,-15,268,,19,249,247,,13,0,234,21,7,,6059
143332,3000,Male,GM0244,Hattem,2020JJ00,2020,6059,,66,,63,,3,256,,15,241,260,,17,1,243,-4,-1,,6058
143333,3000,Male,GM0244,Hattem,2021JJ00,2021,6058,,66,,63,,3,281,,21,260,249,,14,-1,235,32,35,,6093
143334,3000,Male,GM0244,Hattem,2022JJ00,2022,6093,,62,,56,,6,352,,55,297,241,,16,-1,225,111,118,,6211
143335,3000,Male,GM0244,Hattem,2023JJ00,2023,6211,,65,,58,,7,309,,19,290,298,,20,0,278,11,18,,6229
143816,3000,Male,GM0396,Heemskerk,2012JJ00,2012,19245,,208,,180,,28,788,,98,690,849,,93,-16,756,-61,-33,,19212
143817,3000,Male,GM0396,Heemskerk,2013JJ00,2013,19212,,174,,191,,-17,767,,89,678,811,,98,-31,713,-44,-60,,19152
143818,3000,Male,GM0396,Heemskerk,2014JJ00,2014,19152,,160,,187,,-27,918,,68,850,833,,115,-14,718,85,58,,19210
143819,3000,Male,GM0396,Heemskerk,2015JJ00,2015,19210,,167,,202,,-35,1032,,68,964,908,,112,-21,796,124,88,,19298
143820,3000,Male,GM0396,Heemskerk,2016JJ00,2016,19298,,171,,231,,-60,931,,70,861,965,,78,-17,887,-34,-97,,19201
143821,3000,Male,GM0396,Heemskerk,2017JJ00,2017,19201,,170,,211,,-41,940,,88,852,944,,82,-10,862,-4,-44,,19157
143822,3000,Male,GM0396,Heemskerk,2018JJ00,2018,19157,,156,,210,,-54,937,,114,823,871,,83,-2,788,66,12,,19169
143823,3000,Male,GM0396,Heemskerk,2019JJ00,2019,19169,,163,,197,,-34,936,,98,838,886,,98,-29,788,50,15,,19184
143824,3000,Male,GM0396,Heemskerk,2020JJ00,2020,19184,,191,,245,,-54,945,,78,867,926,,74,-20,852,19,-35,,19149
143825,3000,Male,GM0396,Heemskerk,2021JJ00,2021,19149,,194,,241,,-47,864,,57,807,827,,79,-16,748,37,-5,,19144
143826,3000,Male,GM0396,Heemskerk,2022JJ00,2022,19144,,189,,206,,-17,995,,114,881,842,,71,4,771,153,137,,19281
143827,3000,Male,GM0396,Heemskerk,2023JJ00,2023,19281,,184,,249,,-65,868,,72,796,792,,61,5,731,76,12,,19293
143898,3000,Male,GM0397,Heemstede,2012JJ00,2012,12351,,88,,124,,-36,701,,81,620,647,,86,-11,561,54,20,,12371
143899,3000,Male,GM0397,Heemstede,2013JJ00,2013,12371,,96,,134,,-38,733,,88,645,706,,71,4,635,27,-12,,12359
143900,3000,Male,GM0397,Heemstede,2014JJ00,2014,12359,,90,,123,,-33,822,,67,755,766,,106,-17,660,56,24,,12383
143901,3000,Male,GM0397,Heemstede,2015JJ00,2015,12383,,104,,151,,-47,910,,90,820,730,,73,-5,657,180,134,,12517
143902,3000,Male,GM0397,Heemstede,2016JJ00,2016,12517,,121,,140,,-19,936,,117,819,774,,87,-7,687,162,144,,12661
143903,3000,Male,GM0397,Heemstede,2017JJ00,2017,12661,,101,,161,,-60,960,,97,863,802,,61,-6,741,158,97,,12758
143904,3000,Male,GM0397,Heemstede,2018JJ00,2018,12758,,109,,139,,-30,938,,159,779,766,,67,-8,699,172,142,,12900
143905,3000,Male,GM0397,Heemstede,2019JJ00,2019,12900,,98,,146,,-48,856,,129,727,829,,92,-3,737,27,-25,,12875
143906,3000,Male,GM0397,Heemstede,2020JJ00,2020,12875,,107,,174,,-67,1122,,113,1009,850,,53,-4,797,272,203,,13078
143907,3000,Male,GM0397,Heemstede,2021JJ00,2021,13078,,104,,170,,-66,887,,102,785,821,,57,2,764,66,0,,13078
143908,3000,Male,GM0397,Heemstede,2022JJ00,2022,13078,,93,,172,,-79,950,,164,786,809,,92,-2,717,141,65,,13143
143909,3000,Male,GM0397,Heemstede,2023JJ00,2023,13143,,91,,154,,-63,883,,107,776,850,,97,-7,753,33,-32,,13111
144308,3000,Male,GM0246,Heerde,2012JJ00,2012,8998,,88,,90,,-2,318,,32,286,269,,23,-12,246,49,46,,9044
144309,3000,Male,GM0246,Heerde,2013JJ00,2013,9044,,77,,97,,-20,343,,24,319,274,,10,2,264,69,49,,9093
144310,3000,Male,GM0246,Heerde,2014JJ00,2014,9093,,83,,88,,-5,323,,12,311,317,,17,1,300,6,1,,9094
144311,3000,Male,GM0246,Heerde,2015JJ00,2015,9094,,81,,85,,-4,353,,29,324,305,,28,-6,277,48,46,,9140
144312,3000,Male,GM0246,Heerde,2016JJ00,2016,9140,,79,,91,,-12,392,,22,370,375,,30,-5,345,17,6,,9146
144313,3000,Male,GM0246,Heerde,2017JJ00,2017,9146,,76,,91,,-15,413,,29,384,369,,25,-6,344,44,29,,9175
144314,3000,Male,GM0246,Heerde,2018JJ00,2018,9175,,90,,91,,-1,376,,27,349,401,,21,-5,380,-25,-26,,9149
144315,3000,Male,GM0246,Heerde,2019JJ00,2019,9149,,75,,100,,-25,404,,22,382,350,,22,-3,328,54,29,,9178
144316,3000,Male,GM0246,Heerde,2020JJ00,2020,9178,,84,,129,,-45,459,,32,427,338,,11,3,327,121,76,,9254
144317,3000,Male,GM0246,Heerde,2021JJ00,2021,9254,,95,,98,,-3,466,,21,445,333,,17,1,316,133,130,,9384
144318,3000,Male,GM0246,Heerde,2022JJ00,2022,9384,,85,,106,,-21,459,,76,383,326,,42,-7,284,133,111,,9495
144319,3000,Male,GM0246,Heerde,2023JJ00,2023,9495,,55,,110,,-55,374,,42,332,335,,27,-1,308,39,-15,,9480
144472,3000,Male,GM0074,Heerenveen,2012JJ00,2012,21401,,236,,213,,23,885,,71,814,954,,92,-14,862,-69,-45,,21356
144473,3000,Male,GM0074,Heerenveen,2013JJ00,2013,21356,,193,,187,,6,849,,68,781,854,,82,-11,772,-5,-1,,21355
144474,3000,Male,GM0074,Heerenveen,2014JJ00,2014,24612,,295,,252,,43,1093,,95,998,1000,,98,-19,902,93,135,,24747
144475,3000,Male,GM0074,Heerenveen,2015JJ00,2015,24747,,250,,243,,7,1184,,112,1072,1047,,98,-20,949,137,143,,24890
144476,3000,Male,GM0074,Heerenveen,2016JJ00,2016,24890,,225,,272,,-47,1212,,132,1080,1155,,112,-20,1043,57,7,,24897
144477,3000,Male,GM0074,Heerenveen,2017JJ00,2017,24897,,239,,220,,19,1195,,118,1077,1188,,122,-27,1066,7,26,,24923
144478,3000,Male,GM0074,Heerenveen,2018JJ00,2018,24923,,238,,274,,-36,1231,,108,1123,1136,,114,-25,1022,95,61,,24984
144479,3000,Male,GM0074,Heerenveen,2019JJ00,2019,24984,,203,,256,,-53,1300,,135,1165,1114,,99,-5,1015,186,131,,25115
144480,3000,Male,GM0074,Heerenveen,2020JJ00,2020,25115,,244,,276,,-32,1186,,98,1088,1062,,83,-1,979,124,92,,25207
144481,3000,Male,GM0074,Heerenveen,2021JJ00,2021,25207,,232,,259,,-27,1329,,96,1233,1014,,79,-7,935,315,285,,25492
144482,3000,Male,GM0074,Heerenveen,2022JJ00,2022,25492,,209,,287,,-78,1359,,242,1117,1068,,103,-11,965,291,214,,25706
144483,3000,Male,GM0074,Heerenveen,2023JJ00,2023,25706,,213,,287,,-74,1319,,159,1160,1146,,130,-15,1016,173,97,,25803
144636,3000,Male,GM0398,Heerhugowaard,2012JJ00,2012,26460,,308,,160,,148,1248,,135,1113,1240,,105,25,1135,8,156,,26616
144637,3000,Male,GM0398,Heerhugowaard,2013JJ00,2013,26616,,289,,178,,111,1337,,156,1181,1233,,97,8,1136,104,220,,26836
144638,3000,Male,GM0398,Heerhugowaard,2014JJ00,2014,26836,,314,,159,,155,1288,,150,1138,1329,,102,45,1227,-41,117,,26953
144639,3000,Male,GM0398,Heerhugowaard,2015JJ00,2015,26953,,277,,178,,99,1425,,135,1290,1382,,124,-17,1258,43,143,,27096
144640,3000,Male,GM0398,Heerhugowaard,2016JJ00,2016,27096,,310,,173,,137,2157,,549,1608,1667,,158,-32,1509,490,623,,27719
144641,3000,Male,GM0398,Heerhugowaard,2017JJ00,2017,27719,,325,,184,,141,2011,,225,1786,1664,,122,-21,1542,347,488,,28207
144642,3000,Male,GM0398,Heerhugowaard,2018JJ00,2018,28207,,339,,198,,141,1927,,206,1721,1595,,112,-5,1483,332,470,,28677
144643,3000,Male,GM0398,Heerhugowaard,2019JJ00,2019,28677,,288,,183,,105,2000,,192,1808,1741,,147,-26,1594,259,365,,29042
144644,3000,Male,GM0398,Heerhugowaard,2020JJ00,2020,29042,,304,,239,,65,2029,,139,1890,1718,,129,-29,1589,311,375,,29417
144645,3000,Male,GM0398,Heerhugowaard,2021JJ00,2021,29417,,333,,248,,85,1935,,154,1781,1675,,144,-32,1531,260,366,,29783
144800,3000,Male,GM0917,Heerlen,2012JJ00,2012,44003,,372,,470,,-98,2516,,417,2099,2500,,359,-116,2141,16,-80,,43923
144801,3000,Male,GM0917,Heerlen,2013JJ00,2013,43923,,393,,464,,-71,2456,,473,1983,2533,,428,-198,2105,-77,-144,,43779
144802,3000,Male,GM0917,Heerlen,2014JJ00,2014,43779,,368,,481,,-113,2426,,478,1948,2742,,519,-231,2223,-316,-430,,43349
144803,3000,Male,GM0917,Heerlen,2015JJ00,2015,43349,,373,,512,,-139,2603,,544,2059,2505,,402,-124,2103,98,-40,,43309
144804,3000,Male,GM0917,Heerlen,2016JJ00,2016,43309,,371,,526,,-155,3112,,697,2415,2975,,425,-174,2550,137,-19,,43290
144805,3000,Male,GM0917,Heerlen,2017JJ00,2017,43290,,358,,500,,-142,2788,,442,2346,2834,,429,-177,2405,-46,-190,,43100
144806,3000,Male,GM0917,Heerlen,2018JJ00,2018,43100,,318,,536,,-218,2878,,506,2372,2678,,427,-184,2251,200,-18,,43082
144807,3000,Male,GM0917,Heerlen,2019JJ00,2019,43082,,349,,520,,-171,3071,,520,2551,2654,,408,-131,2246,417,239,,43321
144808,3000,Male,GM0917,Heerlen,2020JJ00,2020,43321,,368,,556,,-188,2971,,470,2501,2750,,389,-121,2361,221,35,,43356
144809,3000,Male,GM0917,Heerlen,2021JJ00,2021,43356,,366,,629,,-263,3197,,485,2712,2875,,465,-207,2410,322,46,,43402
144810,3000,Male,GM0917,Heerlen,2022JJ00,2022,43402,,353,,587,,-234,3042,,606,2436,2753,,462,-161,2291,289,54,,43456
144811,3000,Male,GM0917,Heerlen,2023JJ00,2023,43456,,352,,588,,-236,3138,,672,2466,2673,,488,-194,2185,465,223,,43679
145210,3000,Male,GM1658,Heeze-Leende,2012JJ00,2012,7754,,60,,63,,-3,238,,32,206,226,,25,0,201,12,11,,7765
145211,3000,Male,GM1658,Heeze-Leende,2013JJ00,2013,7765,,46,,73,,-27,289,,43,246,262,,41,-1,221,27,0,,7765
145212,3000,Male,GM1658,Heeze-Leende,2014JJ00,2014,7765,,69,,79,,-10,348,,60,288,252,,38,-1,214,96,85,,7850
145213,3000,Male,GM1658,Heeze-Leende,2015JJ00,2015,7850,,68,,76,,-8,351,,46,305,271,,34,0,237,80,71,,7921
145214,3000,Male,GM1658,Heeze-Leende,2016JJ00,2016,7921,,63,,80,,-17,361,,27,334,291,,28,-3,263,70,53,,7974
145215,3000,Male,GM1658,Heeze-Leende,2017JJ00,2017,7974,,69,,89,,-20,406,,43,363,332,,34,2,298,74,54,,8028
145216,3000,Male,GM1658,Heeze-Leende,2018JJ00,2018,8028,,53,,88,,-35,389,,46,343,323,,35,-3,288,66,31,,8059
145217,3000,Male,GM1658,Heeze-Leende,2019JJ00,2019,8059,,73,,95,,-22,407,,51,356,309,,31,-2,278,98,76,,8135
145218,3000,Male,GM1658,Heeze-Leende,2020JJ00,2020,8135,,64,,94,,-30,385,,51,334,317,,36,-4,281,68,39,,8174
145219,3000,Male,GM1658,Heeze-Leende,2021JJ00,2021,8174,,81,,95,,-14,461,,47,414,338,,30,-3,308,123,108,,8282
145220,3000,Male,GM1658,Heeze-Leende,2022JJ00,2022,8282,,73,,94,,-21,407,,80,327,324,,55,-9,269,83,64,,8346
145221,3000,Male,GM1658,Heeze-Leende,2023JJ00,2023,8346,,73,,73,,0,415,,66,349,302,,38,-5,264,113,111,,8457
145456,3000,Male,GM0399,Heiloo,2012JJ00,2012,11140,,93,,81,,12,454,,46,408,474,,42,12,432,-20,-8,,11132
145457,3000,Male,GM0399,Heiloo,2013JJ00,2013,11132,,62,,108,,-46,483,,39,444,461,,35,8,426,22,-23,,11109
145458,3000,Male,GM0399,Heiloo,2014JJ00,2014,11109,,70,,100,,-30,538,,46,492,483,,31,3,452,55,25,,11134
145459,3000,Male,GM0399,Heiloo,2015JJ00,2015,11134,,88,,95,,-7,647,,46,601,581,,32,3,549,66,60,,11194
145460,3000,Male,GM0399,Heiloo,2016JJ00,2016,11194,,85,,127,,-42,703,,54,649,546,,29,7,517,157,115,,11309
145461,3000,Male,GM0399,Heiloo,2017JJ00,2017,11309,,75,,96,,-21,765,,57,708,632,,48,2,584,133,112,,11421
145462,3000,Male,GM0399,Heiloo,2018JJ00,2018,11421,,92,,110,,-18,747,,67,680,566,,48,0,518,181,164,,11585
145463,3000,Male,GM0399,Heiloo,2019JJ00,2019,11585,,90,,94,,-4,830,,70,760,604,,50,-1,554,226,224,,11809
145464,3000,Male,GM0399,Heiloo,2020JJ00,2020,11809,,96,,127,,-31,758,,53,705,632,,40,2,592,126,96,,11905
145465,3000,Male,GM0399,Heiloo,2021JJ00,2021,11905,,101,,137,,-36,722,,46,676,520,,41,-6,479,202,166,,12071
145466,3000,Male,GM0399,Heiloo,2022JJ00,2022,12071,,95,,146,,-51,635,,74,561,645,,77,-7,568,-10,-59,,12012
145467,3000,Male,GM0399,Heiloo,2023JJ00,2023,12012,,90,,144,,-54,678,,59,619,610,,57,-4,553,68,13,,12025
146030,3000,Male,GM0400,Den Helder,2012JJ00,2012,28284,,315,,263,,52,911,,180,731,1057,,189,-33,868,-146,-95,,28189
146031,3000,Male,GM0400,Den Helder,2013JJ00,2013,28189,,257,,270,,-13,782,,178,604,970,,234,-29,736,-188,-199,,27990
146032,3000,Male,GM0400,Den Helder,2014JJ00,2014,27990,,287,,247,,40,899,,254,645,946,,173,1,773,-47,-7,,27983
146033,3000,Male,GM0400,Den Helder,2015JJ00,2015,27983,,265,,303,,-38,1222,,528,694,1314,,200,-31,1114,-92,-129,,27854
146034,3000,Male,GM0400,Den Helder,2016JJ00,2016,27854,,262,,234,,28,1425,,402,1023,1554,,170,-7,1384,-129,-104,,27750
146035,3000,Male,GM0400,Den Helder,2017JJ00,2017,27750,,257,,290,,-33,1155,,190,965,1323,,147,-8,1176,-168,-200,,27550
146036,3000,Male,GM0400,Den Helder,2018JJ00,2018,27550,,254,,274,,-20,1086,,202,884,1130,,174,-42,956,-44,-69,,27481
146037,3000,Male,GM0400,Den Helder,2019JJ00,2019,27481,,274,,282,,-8,1525,,422,1103,1069,,148,2,921,456,445,,27926
146038,3000,Male,GM0400,Den Helder,2020JJ00,2020,27926,,252,,292,,-40,1356,,250,1106,1143,,160,-38,983,213,168,,28094
146039,3000,Male,GM0400,Den Helder,2021JJ00,2021,28094,,257,,352,,-95,1419,,163,1256,1437,,174,-31,1263,-18,-115,,27979
146040,3000,Male,GM0400,Den Helder,2022JJ00,2022,27979,,230,,308,,-78,1352,,282,1070,1250,,182,-42,1068,102,17,,27996
146041,3000,Male,GM0400,Den Helder,2023JJ00,2023,27996,,286,,355,,-69,1229,,220,1009,1176,,190,-28,986,53,-18,,27978
146112,3000,Male,GM0163,Hellendoorn,2012JJ00,2012,17887,,179,,159,,20,347,,35,312,383,,31,-2,352,-36,-16,,17871
146113,3000,Male,GM0163,Hellendoorn,2013JJ00,2013,17871,,167,,179,,-12,374,,27,347,370,,27,2,343,4,-9,,17862
146114,3000,Male,GM0163,Hellendoorn,2014JJ00,2014,17862,,148,,154,,-6,404,,25,379,471,,45,-13,426,-67,-73,,17789
146115,3000,Male,GM0163,Hellendoorn,2015JJ00,2015,17789,,173,,167,,6,436,,36,400,416,,20,-2,396,20,27,,17816
146116,3000,Male,GM0163,Hellendoorn,2016JJ00,2016,17816,,170,,163,,7,529,,36,493,460,,22,3,438,69,76,,17892
146117,3000,Male,GM0163,Hellendoorn,2017JJ00,2017,17892,,170,,183,,-13,493,,36,457,509,,42,-6,467,-16,-32,,17860
146118,3000,Male,GM0163,Hellendoorn,2018JJ00,2018,17860,,157,,200,,-43,528,,41,487,461,,25,2,436,67,25,,17885
146119,3000,Male,GM0163,Hellendoorn,2019JJ00,2019,17885,,164,,169,,-5,489,,43,446,458,,40,-6,418,31,28,,17913
146120,3000,Male,GM0163,Hellendoorn,2020JJ00,2020,17913,,157,,185,,-28,501,,40,461,438,,27,0,411,63,36,,17949
146121,3000,Male,GM0163,Hellendoorn,2021JJ00,2021,17949,,190,,203,,-13,475,,31,444,420,,28,-1,392,55,43,,17992
146122,3000,Male,GM0163,Hellendoorn,2022JJ00,2022,17992,,134,,191,,-57,595,,148,447,421,,51,-6,370,174,117,,18109
146123,3000,Male,GM0163,Hellendoorn,2023JJ00,2023,18109,,171,,215,,-44,527,,86,441,479,,71,-7,408,48,3,,18112
146194,3000,Male,GM0530,Hellevoetsluis,2012JJ00,2012,19718,,187,,159,,28,668,,199,469,990,,454,-125,536,-322,-296,,19422
146195,3000,Male,GM0530,Hellevoetsluis,2013JJ00,2013,19422,,188,,154,,34,606,,97,509,717,,119,-35,598,-111,-76,,19346
146196,3000,Male,GM0530,Hellevoetsluis,2014JJ00,2014,19346,,163,,115,,48,595,,95,500,698,,129,-46,569,-103,-58,,19288
146197,3000,Male,GM0530,Hellevoetsluis,2015JJ00,2015,19288,,163,,149,,14,641,,99,542,784,,107,-27,677,-143,-120,,19168
146198,3000,Male,GM0530,Hellevoetsluis,2016JJ00,2016,19168,,173,,152,,21,735,,87,648,761,,90,-16,671,-26,-7,,19161
146199,3000,Male,GM0530,Hellevoetsluis,2017JJ00,2017,19161,,154,,145,,9,818,,101,717,786,,86,-20,700,32,42,,19203
146200,3000,Male,GM0530,Hellevoetsluis,2018JJ00,2018,19793,,182,,174,,8,824,,105,719,812,,69,-3,743,12,26,,19819
146201,3000,Male,GM0530,Hellevoetsluis,2019JJ00,2019,19819,,158,,173,,-15,943,,151,792,863,,85,-5,778,80,62,,19881
146202,3000,Male,GM0530,Hellevoetsluis,2020JJ00,2020,19881,,176,,166,,10,859,,90,769,847,,104,-35,743,12,24,,19905
146203,3000,Male,GM0530,Hellevoetsluis,2021JJ00,2021,19905,,180,,183,,-3,873,,106,767,741,,96,-13,645,132,131,,20036
146204,3000,Male,GM0530,Hellevoetsluis,2022JJ00,2022,20036,,206,,175,,31,1016,,136,880,799,,63,4,736,217,225,,20261
146276,3000,Male,GM0794,Helmond,2012JJ00,2012,44567,,521,,330,,191,1486,,297,1189,1565,,286,-27,1279,-79,110,,44677
146277,3000,Male,GM0794,Helmond,2013JJ00,2013,44677,,469,,333,,136,1617,,279,1338,1657,,327,-62,1330,-40,95,,44772
146278,3000,Male,GM0794,Helmond,2014JJ00,2014,44772,,492,,329,,163,1766,,383,1383,1689,,363,-49,1326,77,235,,45007
146279,3000,Male,GM0794,Helmond,2015JJ00,2015,45007,,487,,356,,131,1824,,358,1466,1663,,370,-57,1293,161,287,,45294
146280,3000,Male,GM0794,Helmond,2016JJ00,2016,45294,,447,,357,,90,1959,,359,1600,1704,,255,-9,1449,255,342,,45636
146281,3000,Male,GM0794,Helmond,2017JJ00,2017,45636,,454,,380,,74,2141,,445,1696,2032,,349,-95,1683,109,183,,45819
146282,3000,Male,GM0794,Helmond,2018JJ00,2018,45819,,457,,353,,104,2245,,449,1796,1947,,315,-60,1632,298,403,,46222
146283,3000,Male,GM0794,Helmond,2019JJ00,2019,46222,,449,,376,,73,2329,,542,1787,1940,,350,-79,1590,389,461,,46683
146284,3000,Male,GM0794,Helmond,2020JJ00,2020,46683,,433,,453,,-20,2262,,483,1779,2147,,384,-90,1763,115,92,,46775
146285,3000,Male,GM0794,Helmond,2021JJ00,2021,46775,,484,,463,,21,2431,,484,1947,2044,,377,-71,1667,387,409,,47184
146286,3000,Male,GM0794,Helmond,2022JJ00,2022,47184,,450,,397,,53,2715,,697,2018,2025,,416,-46,1609,690,737,,47921
146287,3000,Male,GM0794,Helmond,2023JJ00,2023,47921,,467,,441,,26,2637,,607,2030,2149,,492,-114,1657,488,515,,48436
146686,3000,Male,GM0531,Hendrik-Ido-Ambacht,2012JJ00,2012,13848,,222,,92,,130,585,,38,547,492,,45,-5,447,93,228,,14076
146687,3000,Male,GM0531,Hendrik-Ido-Ambacht,2013JJ00,2013,14076,,176,,68,,108,573,,46,527,550,,54,-12,496,23,130,,14206
146688,3000,Male,GM0531,Hendrik-Ido-Ambacht,2014JJ00,2014,14206,,194,,86,,108,590,,42,548,561,,48,-4,513,29,137,,14343
146689,3000,Male,GM0531,Hendrik-Ido-Ambacht,2015JJ00,2015,14343,,196,,88,,108,649,,52,597,572,,62,-7,510,77,186,,14529
146690,3000,Male,GM0531,Hendrik-Ido-Ambacht,2016JJ00,2016,14529,,176,,105,,71,732,,39,693,682,,36,3,646,50,120,,14649
146691,3000,Male,GM0531,Hendrik-Ido-Ambacht,2017JJ00,2017,14649,,192,,116,,76,1031,,46,985,673,,25,-1,648,358,434,,15083
146692,3000,Male,GM0531,Hendrik-Ido-Ambacht,2018JJ00,2018,15083,,207,,105,,102,726,,38,688,698,,42,1,656,28,130,,15213
146693,3000,Male,GM0531,Hendrik-Ido-Ambacht,2019JJ00,2019,15213,,210,,119,,91,762,,42,720,722,,49,-8,673,40,131,,15344
146694,3000,Male,GM0531,Hendrik-Ido-Ambacht,2020JJ00,2020,15344,,216,,129,,87,634,,41,593,694,,45,-11,649,-60,29,,15373
146695,3000,Male,GM0531,Hendrik-Ido-Ambacht,2021JJ00,2021,15373,,188,,127,,61,880,,25,855,742,,36,-6,706,138,200,,15573
146696,3000,Male,GM0531,Hendrik-Ido-Ambacht,2022JJ00,2022,15573,,195,,109,,86,833,,113,720,659,,36,1,623,174,261,,15834
146697,3000,Male,GM0531,Hendrik-Ido-Ambacht,2023JJ00,2023,15834,,165,,122,,43,951,,89,862,712,,52,-25,660,239,282,,16116
146850,3000,Male,GM0164,Hengelo (O.),2012JJ00,2012,40290,,388,,335,,53,1481,,200,1281,1497,,253,-68,1244,-16,37,,40327
146851,3000,Male,GM0164,Hengelo (O.),2013JJ00,2013,40327,,438,,358,,80,1457,,165,1292,1492,,220,-15,1272,-35,48,,40375
146852,3000,Male,GM0164,Hengelo (O.),2014JJ00,2014,40375,,402,,331,,71,1523,,199,1324,1500,,272,-29,1228,23,91,,40466
146853,3000,Male,GM0164,Hengelo (O.),2015JJ00,2015,40466,,411,,330,,81,1650,,296,1354,1642,,259,-39,1383,8,88,,40554
146854,3000,Male,GM0164,Hengelo (O.),2016JJ00,2016,40554,,362,,368,,-6,2020,,297,1723,2091,,223,-12,1868,-71,-79,,40475
146855,3000,Male,GM0164,Hengelo (O.),2017JJ00,2017,40475,,336,,359,,-23,1780,,248,1532,1845,,250,-37,1595,-65,-94,,40381
146856,3000,Male,GM0164,Hengelo (O.),2018JJ00,2018,40381,,373,,408,,-35,1843,,311,1532,1717,,207,-12,1510,126,88,,40469
146857,3000,Male,GM0164,Hengelo (O.),2019JJ00,2019,40469,,358,,393,,-35,1969,,327,1642,1620,,221,-3,1399,349,316,,40785
146858,3000,Male,GM0164,Hengelo (O.),2020JJ00,2020,40785,,351,,417,,-66,1982,,296,1686,1924,,224,-58,1700,58,-9,,40776
146859,3000,Male,GM0164,Hengelo (O.),2021JJ00,2021,40776,,372,,436,,-64,2187,,352,1835,1837,,238,-39,1599,350,286,,41062
146860,3000,Male,GM0164,Hengelo (O.),2022JJ00,2022,41062,,371,,414,,-43,2452,,611,1841,1919,,320,-73,1599,533,482,,41544
146861,3000,Male,GM0164,Hengelo (O.),2023JJ00,2023,41544,,376,,391,,-15,2436,,419,2017,2056,,305,-61,1751,380,362,,41906
147260,3000,Male,GM0796,s-Hertogenbosch,2012JJ00,2012,69808,,896,,552,,344,3184,,448,2736,3058,,584,-152,2474,126,468,,70276
147261,3000,Male,GM0796,s-Hertogenbosch,2013JJ00,2013,70276,,873,,507,,366,3222,,439,2783,3010,,475,-84,2535,212,580,,70856
147262,3000,Male,GM0796,s-Hertogenbosch,2014JJ00,2014,70856,,873,,520,,353,3299,,417,2882,3491,,508,-61,2983,-192,172,,71028
147263,3000,Male,GM0796,s-Hertogenbosch,2015JJ00,2015,74424,,844,,559,,285,3730,,501,3229,3633,,469,-76,3164,97,383,,74807
147264,3000,Male,GM0796,s-Hertogenbosch,2016JJ00,2016,74807,,909,,604,,305,4563,,560,4003,4405,,494,-78,3911,158,469,,75276
147265,3000,Male,GM0796,s-Hertogenbosch,2017JJ00,2017,75276,,824,,603,,221,4227,,590,3637,3938,,453,-105,3485,289,512,,75788
147266,3000,Male,GM0796,s-Hertogenbosch,2018JJ00,2018,75788,,788,,654,,134,4121,,686,3435,3844,,558,-125,3286,277,413,,76201
147267,3000,Male,GM0796,s-Hertogenbosch,2019JJ00,2019,76201,,772,,655,,117,4244,,647,3597,3955,,513,-81,3442,289,405,,76606
147268,3000,Male,GM0796,s-Hertogenbosch,2020JJ00,2020,76606,,785,,741,,44,4218,,589,3629,3975,,399,-59,3576,243,285,,76891
147269,3000,Male,GM0796,s-Hertogenbosch,2021JJ00,2021,76891,,870,,751,,119,4394,,694,3700,3919,,475,-72,3444,475,592,,77483
147270,3000,Male,GM0796,s-Hertogenbosch,2022JJ00,2022,77483,,825,,751,,74,5060,,1364,3696,3969,,619,-132,3350,1091,1166,,78649
147271,3000,Male,GM0796,s-Hertogenbosch,2023JJ00,2023,78649,,765,,743,,22,5228,,1081,4147,4106,,636,-128,3470,1122,1143,,79792
147670,3000,Male,GM0252,Heumen,2012JJ00,2012,8128,,76,,49,,27,354,,23,331,347,,26,-2,321,7,35,,8163
147671,3000,Male,GM0252,Heumen,2013JJ00,2013,8163,,59,,51,,8,318,,26,292,368,,35,-4,333,-50,-41,,8122
147672,3000,Male,GM0252,Heumen,2014JJ00,2014,8122,,77,,67,,10,413,,38,375,390,,14,10,376,23,34,,8156
147673,3000,Male,GM0252,Heumen,2015JJ00,2015,8156,,53,,82,,-29,432,,44,388,442,,42,-6,400,-10,-39,,8117
147674,3000,Male,GM0252,Heumen,2016JJ00,2016,8117,,67,,76,,-9,887,,37,850,837,,36,-5,801,50,42,,8159
147675,3000,Male,GM0252,Heumen,2017JJ00,2017,8159,,71,,73,,-2,485,,39,446,473,,41,-10,432,12,10,,8169
147676,3000,Male,GM0252,Heumen,2018JJ00,2018,8169,,62,,61,,1,461,,35,426,453,,22,1,431,8,10,,8179
147677,3000,Male,GM0252,Heumen,2019JJ00,2019,8179,,50,,71,,-21,498,,47,451,479,,29,-4,450,19,0,,8179
147678,3000,Male,GM0252,Heumen,2020JJ00,2020,8179,,88,,82,,6,498,,35,463,428,,33,-6,395,70,78,,8257
147679,3000,Male,GM0252,Heumen,2021JJ00,2021,8257,,67,,76,,-9,747,,56,691,435,,51,-10,384,312,301,,8558
147680,3000,Male,GM0252,Heumen,2022JJ00,2022,8558,,85,,76,,9,527,,101,426,733,,59,-24,674,-206,-198,,8360
147681,3000,Male,GM0252,Heumen,2023JJ00,2023,8360,,63,,69,,-6,576,,78,498,517,,44,-2,473,59,51,,8411
147752,3000,Male,GM0797,Heusden,2012JJ00,2012,21553,,215,,153,,62,726,,108,618,746,,84,-26,662,-20,46,,21599
147753,3000,Male,GM0797,Heusden,2013JJ00,2013,21599,,194,,163,,31,728,,145,583,745,,105,-22,640,-17,15,,21614
147754,3000,Male,GM0797,Heusden,2014JJ00,2014,21614,,223,,157,,66,779,,143,636,876,,154,-47,722,-97,-29,,21585
147755,3000,Male,GM0797,Heusden,2015JJ00,2015,21585,,185,,150,,35,914,,159,755,881,,139,-30,742,33,67,,21652
147756,3000,Male,GM0797,Heusden,2016JJ00,2016,21652,,208,,172,,36,920,,155,765,811,,93,-33,718,109,148,,21800
147757,3000,Male,GM0797,Heusden,2017JJ00,2017,21800,,214,,183,,31,991,,186,805,909,,121,-36,788,82,113,,21913
147758,3000,Male,GM0797,Heusden,2018JJ00,2018,21913,,177,,190,,-13,1140,,234,906,900,,146,-37,754,240,226,,22139
147759,3000,Male,GM0797,Heusden,2019JJ00,2019,22139,,205,,188,,17,1218,,217,1001,949,,161,-39,788,269,286,,22425
147760,3000,Male,GM0797,Heusden,2020JJ00,2020,22425,,180,,205,,-25,1174,,219,955,983,,146,-35,837,191,165,,22590
147761,3000,Male,GM0797,Heusden,2021JJ00,2021,22590,,241,,210,,31,1285,,297,988,1018,,161,-41,857,267,296,,22886
147762,3000,Male,GM0797,Heusden,2022JJ00,2022,22886,,208,,206,,2,1070,,287,783,1033,,213,-58,820,37,40,,22926
147763,3000,Male,GM0797,Heusden,2023JJ00,2023,22926,,201,,242,,-41,1193,,248,945,1084,,208,-67,876,109,72,,22998
147916,3000,Male,GM0534,Hillegom,2012JJ00,2012,10304,,96,,104,,-8,461,,64,397,447,,81,-20,366,14,6,,10310
147917,3000,Male,GM0534,Hillegom,2013JJ00,2013,10310,,109,,90,,19,496,,84,412,434,,42,-4,392,62,79,,10389
147918,3000,Male,GM0534,Hillegom,2014JJ00,2014,10389,,118,,113,,5,514,,79,435,453,,73,-14,380,61,69,,10458
147919,3000,Male,GM0534,Hillegom,2015JJ00,2015,10458,,97,,96,,1,526,,93,433,527,,75,-11,452,-1,-5,,10453
147920,3000,Male,GM0534,Hillegom,2016JJ00,2016,10453,,77,,105,,-28,642,,84,558,524,,89,-18,435,118,92,,10545
147921,3000,Male,GM0534,Hillegom,2017JJ00,2017,10545,,115,,110,,5,806,,99,707,518,,53,4,465,288,293,,10838
147922,3000,Male,GM0534,Hillegom,2018JJ00,2018,10838,,105,,115,,-10,630,,87,543,566,,48,-7,518,64,54,,10892
147923,3000,Male,GM0534,Hillegom,2019JJ00,2019,10892,,97,,94,,3,626,,103,523,491,,58,-1,433,135,140,,11032
147924,3000,Male,GM0534,Hillegom,2020JJ00,2020,11032,,110,,99,,11,584,,106,478,598,,74,-23,524,-14,-7,,11025
147925,3000,Male,GM0534,Hillegom,2021JJ00,2021,11025,,118,,147,,-29,650,,113,537,555,,80,-17,475,95,67,,11092
147926,3000,Male,GM0534,Hillegom,2022JJ00,2022,11092,,102,,105,,-3,669,,140,529,598,,69,-11,529,71,68,,11160
147927,3000,Male,GM0534,Hillegom,2023JJ00,2023,11160,,110,,121,,-11,784,,163,621,604,,113,-15,491,180,170,,11330
147998,3000,Male,GM0798,Hilvarenbeek,2012JJ00,2012,7602,,64,,47,,17,204,,25,179,191,,21,1,170,13,31,,7633
147999,3000,Male,GM0798,Hilvarenbeek,2013JJ00,2013,7633,,52,,62,,-10,219,,21,198,217,,23,-3,194,2,-7,,7626
148000,3000,Male,GM0798,Hilvarenbeek,2014JJ00,2014,7626,,54,,53,,1,220,,27,193,254,,27,-5,227,-34,-35,,7591
148001,3000,Male,GM0798,Hilvarenbeek,2015JJ00,2015,7591,,58,,58,,0,288,,35,253,255,,27,-6,228,33,37,,7628
148002,3000,Male,GM0798,Hilvarenbeek,2016JJ00,2016,7628,,57,,61,,-4,323,,50,273,246,,34,-1,212,77,73,,7701
148003,3000,Male,GM0798,Hilvarenbeek,2017JJ00,2017,7701,,47,,72,,-25,344,,27,317,289,,19,-1,270,55,30,,7731
148004,3000,Male,GM0798,Hilvarenbeek,2018JJ00,2018,7731,,72,,80,,-8,275,,27,248,293,,42,-7,251,-18,-26,,7705
148005,3000,Male,GM0798,Hilvarenbeek,2019JJ00,2019,7705,,53,,66,,-13,340,,42,298,254,,36,-2,218,86,74,,7779
148006,3000,Male,GM0798,Hilvarenbeek,2020JJ00,2020,7779,,72,,80,,-8,399,,49,350,295,,25,-6,270,104,96,,7875
148007,3000,Male,GM0798,Hilvarenbeek,2021JJ00,2021,7875,,73,,77,,-4,316,,38,278,268,,41,-7,227,48,43,,7918
148008,3000,Male,GM0798,Hilvarenbeek,2022JJ00,2022,7918,,83,,73,,10,319,,82,237,287,,39,-6,248,32,41,,7959
148009,3000,Male,GM0798,Hilvarenbeek,2023JJ00,2023,7959,,75,,76,,-1,283,,45,238,262,,27,-6,235,21,20,,7979
148080,3000,Male,GM0402,Hilversum,2012JJ00,2012,41587,,478,,384,,94,2588,,476,2112,2334,,441,-88,1893,254,347,,41934
148081,3000,Male,GM0402,Hilversum,2013JJ00,2013,41934,,418,,405,,13,2492,,501,1991,2274,,417,-34,1857,218,234,,42168
148082,3000,Male,GM0402,Hilversum,2014JJ00,2014,42168,,475,,403,,72,2886,,638,2248,2509,,446,-106,2063,377,451,,42619
148083,3000,Male,GM0402,Hilversum,2015JJ00,2015,42619,,482,,424,,58,3046,,719,2327,2776,,497,-73,2279,270,335,,42954
148084,3000,Male,GM0402,Hilversum,2016JJ00,2016,42954,,451,,399,,52,3385,,725,2660,2781,,446,-55,2335,604,657,,43611
148085,3000,Male,GM0402,Hilversum,2017JJ00,2017,43611,,467,,415,,52,3406,,752,2654,3130,,490,-52,2640,276,326,,43937
148086,3000,Male,GM0402,Hilversum,2018JJ00,2018,43937,,470,,418,,52,3285,,877,2408,2991,,480,-62,2511,294,343,,44280
148087,3000,Male,GM0402,Hilversum,2019JJ00,2019,44280,,462,,399,,63,3500,,893,2607,3226,,511,-71,2715,274,339,,44619
148088,3000,Male,GM0402,Hilversum,2020JJ00,2020,44619,,455,,447,,8,3301,,724,2577,3099,,476,-78,2623,202,209,,44828
148089,3000,Male,GM0402,Hilversum,2021JJ00,2021,44828,,457,,461,,-4,3418,,727,2691,3143,,474,-57,2669,275,264,,45092
148090,3000,Male,GM0402,Hilversum,2022JJ00,2022,45092,,488,,425,,63,4018,,1219,2799,3203,,515,-37,2688,815,877,,45969
148091,3000,Male,GM0402,Hilversum,2023JJ00,2023,45969,,433,,439,,-6,3690,,950,2740,3096,,457,-64,2639,594,574,,46543
148415,3000,Male,GM1963,Hoeksche Waard,2019JJ00,2019,42894,,412,,426,,-14,1417,,146,1271,1078,,121,-20,957,339,317,,43211
148416,3000,Male,GM1963,Hoeksche Waard,2020JJ00,2020,43211,,401,,452,,-51,1441,,102,1339,1133,,104,-18,1029,308,259,,43470
148417,3000,Male,GM1963,Hoeksche Waard,2021JJ00,2021,43470,,436,,440,,-4,1516,,93,1423,1180,,92,1,1088,336,327,,43797
148418,3000,Male,GM1963,Hoeksche Waard,2022JJ00,2022,43797,,388,,432,,-44,1860,,250,1610,1317,,171,-25,1146,543,494,,44291
148419,3000,Male,GM1963,Hoeksche Waard,2023JJ00,2023,44291,,402,,423,,-21,1640,,201,1439,1377,,153,-26,1224,263,242,,44533
148818,3000,Male,GM1735,Hof van Twente,2012JJ00,2012,17676,,139,,166,,-27,532,,108,424,713,,93,-29,620,-181,-208,,17468
148819,3000,Male,GM1735,Hof van Twente,2013JJ00,2013,17468,,156,,179,,-23,450,,57,393,514,,59,-17,455,-64,-85,,17383
148820,3000,Male,GM1735,Hof van Twente,2014JJ00,2014,17383,,144,,175,,-31,538,,78,460,508,,50,-11,458,30,0,,17383
148821,3000,Male,GM1735,Hof van Twente,2015JJ00,2015,17383,,143,,196,,-53,558,,90,468,552,,90,-8,462,6,-50,,17333
148822,3000,Male,GM1735,Hof van Twente,2016JJ00,2016,17333,,134,,188,,-54,677,,124,553,553,,58,-12,495,124,73,,17406
148823,3000,Male,GM1735,Hof van Twente,2017JJ00,2017,17406,,137,,205,,-68,642,,102,540,606,,99,-16,507,36,-28,,17378
148824,3000,Male,GM1735,Hof van Twente,2018JJ00,2018,17378,,138,,191,,-53,727,,198,529,662,,129,-28,533,65,12,,17390
148825,3000,Male,GM1735,Hof van Twente,2019JJ00,2019,17390,,123,,185,,-62,702,,140,562,569,,98,-1,471,133,72,,17462
148826,3000,Male,GM1735,Hof van Twente,2020JJ00,2020,17462,,135,,218,,-83,748,,148,600,646,,117,-28,529,102,21,,17483
148827,3000,Male,GM1735,Hof van Twente,2021JJ00,2021,17483,,146,,226,,-80,707,,118,589,600,,117,-17,483,107,26,,17509
148828,3000,Male,GM1735,Hof van Twente,2022JJ00,2022,17509,,141,,197,,-56,803,,223,580,563,,93,-7,470,240,185,,17694
148829,3000,Male,GM1735,Hof van Twente,2023JJ00,2023,17694,,144,,237,,-93,782,,170,612,652,,113,-24,539,130,38,,17732
148907,3000,Male,GM1966,Het Hogeland,2019JJ00,2019,24066,,209,,245,,-36,942,,102,840,931,,98,-33,833,11,-24,,24042
148908,3000,Male,GM1966,Het Hogeland,2020JJ00,2020,24042,,205,,271,,-66,958,,107,851,882,,63,-15,819,76,10,,24052
148909,3000,Male,GM1966,Het Hogeland,2021JJ00,2021,24052,,224,,250,,-26,985,,80,905,885,,99,-23,786,100,74,,24126
148910,3000,Male,GM1966,Het Hogeland,2022JJ00,2022,24126,,178,,290,,-112,1266,,172,1094,1087,,97,-21,990,179,62,,24188
148911,3000,Male,GM1966,Het Hogeland,2023JJ00,2023,24188,,201,,263,,-62,1226,,109,1117,1207,,125,-26,1082,19,-40,,24148
148982,3000,Male,GM1911,Hollands Kroon,2012JJ00,2012,24150,,223,,161,,62,684,,95,589,798,,98,-16,700,-114,-66,,24084
148983,3000,Male,GM1911,Hollands Kroon,2013JJ00,2013,24084,,200,,159,,41,678,,129,549,773,,87,-9,686,-95,-53,,24031
148984,3000,Male,GM1911,Hollands Kroon,2014JJ00,2014,24031,,235,,200,,35,815,,240,575,863,,177,-26,686,-48,7,,24038
148985,3000,Male,GM1911,Hollands Kroon,2015JJ00,2015,24038,,204,,171,,33,887,,151,736,908,,139,-8,769,-21,14,,24052
148986,3000,Male,GM1911,Hollands Kroon,2016JJ00,2016,24052,,231,,185,,46,906,,117,789,906,,106,-20,800,0,45,,24097
148987,3000,Male,GM1911,Hollands Kroon,2017JJ00,2017,24097,,217,,197,,20,1060,,145,915,1029,,132,-34,897,31,52,,24149
148988,3000,Male,GM1911,Hollands Kroon,2018JJ00,2018,24149,,223,,214,,9,1057,,207,850,958,,100,-6,858,99,108,,24257
148989,3000,Male,GM1911,Hollands Kroon,2019JJ00,2019,24257,,216,,204,,12,1505,,611,894,1133,,306,-130,827,372,382,,24639
148990,3000,Male,GM1911,Hollands Kroon,2020JJ00,2020,24639,,217,,207,,10,1392,,554,838,1318,,445,-101,873,74,85,,24724
148991,3000,Male,GM1911,Hollands Kroon,2021JJ00,2021,24724,,225,,244,,-19,1381,,372,1009,1281,,467,-108,814,100,77,,24801
148992,3000,Male,GM1911,Hollands Kroon,2022JJ00,2022,24801,,231,,231,,0,1622,,612,1010,1317,,466,-64,851,305,302,,25103
148993,3000,Male,GM1911,Hollands Kroon,2023JJ00,2023,25103,,214,,235,,-21,1342,,453,889,1214,,388,-40,826,128,109,,25212
149638,3000,Male,GM0118,Hoogeveen,2012JJ00,2012,27281,,297,,224,,73,830,,92,738,882,,46,20,836,-52,19,,27300
149639,3000,Male,GM0118,Hoogeveen,2013JJ00,2013,27300,,273,,243,,30,743,,76,667,891,,77,-14,814,-148,-125,,27175
149640,3000,Male,GM0118,Hoogeveen,2014JJ00,2014,27175,,300,,240,,60,810,,68,742,767,,56,5,711,43,106,,27281
149641,3000,Male,GM0118,Hoogeveen,2015JJ00,2015,27281,,285,,244,,41,1458,,612,846,1216,,95,-16,1121,242,282,,27563
149642,3000,Male,GM0118,Hoogeveen,2016JJ00,2016,27563,,264,,272,,-8,1553,,434,1119,1521,,95,-40,1426,32,24,,27587
149643,3000,Male,GM0118,Hoogeveen,2017JJ00,2017,27587,,296,,246,,50,1279,,227,1052,1066,,60,-6,1006,213,257,,27844
149644,3000,Male,GM0118,Hoogeveen,2018JJ00,2018,27844,,258,,272,,-14,1375,,304,1071,1335,,197,-114,1138,40,27,,27871
149645,3000,Male,GM0118,Hoogeveen,2019JJ00,2019,27871,,269,,248,,21,1210,,189,1021,1232,,140,-53,1092,-22,1,,27872
149646,3000,Male,GM0118,Hoogeveen,2020JJ00,2020,27872,,255,,284,,-29,1147,,154,993,1151,,91,-25,1060,-4,-33,,27839
149647,3000,Male,GM0118,Hoogeveen,2021JJ00,2021,27839,,276,,342,,-66,1558,,156,1402,1294,,129,-59,1165,264,196,,28035
149648,3000,Male,GM0118,Hoogeveen,2022JJ00,2022,28035,,233,,355,,-122,1767,,347,1420,1452,,125,-48,1327,315,192,,28227
149649,3000,Male,GM0118,Hoogeveen,2023JJ00,2023,28227,,216,,292,,-76,1639,,252,1387,1422,,187,-75,1235,217,137,,28364
149802,3000,Male,GM0018,Hoogezand-Sappemeer,2012JJ00,2012,17161,,165,,170,,-5,630,,49,581,744,,89,-35,655,-114,-118,,17043
149803,3000,Male,GM0018,Hoogezand-Sappemeer,2013JJ00,2013,17043,,172,,186,,-14,596,,90,506,673,,77,-18,596,-77,-92,,16951
149804,3000,Male,GM0018,Hoogezand-Sappemeer,2014JJ00,2014,16951,,156,,180,,-24,751,,130,621,724,,130,-82,594,27,4,,16955
149805,3000,Male,GM0018,Hoogezand-Sappemeer,2015JJ00,2015,16955,,161,,192,,-31,711,,84,627,722,,77,-15,645,-11,-42,,16913
149806,3000,Male,GM0018,Hoogezand-Sappemeer,2016JJ00,2016,16913,,153,,182,,-29,794,,91,703,769,,64,-16,705,25,-7,,16906
149807,3000,Male,GM0018,Hoogezand-Sappemeer,2017JJ00,2017,16906,,129,,206,,-77,902,,89,813,801,,63,-20,738,101,26,,16932
150212,3000,Male,GM0405,Hoorn,2012JJ00,2012,35131,,437,,262,,175,1227,,210,1017,1428,,258,-116,1170,-201,-27,,35104
150213,3000,Male,GM0405,Hoorn,2013JJ00,2013,35104,,411,,260,,151,1270,,193,1077,1208,,112,2,1096,62,209,,35313
150214,3000,Male,GM0405,Hoorn,2014JJ00,2014,35313,,406,,269,,137,1252,,214,1038,1299,,167,-26,1132,-47,87,,35400
150215,3000,Male,GM0405,Hoorn,2015JJ00,2015,35400,,416,,311,,105,1590,,238,1352,1548,,228,-24,1320,42,150,,35550
150216,3000,Male,GM0405,Hoorn,2016JJ00,2016,35550,,391,,272,,119,1689,,293,1396,1624,,240,-78,1384,65,184,,35734
150217,3000,Male,GM0405,Hoorn,2017JJ00,2017,35734,,407,,296,,111,1756,,323,1433,1673,,227,-1,1446,83,191,,35925
150218,3000,Male,GM0405,Hoorn,2018JJ00,2018,35925,,363,,305,,58,1742,,355,1387,1707,,270,-83,1437,35,94,,36019
150219,3000,Male,GM0405,Hoorn,2019JJ00,2019,36019,,391,,351,,40,1706,,425,1281,1615,,269,-58,1346,91,130,,36149
150220,3000,Male,GM0405,Hoorn,2020JJ00,2020,36149,,400,,352,,48,1848,,363,1485,1749,,343,-79,1406,99,152,,36301
150221,3000,Male,GM0405,Hoorn,2021JJ00,2021,36301,,401,,378,,23,1947,,345,1602,1651,,301,-64,1350,296,321,,36622
150222,3000,Male,GM0405,Hoorn,2022JJ00,2022,36622,,391,,353,,38,2070,,528,1542,1664,,323,-111,1341,406,441,,37063
150223,3000,Male,GM0405,Hoorn,2023JJ00,2023,37063,,353,,357,,-4,1912,,463,1449,1720,,377,-142,1343,192,186,,37249
150622,3000,Male,GM1507,Horst aan de Maas,2012JJ00,2012,21119,,188,,168,,20,547,,116,431,600,,98,-17,502,-53,-32,,21087
150623,3000,Male,GM1507,Horst aan de Maas,2013JJ00,2013,21087,,174,,189,,-15,507,,126,381,603,,97,-14,506,-96,-112,,20975
150624,3000,Male,GM1507,Horst aan de Maas,2014JJ00,2014,20975,,184,,156,,28,635,,151,484,654,,104,-18,550,-19,9,,20984
150625,3000,Male,GM1507,Horst aan de Maas,2015JJ00,2015,20984,,197,,190,,7,654,,141,513,636,,110,-17,526,18,25,,21009
150626,3000,Male,GM1507,Horst aan de Maas,2016JJ00,2016,21009,,195,,170,,25,819,,235,584,646,,120,-29,526,173,201,,21210
150627,3000,Male,GM1507,Horst aan de Maas,2017JJ00,2017,21210,,191,,186,,5,843,,210,633,778,,156,-29,622,65,71,,21281
150628,3000,Male,GM1507,Horst aan de Maas,2018JJ00,2018,21281,,181,,174,,7,880,,219,661,827,,164,-52,663,53,60,,21341
150629,3000,Male,GM1507,Horst aan de Maas,2019JJ00,2019,21341,,170,,217,,-47,879,,309,570,784,,169,-35,615,95,47,,21388
150630,3000,Male,GM1507,Horst aan de Maas,2020JJ00,2020,21388,,165,,234,,-69,873,,286,587,783,,226,-59,557,90,21,,21409
150631,3000,Male,GM1507,Horst aan de Maas,2021JJ00,2021,21409,,204,,210,,-6,1049,,345,704,758,,233,-60,525,291,285,,21694
150632,3000,Male,GM1507,Horst aan de Maas,2022JJ00,2022,21694,,190,,218,,-28,1101,,445,656,834,,278,-42,556,267,240,,21934
150633,3000,Male,GM1507,Horst aan de Maas,2023JJ00,2023,21934,,165,,205,,-40,1186,,590,596,979,,345,-53,634,207,164,,22098
150704,3000,Male,GM0321,Houten,2012JJ00,2012,23916,,274,,117,,157,779,,74,705,955,,78,-3,877,-176,-18,,23898
150705,3000,Male,GM0321,Houten,2013JJ00,2013,23898,,263,,132,,131,751,,78,673,865,,70,-3,795,-114,19,,23917
150706,3000,Male,GM0321,Houten,2014JJ00,2014,23917,,253,,114,,139,903,,84,819,960,,93,-20,867,-57,80,,23997
150707,3000,Male,GM0321,Houten,2015JJ00,2015,23997,,264,,141,,123,966,,66,900,1037,,85,-6,952,-71,51,,24048
150708,3000,Male,GM0321,Houten,2016JJ00,2016,24048,,240,,128,,112,1249,,92,1157,1073,,87,-16,986,176,290,,24338
150709,3000,Male,GM0321,Houten,2017JJ00,2017,24338,,265,,144,,121,1111,,94,1017,1106,,79,-16,1027,5,126,,24464
150710,3000,Male,GM0321,Houten,2018JJ00,2018,24464,,248,,156,,92,1067,,115,952,1053,,87,-19,966,14,106,,24570
150711,3000,Male,GM0321,Houten,2019JJ00,2019,24570,,270,,121,,149,985,,128,857,1018,,55,-3,963,-33,118,,24688
150712,3000,Male,GM0321,Houten,2020JJ00,2020,24688,,270,,154,,116,1050,,89,961,1078,,57,-6,1021,-28,89,,24777
150713,3000,Male,GM0321,Houten,2021JJ00,2021,24777,,269,,166,,103,1054,,86,968,1111,,74,-7,1037,-57,42,,24819
150714,3000,Male,GM0321,Houten,2022JJ00,2022,24819,,221,,155,,66,1181,,185,996,1133,,108,-15,1025,48,118,,24937
150715,3000,Male,GM0321,Houten,2023JJ00,2023,24937,,249,,158,,91,1178,,167,1011,1161,,119,-8,1042,17,106,,25043
150950,3000,Male,GM0406,Huizen,2012JJ00,2012,20224,,180,,158,,22,769,,88,681,850,,86,-3,764,-81,-60,,20164
150951,3000,Male,GM0406,Huizen,2013JJ00,2013,20164,,201,,171,,30,718,,80,638,866,,89,4,777,-148,-117,,20047
150952,3000,Male,GM0406,Huizen,2014JJ00,2014,20047,,206,,169,,37,843,,98,745,876,,94,4,782,-33,1,,20048
150953,3000,Male,GM0406,Huizen,2015JJ00,2015,20048,,180,,186,,-6,931,,90,841,922,,109,-19,813,9,0,,20048
150954,3000,Male,GM0406,Huizen,2016JJ00,2016,20048,,199,,176,,23,1021,,125,896,1007,,112,-18,895,14,38,,20086
150955,3000,Male,GM0406,Huizen,2017JJ00,2017,20086,,173,,181,,-8,1061,,100,961,1105,,80,4,1025,-44,-51,,20035
150956,3000,Male,GM0406,Huizen,2018JJ00,2018,20035,,171,,212,,-41,942,,97,845,985,,117,-14,868,-43,-86,,19949
150957,3000,Male,GM0406,Huizen,2019JJ00,2019,19949,,165,,193,,-28,977,,108,869,944,,79,-16,865,33,-7,,19942
150958,3000,Male,GM0406,Huizen,2020JJ00,2020,19942,,162,,231,,-69,1027,,90,937,1088,,69,-8,1019,-61,-130,,19812
150959,3000,Male,GM0406,Huizen,2021JJ00,2021,19812,,186,,231,,-45,1052,,98,954,1083,,59,7,1024,-31,-75,,19737
150960,3000,Male,GM0406,Huizen,2022JJ00,2022,19737,,189,,189,,0,1059,,213,846,907,,106,-16,801,152,152,,19889
150961,3000,Male,GM0406,Huizen,2023JJ00,2023,19889,,178,,261,,-83,1160,,141,1019,1121,,110,-39,1011,39,-43,,19846
151114,3000,Male,GM0677,Hulst,2012JJ00,2012,13781,,112,,128,,-16,479,,203,276,516,,131,-29,385,-37,-53,,13728
151115,3000,Male,GM0677,Hulst,2013JJ00,2013,13728,,73,,143,,-70,507,,214,293,511,,155,-41,356,-4,-71,,13657
151116,3000,Male,GM0677,Hulst,2014JJ00,2014,13657,,123,,138,,-15,480,,196,284,487,,149,-28,338,-7,-23,,13634
151117,3000,Male,GM0677,Hulst,2015JJ00,2015,13634,,122,,151,,-29,465,,179,286,428,,169,-60,259,37,10,,13644
151118,3000,Male,GM0677,Hulst,2016JJ00,2016,13644,,102,,146,,-44,505,,189,316,456,,123,-6,333,49,6,,13650
151119,3000,Male,GM0677,Hulst,2017JJ00,2017,13650,,102,,150,,-48,575,,208,367,467,,112,-4,355,108,60,,13710
151120,3000,Male,GM0677,Hulst,2018JJ00,2018,13710,,126,,151,,-25,546,,213,333,435,,112,-8,323,111,82,,13792
151121,3000,Male,GM0677,Hulst,2019JJ00,2019,13792,,97,,144,,-47,520,,170,350,458,,112,-7,346,62,16,,13808
151122,3000,Male,GM0677,Hulst,2020JJ00,2020,13808,,110,,165,,-55,515,,176,339,487,,123,-14,364,28,-26,,13782
151123,3000,Male,GM0677,Hulst,2021JJ00,2021,13782,,95,,166,,-71,483,,157,326,433,,119,-20,314,50,-20,,13762
151124,3000,Male,GM0677,Hulst,2022JJ00,2022,13762,,109,,173,,-64,593,,223,370,463,,157,-17,306,130,64,,13826
151125,3000,Male,GM0677,Hulst,2023JJ00,2023,13826,,84,,171,,-87,483,,139,344,517,,118,-10,399,-34,-122,,13704
151770,3000,Male,GM0353,IJsselstein,2012JJ00,2012,16719,,204,,97,,107,629,,54,575,772,,52,8,720,-143,-37,,16682
151771,3000,Male,GM0353,IJsselstein,2013JJ00,2013,16682,,177,,95,,82,707,,77,630,750,,78,6,672,-43,39,,16721
151772,3000,Male,GM0353,IJsselstein,2014JJ00,2014,16721,,162,,115,,47,674,,72,602,890,,94,-18,796,-216,-166,,16555
151773,3000,Male,GM0353,IJsselstein,2015JJ00,2015,16555,,167,,90,,77,767,,91,676,826,,99,-35,727,-59,19,,16574
151774,3000,Male,GM0353,IJsselstein,2016JJ00,2016,16574,,171,,100,,71,845,,81,764,839,,72,-8,767,6,78,,16652
151775,3000,Male,GM0353,IJsselstein,2017JJ00,2017,16652,,182,,119,,63,831,,78,753,858,,73,-17,785,-27,38,,16690
151776,3000,Male,GM0353,IJsselstein,2018JJ00,2018,16690,,158,,117,,41,734,,78,656,869,,78,-17,791,-135,-94,,16596
151777,3000,Male,GM0353,IJsselstein,2019JJ00,2019,16596,,150,,137,,13,734,,104,630,764,,64,-4,700,-30,-16,,16580
151778,3000,Male,GM0353,IJsselstein,2020JJ00,2020,16580,,160,,163,,-3,748,,71,677,879,,48,-6,831,-131,-135,,16445
151779,3000,Male,GM0353,IJsselstein,2021JJ00,2021,16445,,165,,159,,6,682,,59,623,881,,56,-6,825,-199,-192,,16253
151780,3000,Male,GM0353,IJsselstein,2022JJ00,2022,16253,,159,,139,,20,785,,129,656,770,,76,1,694,15,36,,16289
151781,3000,Male,GM0353,IJsselstein,2023JJ00,2023,16289,,145,,147,,-2,773,,90,683,804,,65,-8,739,-31,-32,,16257
152590,3000,Male,GM1884,Kaag en Braassem,2012JJ00,2012,13062,,119,,94,,25,335,,38,297,392,,49,-5,343,-57,-32,,13030
152591,3000,Male,GM1884,Kaag en Braassem,2013JJ00,2013,13030,,129,,88,,41,393,,53,340,414,,45,-10,369,-21,19,,13049
152592,3000,Male,GM1884,Kaag en Braassem,2014JJ00,2014,13049,,122,,97,,25,498,,83,415,466,,60,-4,406,32,56,,13105
152593,3000,Male,GM1884,Kaag en Braassem,2015JJ00,2015,13105,,109,,101,,8,649,,68,581,512,,66,-16,446,137,145,,13250
152594,3000,Male,GM1884,Kaag en Braassem,2016JJ00,2016,13250,,128,,113,,15,640,,83,557,543,,66,-6,477,97,113,,13363
152595,3000,Male,GM1884,Kaag en Braassem,2017JJ00,2017,13363,,117,,93,,24,610,,71,539,540,,60,-8,480,70,92,,13455
152596,3000,Male,GM1884,Kaag en Braassem,2018JJ00,2018,13455,,107,,100,,7,671,,93,578,520,,61,-15,459,151,159,,13614
152597,3000,Male,GM1884,Kaag en Braassem,2019JJ00,2019,13614,,157,,103,,54,722,,78,644,538,,73,-15,465,184,235,,13849
152598,3000,Male,GM1884,Kaag en Braassem,2020JJ00,2020,13849,,146,,129,,17,659,,69,590,565,,33,3,532,94,110,,13959
152599,3000,Male,GM1884,Kaag en Braassem,2021JJ00,2021,13959,,160,,135,,25,686,,77,609,573,,46,-5,527,113,140,,14099
152600,3000,Male,GM1884,Kaag en Braassem,2022JJ00,2022,14099,,146,,110,,36,843,,154,689,553,,62,-2,491,290,327,,14426
152601,3000,Male,GM1884,Kaag en Braassem,2023JJ00,2023,14426,,160,,112,,48,823,,76,747,587,,72,1,515,236,283,,14709
152754,3000,Male,GM0166,Kampen,2012JJ00,2012,25203,,340,,188,,152,663,,102,561,721,,81,-2,640,-58,94,,25297
152755,3000,Male,GM0166,Kampen,2013JJ00,2013,25297,,330,,156,,174,638,,103,535,745,,126,-22,619,-107,67,,25364
152756,3000,Male,GM0166,Kampen,2014JJ00,2014,25364,,336,,182,,154,812,,76,736,761,,118,-1,643,51,205,,25569
152757,3000,Male,GM0166,Kampen,2015JJ00,2015,25569,,314,,185,,129,886,,119,767,741,,108,-10,633,145,274,,25843
152758,3000,Male,GM0166,Kampen,2016JJ00,2016,25843,,379,,204,,175,939,,100,839,776,,85,1,691,163,336,,26179
152759,3000,Male,GM0166,Kampen,2017JJ00,2017,26179,,333,,182,,151,1000,,107,893,737,,60,7,677,263,415,,26594
152760,3000,Male,GM0166,Kampen,2018JJ00,2018,26594,,324,,213,,111,1044,,116,928,860,,79,7,781,184,296,,26890
152761,3000,Male,GM0166,Kampen,2019JJ00,2019,26890,,339,,194,,145,958,,134,824,822,,89,-12,733,136,280,,27170
152762,3000,Male,GM0166,Kampen,2020JJ00,2020,27170,,344,,238,,106,866,,104,762,885,,87,-3,798,-19,85,,27255
152763,3000,Male,GM0166,Kampen,2021JJ00,2021,27255,,350,,230,,120,862,,124,738,821,,92,-12,729,41,163,,27418
152764,3000,Male,GM0166,Kampen,2022JJ00,2022,27418,,322,,226,,96,1206,,274,932,920,,104,-11,816,286,386,,27804
152765,3000,Male,GM0166,Kampen,2023JJ00,2023,27804,,322,,209,,113,1220,,244,976,993,,127,-18,866,227,341,,28145
152918,3000,Male,GM0678,Kapelle,2012JJ00,2012,6167,,71,,41,,30,238,,17,221,218,,9,1,209,20,49,,6216
152919,3000,Male,GM0678,Kapelle,2013JJ00,2013,6216,,56,,48,,8,244,,28,216,255,,27,-3,228,-11,-3,,6213
152920,3000,Male,GM0678,Kapelle,2014JJ00,2014,6213,,65,,41,,24,256,,24,232,239,,11,0,228,17,40,,6253
152921,3000,Male,GM0678,Kapelle,2015JJ00,2015,6253,,63,,41,,22,276,,37,239,248,,14,-5,234,28,50,,6303
152922,3000,Male,GM0678,Kapelle,2016JJ00,2016,6303,,68,,54,,14,280,,45,235,289,,29,0,260,-9,5,,6308
152923,3000,Male,GM0678,Kapelle,2017JJ00,2017,6308,,54,,46,,8,342,,25,317,310,,18,-1,292,32,40,,6348
152924,3000,Male,GM0678,Kapelle,2018JJ00,2018,6348,,48,,47,,1,305,,27,278,260,,22,-6,238,45,43,,6391
152925,3000,Male,GM0678,Kapelle,2019JJ00,2019,6391,,64,,52,,12,305,,42,263,382,,36,-12,346,-77,-66,,6325
152926,3000,Male,GM0678,Kapelle,2020JJ00,2020,6325,,56,,47,,9,357,,39,318,279,,21,-6,258,78,84,,6409
152927,3000,Male,GM0678,Kapelle,2021JJ00,2021,6409,,65,,53,,12,324,,23,301,267,,22,-2,245,57,70,,6479
152928,3000,Male,GM0678,Kapelle,2022JJ00,2022,6479,,54,,52,,2,305,,66,239,338,,29,-3,309,-33,-30,,6449
152929,3000,Male,GM0678,Kapelle,2023JJ00,2023,6449,,53,,45,,8,289,,42,247,302,,27,-2,275,-13,-5,,6444
153082,3000,Male,GM0537,Katwijk,2012JJ00,2012,31018,,414,,239,,175,784,,134,650,859,,123,-30,736,-75,107,,31125
153083,3000,Male,GM0537,Katwijk,2013JJ00,2013,31125,,393,,243,,150,780,,124,656,844,,149,-59,695,-64,89,,31214
153084,3000,Male,GM0537,Katwijk,2014JJ00,2014,31214,,405,,251,,154,1052,,151,901,800,,129,-21,671,252,407,,31621
153085,3000,Male,GM0537,Katwijk,2015JJ00,2015,31621,,337,,233,,104,1548,,731,817,1356,,137,-28,1219,192,298,,31919
153086,3000,Male,GM0537,Katwijk,2016JJ00,2016,31919,,391,,249,,142,1479,,394,1085,1421,,121,-19,1300,58,204,,32123
153087,3000,Male,GM0537,Katwijk,2017JJ00,2017,32123,,403,,267,,136,1034,,133,901,1035,,105,-11,930,-1,139,,32262
153088,3000,Male,GM0537,Katwijk,2018JJ00,2018,32262,,413,,286,,127,992,,153,839,958,,159,-54,799,34,163,,32425
153089,3000,Male,GM0537,Katwijk,2019JJ00,2019,32425,,352,,269,,83,1094,,163,931,980,,140,-27,840,114,205,,32630
153090,3000,Male,GM0537,Katwijk,2020JJ00,2020,32630,,363,,301,,62,1034,,124,910,972,,94,-15,878,62,126,,32756
153091,3000,Male,GM0537,Katwijk,2021JJ00,2021,32756,,420,,314,,106,955,,129,826,1016,,100,-4,916,-61,49,,32805
153092,3000,Male,GM0537,Katwijk,2022JJ00,2022,32805,,362,,262,,100,1319,,274,1045,1102,,151,-7,951,217,314,,33119
153093,3000,Male,GM0537,Katwijk,2023JJ00,2023,33119,,365,,296,,69,1219,,213,1006,1145,,136,-13,1009,74,154,,33273
153328,3000,Male,GM0928,Kerkrade,2012JJ00,2012,23540,,206,,278,,-72,1154,,188,966,1091,,209,-11,882,63,-10,,23530
153329,3000,Male,GM0928,Kerkrade,2013JJ00,2013,23530,,199,,296,,-97,1045,,179,866,1154,,259,-67,895,-109,-205,,23325
153330,3000,Male,GM0928,Kerkrade,2014JJ00,2014,23325,,181,,295,,-114,1106,,214,892,1119,,199,-11,920,-13,-126,,23199
153331,3000,Male,GM0928,Kerkrade,2015JJ00,2015,23199,,187,,357,,-170,1147,,204,943,1219,,238,-39,981,-72,-239,,22960
153332,3000,Male,GM0928,Kerkrade,2016JJ00,2016,22960,,179,,319,,-140,1237,,209,1028,1090,,190,-37,900,147,8,,22968
153333,3000,Male,GM0928,Kerkrade,2017JJ00,2017,22968,,167,,345,,-178,1313,,255,1058,1209,,269,-40,940,104,-77,,22891
153334,3000,Male,GM0928,Kerkrade,2018JJ00,2018,22891,,161,,313,,-152,1335,,274,1061,1217,,239,-57,978,118,-37,,22854
153335,3000,Male,GM0928,Kerkrade,2019JJ00,2019,22854,,185,,330,,-145,1423,,318,1105,1178,,191,10,987,245,97,,22951
153336,3000,Male,GM0928,Kerkrade,2020JJ00,2020,22951,,145,,383,,-238,1412,,265,1147,1351,,272,-96,1079,61,-180,,22771
153337,3000,Male,GM0928,Kerkrade,2021JJ00,2021,22771,,184,,393,,-209,1541,,304,1237,1351,,260,-86,1091,190,-19,,22752
153338,3000,Male,GM0928,Kerkrade,2022JJ00,2022,22752,,163,,324,,-161,1506,,400,1106,1249,,237,-62,1012,257,94,,22846
153339,3000,Male,GM0928,Kerkrade,2023JJ00,2023,22846,,176,,332,,-156,1315,,304,1011,1314,,275,-89,1039,1,-152,,22694
154394,3000,Male,GM1598,Koggenland,2012JJ00,2012,11233,,104,,96,,8,348,,37,311,358,,28,-2,330,-10,-2,,11231
154395,3000,Male,GM1598,Koggenland,2013JJ00,2013,11231,,108,,64,,44,411,,41,370,392,,36,-3,356,19,62,,11293
154396,3000,Male,GM1598,Koggenland,2014JJ00,2014,11293,,124,,95,,29,365,,49,316,421,,58,-12,363,-56,-27,,11266
154397,3000,Male,GM1598,Koggenland,2015JJ00,2015,11266,,112,,86,,26,437,,42,395,432,,50,-7,382,5,33,,11299
154398,3000,Male,GM1598,Koggenland,2016JJ00,2016,11299,,110,,92,,18,479,,36,443,456,,22,2,434,23,41,,11340
154399,3000,Male,GM1598,Koggenland,2017JJ00,2017,11340,,107,,90,,17,540,,33,507,458,,36,-7,422,82,96,,11436
154400,3000,Male,GM1598,Koggenland,2018JJ00,2018,11436,,122,,86,,36,483,,46,437,474,,34,-3,440,9,42,,11478
154401,3000,Male,GM1598,Koggenland,2019JJ00,2019,11478,,86,,95,,-9,478,,45,433,484,,42,-9,442,-6,-14,,11464
154402,3000,Male,GM1598,Koggenland,2020JJ00,2020,11464,,112,,93,,19,597,,40,557,525,,54,-15,471,72,91,,11555
154403,3000,Male,GM1598,Koggenland,2021JJ00,2021,11555,,130,,104,,26,529,,39,490,486,,39,-1,447,43,69,,11624
154404,3000,Male,GM1598,Koggenland,2022JJ00,2022,11624,,128,,88,,40,641,,177,464,482,,76,-34,406,159,199,,11823
154405,3000,Male,GM1598,Koggenland,2023JJ00,2023,11823,,122,,110,,12,616,,84,532,588,,74,-20,514,28,41,,11864
154476,3000,Male,GM0079,Kollumerland en Nieuwkruisland,2012JJ00,2012,6630,,67,,55,,12,179,,8,171,220,,9,3,211,-41,-30,,6600
154477,3000,Male,GM0079,Kollumerland en Nieuwkruisland,2013JJ00,2013,6600,,70,,65,,5,192,,4,188,177,,11,-4,166,15,19,,6619
154478,3000,Male,GM0079,Kollumerland en Nieuwkruisland,2014JJ00,2014,6619,,77,,58,,19,223,,13,210,253,,11,-1,242,-30,-11,,6608
154479,3000,Male,GM0079,Kollumerland en Nieuwkruisland,2015JJ00,2015,6608,,54,,60,,-6,237,,10,227,258,,9,-1,249,-21,-27,,6581
154480,3000,Male,GM0079,Kollumerland en Nieuwkruisland,2016JJ00,2016,6581,,80,,67,,13,266,,10,256,271,,11,3,260,-5,9,,6590
154481,3000,Male,GM0079,Kollumerland en Nieuwkruisland,2017JJ00,2017,6590,,58,,59,,-1,274,,10,264,293,,7,1,286,-19,-20,,6570
154482,3000,Male,GM0079,Kollumerland en Nieuwkruisland,2018JJ00,2018,6570,,67,,66,,1,233,,10,223,300,,8,0,292,-67,-69,,6501
154640,3000,Male,GM0588,Korendijk,2012JJ00,2012,5401,,53,,43,,10,170,,9,161,196,,10,-2,186,-26,-17,,5384
154641,3000,Male,GM0588,Korendijk,2013JJ00,2013,5384,,55,,47,,8,151,,7,144,195,,7,-1,188,-44,-34,,5350
154642,3000,Male,GM0588,Korendijk,2014JJ00,2014,5350,,63,,41,,22,176,,7,169,188,,14,-3,174,-12,8,,5358
154643,3000,Male,GM0588,Korendijk,2015JJ00,2015,5358,,56,,36,,20,223,,10,213,224,,13,-4,211,-1,19,,5377
154644,3000,Male,GM0588,Korendijk,2016JJ00,2016,5377,,65,,44,,21,246,,8,238,185,,11,-1,174,61,82,,5459
154645,3000,Male,GM0588,Korendijk,2017JJ00,2017,5459,,64,,40,,24,291,,12,279,249,,0,3,249,42,66,,5525
154646,3000,Male,GM0588,Korendijk,2018JJ00,2018,5525,,66,,44,,22,332,,14,318,214,,15,2,199,118,137,,5662
155214,3000,Male,GM0542,Krimpen aan den IJssel,2012JJ00,2012,13952,,158,,130,,28,620,,46,574,559,,26,16,533,61,91,,14043
155215,3000,Male,GM0542,Krimpen aan den IJssel,2013JJ00,2013,14043,,134,,134,,0,535,,51,484,572,,-1,21,573,-37,-36,,14007
155216,3000,Male,GM0542,Krimpen aan den IJssel,2014JJ00,2014,14007,,159,,151,,8,543,,54,489,550,,31,10,519,-7,4,,14011
155217,3000,Male,GM0542,Krimpen aan den IJssel,2015JJ00,2015,14011,,141,,141,,0,638,,66,572,595,,33,9,562,43,44,,14055
155218,3000,Male,GM0542,Krimpen aan den IJssel,2016JJ00,2016,14055,,156,,128,,28,673,,60,613,643,,17,9,626,30,54,,14109
155219,3000,Male,GM0542,Krimpen aan den IJssel,2017JJ00,2017,14109,,136,,130,,6,711,,54,657,664,,-5,19,669,47,55,,14164
155220,3000,Male,GM0542,Krimpen aan den IJssel,2018JJ00,2018,14164,,132,,134,,-2,648,,53,595,631,,25,12,606,17,15,,14179
155221,3000,Male,GM0542,Krimpen aan den IJssel,2019JJ00,2019,14179,,172,,126,,46,658,,62,596,622,,35,12,587,36,80,,14259
155222,3000,Male,GM0542,Krimpen aan den IJssel,2020JJ00,2020,14259,,156,,172,,-16,674,,43,631,732,,17,10,715,-58,-74,,14185
155223,3000,Male,GM0542,Krimpen aan den IJssel,2021JJ00,2021,14185,,161,,174,,-13,676,,62,614,655,,17,8,638,21,9,,14194
155224,3000,Male,GM0542,Krimpen aan den IJssel,2022JJ00,2022,14194,,144,,162,,-18,659,,96,563,644,,60,-12,584,15,-5,,14189
155225,3000,Male,GM0542,Krimpen aan den IJssel,2023JJ00,2023,14189,,164,,151,,13,736,,95,641,673,,50,-5,623,63,74,,14263
155299,3000,Male,GM1931,Krimpenerwaard,2015JJ00,2015,26857,,279,,244,,35,1023,,101,922,799,,106,-31,693,224,237,,27094
155300,3000,Male,GM1931,Krimpenerwaard,2016JJ00,2016,27094,,269,,241,,28,1120,,117,1003,932,,97,-36,835,188,213,,27307
155301,3000,Male,GM1931,Krimpenerwaard,2017JJ00,2017,27307,,279,,234,,45,1198,,106,1092,1009,,109,-16,900,189,232,,27539
155302,3000,Male,GM1931,Krimpenerwaard,2018JJ00,2018,27539,,301,,230,,71,1112,,95,1017,934,,107,-32,827,178,249,,27788
155303,3000,Male,GM1931,Krimpenerwaard,2019JJ00,2019,27788,,314,,239,,75,983,,100,883,915,,66,-13,849,68,146,,27934
155304,3000,Male,GM1931,Krimpenerwaard,2020JJ00,2020,27934,,318,,277,,41,1129,,109,1020,993,,83,-23,910,136,173,,28107
155305,3000,Male,GM1931,Krimpenerwaard,2021JJ00,2021,28107,,320,,248,,72,1062,,72,990,941,,95,-25,846,121,195,,28302
155306,3000,Male,GM1931,Krimpenerwaard,2022JJ00,2022,28302,,315,,290,,25,1200,,275,925,923,,136,-37,787,277,304,,28606
155307,3000,Male,GM1931,Krimpenerwaard,2023JJ00,2023,28606,,328,,277,,51,1013,,146,867,983,,111,-13,872,30,81,,28687
155788,3000,Male,GM1659,Laarbeek,2012JJ00,2012,10921,,113,,86,,27,344,,56,288,272,,19,0,253,72,98,,11019
155789,3000,Male,GM1659,Laarbeek,2013JJ00,2013,11019,,87,,81,,6,307,,38,269,323,,55,-17,268,-16,-10,,11009
155790,3000,Male,GM1659,Laarbeek,2014JJ00,2014,11009,,94,,93,,1,385,,52,333,318,,48,-9,270,67,73,,11082
155791,3000,Male,GM1659,Laarbeek,2015JJ00,2015,11082,,90,,100,,-10,376,,60,316,331,,28,-7,303,45,33,,11115
155792,3000,Male,GM1659,Laarbeek,2016JJ00,2016,11115,,83,,92,,-9,408,,48,360,393,,57,-23,336,15,4,,11119
155793,3000,Male,GM1659,Laarbeek,2017JJ00,2017,11119,,91,,106,,-15,511,,44,467,374,,33,-9,341,137,123,,11242
155794,3000,Male,GM1659,Laarbeek,2018JJ00,2018,11242,,95,,110,,-15,477,,47,430,404,,42,-17,362,73,56,,11298
155795,3000,Male,GM1659,Laarbeek,2019JJ00,2019,11298,,118,,111,,7,519,,56,463,407,,40,-7,367,112,118,,11416
155796,3000,Male,GM1659,Laarbeek,2020JJ00,2020,11416,,94,,134,,-40,569,,50,519,395,,41,-5,354,174,137,,11553
155797,3000,Male,GM1659,Laarbeek,2021JJ00,2021,11553,,124,,112,,12,460,,30,430,419,,47,-7,372,41,53,,11606
155798,3000,Male,GM1659,Laarbeek,2022JJ00,2022,11606,,96,,122,,-26,521,,96,425,383,,45,-8,338,138,111,,11717
155799,3000,Male,GM1659,Laarbeek,2023JJ00,2023,11717,,107,,133,,-26,451,,92,359,419,,63,-12,356,32,6,,11723
155880,3000,Male,GM1982,Land van Cuijk,2022JJ00,2022,45831,,432,,461,,-29,2201,,405,1796,1851,,156,0,1695,350,321,,46152
155881,3000,Male,GM1982,Land van Cuijk,2023JJ00,2023,46152,,393,,486,,-93,1982,,456,1526,1692,,263,-95,1429,290,196,,46348
155952,3000,Male,GM1685,Landerd,2012JJ00,2012,7699,,77,,73,,4,299,,19,280,238,,22,-8,216,61,65,,7764
155953,3000,Male,GM1685,Landerd,2013JJ00,2013,7764,,67,,49,,18,311,,33,278,324,,21,-2,303,-13,5,,7769
155954,3000,Male,GM1685,Landerd,2014JJ00,2014,7769,,68,,76,,-8,320,,30,290,290,,11,5,279,30,24,,7793
155955,3000,Male,GM1685,Landerd,2015JJ00,2015,7793,,64,,75,,-11,282,,34,248,268,,27,-8,241,14,1,,7794
155956,3000,Male,GM1685,Landerd,2016JJ00,2016,7794,,79,,64,,15,362,,26,336,346,,24,-2,322,16,31,,7825
155957,3000,Male,GM1685,Landerd,2017JJ00,2017,7825,,59,,68,,-9,322,,28,294,312,,30,-13,282,10,2,,7827
155958,3000,Male,GM1685,Landerd,2018JJ00,2018,7827,,58,,69,,-11,437,,53,384,324,,22,2,302,113,102,,7929
155959,3000,Male,GM1685,Landerd,2019JJ00,2019,7929,,62,,80,,-18,425,,37,388,312,,22,2,290,113,97,,8026
155960,3000,Male,GM1685,Landerd,2020JJ00,2020,8026,,65,,91,,-26,390,,57,333,315,,31,-7,284,75,47,,8073
155961,3000,Male,GM1685,Landerd,2021JJ00,2021,8073,,74,,78,,-4,346,,39,307,289,,17,2,272,57,45,,8118
156034,3000,Male,GM0882,Landgraaf,2012JJ00,2012,18730,,157,,192,,-35,873,,59,814,882,,83,3,799,-9,-45,,18685
156035,3000,Male,GM0882,Landgraaf,2013JJ00,2013,18685,,133,,171,,-38,746,,71,675,895,,110,-18,785,-149,-187,,18498
156036,3000,Male,GM0882,Landgraaf,2014JJ00,2014,18498,,141,,182,,-41,867,,75,792,876,,83,7,793,-9,-49,,18449
156037,3000,Male,GM0882,Landgraaf,2015JJ00,2015,18449,,137,,183,,-46,929,,86,843,886,,77,-11,809,43,-4,,18445
156038,3000,Male,GM0882,Landgraaf,2016JJ00,2016,18445,,129,,190,,-61,976,,93,883,923,,63,22,860,53,-5,,18440
156039,3000,Male,GM0882,Landgraaf,2017JJ00,2017,18440,,147,,193,,-46,1095,,82,1013,937,,71,9,866,158,111,,18551
156040,3000,Male,GM0882,Landgraaf,2018JJ00,2018,18551,,150,,219,,-69,1042,,95,947,986,,84,0,902,56,-13,,18538
156041,3000,Male,GM0882,Landgraaf,2019JJ00,2019,18538,,118,,222,,-104,971,,96,875,949,,85,-5,864,22,-82,,18456
156042,3000,Male,GM0882,Landgraaf,2020JJ00,2020,18456,,139,,252,,-113,983,,105,878,985,,75,-14,910,-2,-114,,18342
156043,3000,Male,GM0882,Landgraaf,2021JJ00,2021,18342,,148,,273,,-125,976,,83,893,975,,57,18,918,1,-124,,18218
156044,3000,Male,GM0882,Landgraaf,2022JJ00,2022,18218,,150,,233,,-83,1034,,169,865,865,,103,-8,762,169,89,,18307
156045,3000,Male,GM0882,Landgraaf,2023JJ00,2023,18307,,131,,244,,-113,941,,117,824,884,,88,-18,796,57,-56,,18251
156116,3000,Male,GM0415,Landsmeer,2012JJ00,2012,4958,,46,,42,,4,228,,28,200,177,,27,-12,150,51,54,,5012
156117,3000,Male,GM0415,Landsmeer,2013JJ00,2013,5012,,45,,46,,-1,198,,28,170,204,,25,-6,179,-6,-7,,5005
156118,3000,Male,GM0415,Landsmeer,2014JJ00,2014,5005,,45,,33,,12,374,,28,346,209,,15,1,194,165,180,,5185
156119,3000,Male,GM0415,Landsmeer,2015JJ00,2015,5185,,45,,42,,3,304,,27,277,214,,22,1,192,90,95,,5280
156120,3000,Male,GM0415,Landsmeer,2016JJ00,2016,5280,,46,,32,,14,386,,37,349,245,,28,-3,217,141,157,,5437
156121,3000,Male,GM0415,Landsmeer,2017JJ00,2017,5437,,61,,51,,10,341,,36,305,276,,25,-11,251,65,74,,5511
156122,3000,Male,GM0415,Landsmeer,2018JJ00,2018,5511,,56,,56,,0,293,,30,263,286,,30,0,256,7,7,,5518
156123,3000,Male,GM0415,Landsmeer,2019JJ00,2019,5518,,52,,48,,4,295,,22,273,275,,32,-13,243,20,24,,5542
156124,3000,Male,GM0415,Landsmeer,2020JJ00,2020,5542,,48,,53,,-5,334,,20,314,284,,14,-4,270,50,45,,5587
156125,3000,Male,GM0415,Landsmeer,2021JJ00,2021,5587,,52,,48,,4,293,,29,264,301,,28,-4,273,-8,-4,,5583
156126,3000,Male,GM0415,Landsmeer,2022JJ00,2022,5583,,58,,52,,6,327,,54,273,268,,35,-8,233,59,67,,5650
156127,3000,Male,GM0415,Landsmeer,2023JJ00,2023,5650,,43,,51,,-8,303,,49,254,316,,49,-10,267,-13,-22,,5628
156362,3000,Male,GM0416,Langedijk,2012JJ00,2012,13464,,112,,77,,35,460,,41,419,527,,58,-9,469,-67,-33,,13431
156363,3000,Male,GM0416,Langedijk,2013JJ00,2013,13431,,126,,77,,49,544,,46,498,584,,37,8,547,-40,12,,13443
156364,3000,Male,GM0416,Langedijk,2014JJ00,2014,13443,,142,,80,,62,628,,41,587,549,,39,4,510,79,139,,13582
156365,3000,Male,GM0416,Langedijk,2015JJ00,2015,13582,,135,,107,,28,706,,64,642,688,,57,-10,631,18,48,,13630
156366,3000,Male,GM0416,Langedijk,2016JJ00,2016,13630,,124,,82,,42,740,,56,684,703,,65,-15,638,37,79,,13709
156367,3000,Male,GM0416,Langedijk,2017JJ00,2017,13709,,119,,88,,31,864,,69,795,769,,48,-6,721,95,125,,13834
156368,3000,Male,GM0416,Langedijk,2018JJ00,2018,13834,,143,,98,,45,731,,80,651,696,,62,-37,634,35,83,,13917
156369,3000,Male,GM0416,Langedijk,2019JJ00,2019,13917,,134,,98,,36,782,,67,715,723,,62,-16,661,59,94,,14011
156370,3000,Male,GM0416,Langedijk,2020JJ00,2020,14011,,133,,113,,20,753,,50,703,689,,45,-9,644,64,86,,14097
156371,3000,Male,GM0416,Langedijk,2021JJ00,2021,14097,,149,,136,,13,768,,44,724,636,,27,-8,609,132,125,,14222
156526,3000,Male,GM1621,Lansingerland,2012JJ00,2012,27526,,387,,142,,245,1178,,118,1060,824,,117,-6,707,354,601,,28127
156527,3000,Male,GM1621,Lansingerland,2013JJ00,2013,28127,,394,,174,,220,972,,102,870,944,,120,-18,824,28,246,,28373
156528,3000,Male,GM1621,Lansingerland,2014JJ00,2014,28373,,362,,136,,226,1254,,130,1124,955,,118,-14,837,299,528,,28901
156529,3000,Male,GM1621,Lansingerland,2015JJ00,2015,28901,,329,,141,,188,1343,,135,1208,1096,,148,-20,948,247,436,,29337
156530,3000,Male,GM1621,Lansingerland,2016JJ00,2016,29337,,372,,184,,188,1552,,123,1429,1218,,114,-12,1104,334,521,,29858
156531,3000,Male,GM1621,Lansingerland,2017JJ00,2017,29858,,380,,192,,188,1521,,121,1400,1249,,129,-20,1120,272,459,,30317
156532,3000,Male,GM1621,Lansingerland,2018JJ00,2018,30317,,382,,197,,185,1248,,144,1104,1254,,103,4,1151,-6,182,,30499
156533,3000,Male,GM1621,Lansingerland,2019JJ00,2019,30499,,307,,189,,118,1453,,133,1320,1252,,136,-33,1116,201,318,,30817
156534,3000,Male,GM1621,Lansingerland,2020JJ00,2020,30822,,342,,225,,117,1555,,121,1434,1253,,102,-10,1151,302,420,,31242
156535,3000,Male,GM1621,Lansingerland,2021JJ00,2021,31242,,383,,213,,170,1508,,118,1390,1308,,111,-25,1197,200,365,,31607
156536,3000,Male,GM1621,Lansingerland,2022JJ00,2022,31607,,339,,213,,126,1486,,185,1301,1319,,155,-46,1164,167,293,,31900
156537,3000,Male,GM1621,Lansingerland,2023JJ00,2023,31900,,355,,210,,145,1565,,138,1427,1273,,144,-22,1129,292,436,,32336
156690,3000,Male,GM0417,Laren (NH.),2012JJ00,2012,5421,,24,,115,,-91,426,,79,347,676,,176,-132,500,-250,-342,,5079
156691,3000,Male,GM0417,Laren (NH.),2013JJ00,2013,5079,,32,,92,,-60,370,,52,318,303,,47,1,256,67,9,,5088
156692,3000,Male,GM0417,Laren (NH.),2014JJ00,2014,5088,,44,,81,,-37,385,,47,338,323,,44,-11,279,62,26,,5114
156693,3000,Male,GM0417,Laren (NH.),2015JJ00,2015,5114,,31,,107,,-76,480,,64,416,363,,39,-2,324,117,41,,5155
156694,3000,Male,GM0417,Laren (NH.),2016JJ00,2016,5155,,47,,103,,-56,533,,66,467,408,,33,-2,375,125,68,,5223
156695,3000,Male,GM0417,Laren (NH.),2017JJ00,2017,5223,,37,,107,,-70,505,,60,445,385,,31,0,354,120,51,,5274
156696,3000,Male,GM0417,Laren (NH.),2018JJ00,2018,5274,,36,,99,,-63,472,,76,396,393,,60,1,333,79,18,,5292
156697,3000,Male,GM0417,Laren (NH.),2019JJ00,2019,5292,,39,,93,,-54,454,,65,389,383,,43,-2,340,71,17,,5309
156698,3000,Male,GM0417,Laren (NH.),2020JJ00,2020,5309,,50,,122,,-72,533,,67,466,372,,35,0,337,161,89,,5398
156699,3000,Male,GM0417,Laren (NH.),2021JJ00,2021,5398,,34,,113,,-79,512,,48,464,387,,26,1,361,125,47,,5445
156700,3000,Male,GM0417,Laren (NH.),2022JJ00,2022,5445,,49,,120,,-71,548,,96,452,403,,52,-3,351,145,74,,5519
156701,3000,Male,GM0417,Laren (NH.),2023JJ00,2023,5519,,33,,119,,-86,422,,50,372,440,,48,-1,392,-18,-104,,5415
156772,3000,Male,GM0022,Leek,2012JJ00,2012,9661,,86,,94,,-8,503,,61,442,437,,50,-16,387,66,59,,9720
156773,3000,Male,GM0022,Leek,2013JJ00,2013,9720,,74,,78,,-4,467,,55,412,493,,72,-44,421,-26,-30,,9690
156774,3000,Male,GM0022,Leek,2014JJ00,2014,9690,,105,,83,,22,496,,64,432,609,,99,-70,510,-113,-90,,9600
156775,3000,Male,GM0022,Leek,2015JJ00,2015,9600,,86,,108,,-22,553,,34,519,530,,68,-27,462,23,1,,9601
156776,3000,Male,GM0022,Leek,2016JJ00,2016,9601,,88,,62,,26,614,,29,585,549,,33,-11,516,65,93,,9694
156777,3000,Male,GM0022,Leek,2017JJ00,2017,9694,,91,,104,,-13,597,,24,573,586,,56,-20,530,11,-2,,9692
156778,3000,Male,GM0022,Leek,2018JJ00,2018,9692,,94,,91,,3,590,,31,559,545,,30,-7,515,45,44,,9736
157100,3000,Male,GM0545,Leerdam,2012JJ00,2012,10153,,123,,87,,36,335,,32,303,354,,77,-29,277,-19,16,,10169
157101,3000,Male,GM0545,Leerdam,2013JJ00,2013,10169,,106,,98,,8,304,,48,256,382,,57,-14,325,-78,-69,,10100
157102,3000,Male,GM0545,Leerdam,2014JJ00,2014,10100,,121,,102,,19,352,,33,319,379,,75,-10,304,-27,-7,,10093
157103,3000,Male,GM0545,Leerdam,2015JJ00,2015,10093,,114,,93,,21,454,,54,400,385,,47,-13,338,69,88,,10181
157104,3000,Male,GM0545,Leerdam,2016JJ00,2016,10181,,114,,102,,12,492,,65,427,410,,30,-2,380,82,93,,10274
157105,3000,Male,GM0545,Leerdam,2017JJ00,2017,10274,,112,,112,,0,544,,41,503,484,,35,0,449,60,62,,10336
157106,3000,Male,GM0545,Leerdam,2018JJ00,2018,10336,,101,,103,,-2,540,,82,458,442,,43,1,399,98,114,,10450
157264,3000,Male,GM0080,Leeuwarden,2012JJ00,2012,46727,,583,,420,,163,2926,,444,2482,2696,,425,15,2271,230,390,,47117
157265,3000,Male,GM0080,Leeuwarden,2013JJ00,2013,47117,,561,,434,,127,3076,,423,2653,2927,,503,-30,2424,149,286,,47403
157266,3000,Male,GM0080,Leeuwarden,2014JJ00,2014,52953,,622,,441,,181,3392,,536,2856,3247,,546,-69,2701,145,311,,53264
157267,3000,Male,GM0080,Leeuwarden,2015JJ00,2015,53264,,566,,462,,104,3226,,544,2682,3185,,403,36,2782,41,143,,53407
157268,3000,Male,GM0080,Leeuwarden,2016JJ00,2016,53407,,592,,458,,134,3621,,568,3053,3328,,408,24,2920,293,424,,53831
157269,3000,Male,GM0080,Leeuwarden,2017JJ00,2017,53831,,583,,484,,99,3645,,600,3045,3507,,580,-135,2927,138,237,,54068
157270,3000,Male,GM0080,Leeuwarden,2018JJ00,2018,60823,,624,,521,,103,3576,,682,2894,3376,,512,-60,2864,200,304,,61127
157271,3000,Male,GM0080,Leeuwarden,2019JJ00,2019,61127,,622,,591,,31,3788,,811,2977,3259,,455,5,2804,529,550,,61677
157272,3000,Male,GM0080,Leeuwarden,2020JJ00,2020,61677,,571,,564,,7,3684,,667,3017,3428,,526,-75,2902,256,264,,61941
157273,3000,Male,GM0080,Leeuwarden,2021JJ00,2021,61941,,641,,599,,42,3637,,664,2973,3214,,432,-83,2782,423,464,,62405
157274,3000,Male,GM0080,Leeuwarden,2022JJ00,2022,62405,,601,,571,,30,4041,,1225,2816,3230,,593,-96,2637,811,843,,63248
157275,3000,Male,GM0080,Leeuwarden,2023JJ00,2023,63248,,604,,589,,15,4551,,1107,3444,3696,,782,-260,2914,855,859,,64107
157346,3000,Male,GM0081,Leeuwarderadeel,2012JJ00,2012,5208,,43,,47,,-4,192,,11,181,210,,11,-1,199,-18,-22,,5186
157347,3000,Male,GM0081,Leeuwarderadeel,2013JJ00,2013,5186,,30,,37,,-7,224,,8,216,266,,16,-1,250,-42,-49,,5137
157348,3000,Male,GM0081,Leeuwarderadeel,2014JJ00,2014,5137,,44,,43,,1,208,,8,200,249,,7,0,242,-41,-40,,5097
157349,3000,Male,GM0081,Leeuwarderadeel,2015JJ00,2015,5097,,48,,42,,6,208,,5,203,238,,7,-1,231,-30,-22,,5075
157350,3000,Male,GM0081,Leeuwarderadeel,2016JJ00,2016,5075,,37,,55,,-18,259,,9,250,275,,19,-2,256,-16,-34,,5041
157351,3000,Male,GM0081,Leeuwarderadeel,2017JJ00,2017,5041,,45,,51,,-6,251,,5,246,260,,11,1,249,-9,-22,,5019
157428,3000,Male,GM0546,Leiden,2012JJ00,2012,57848,,667,,404,,263,4282,,1095,3187,4162,,1165,-377,2997,120,380,,58228
157429,3000,Male,GM0546,Leiden,2013JJ00,2013,58228,,616,,406,,210,4246,,1198,3048,3787,,955,-93,2832,459,661,,58889
157430,3000,Male,GM0546,Leiden,2014JJ00,2014,58889,,696,,421,,275,4404,,1152,3252,4493,,1208,-310,3285,-89,195,,59084
157431,3000,Male,GM0546,Leiden,2015JJ00,2015,59084,,610,,428,,182,4866,,1331,3535,4498,,1117,-200,3381,368,541,,59625
157432,3000,Male,GM0546,Leiden,2016JJ00,2016,59625,,617,,388,,229,5218,,1281,3937,5009,,1398,-408,3611,209,442,,60067
157433,3000,Male,GM0546,Leiden,2017JJ00,2017,60067,,615,,427,,188,5239,,1515,3724,5274,,1586,-568,3688,-35,156,,60223
157434,3000,Male,GM0546,Leiden,2018JJ00,2018,60223,,545,,441,,104,5050,,1463,3587,4882,,1160,-242,3722,168,272,,60495
157435,3000,Male,GM0546,Leiden,2019JJ00,2019,60495,,574,,475,,99,5039,,1641,3398,5075,,1113,-160,3962,-36,61,,60556
157436,3000,Male,GM0546,Leiden,2020JJ00,2020,60556,,563,,461,,102,4903,,1194,3709,5418,,1170,-303,4248,-515,-410,,60146
157437,3000,Male,GM0546,Leiden,2021JJ00,2021,60146,,564,,522,,42,5278,,1356,3922,4869,,897,-87,3972,409,453,,60599
157438,3000,Male,GM0546,Leiden,2022JJ00,2022,60599,,499,,514,,-15,5820,,2008,3812,4971,,1088,-158,3883,849,838,,61437
157439,3000,Male,GM0546,Leiden,2023JJ00,2023,61437,,489,,514,,-25,6479,,1734,4745,5312,,1149,-201,4163,1167,1140,,62577
157510,3000,Male,GM0547,Leiderdorp,2012JJ00,2012,12883,,137,,94,,43,649,,70,579,661,,55,-7,606,-12,30,,12913
157511,3000,Male,GM0547,Leiderdorp,2013JJ00,2013,12913,,127,,101,,26,610,,68,542,607,,77,-12,530,3,25,,12938
157512,3000,Male,GM0547,Leiderdorp,2014JJ00,2014,12938,,128,,107,,21,660,,88,572,685,,89,-9,596,-25,-1,,12937
157513,3000,Male,GM0547,Leiderdorp,2015JJ00,2015,12937,,136,,114,,22,786,,159,627,727,,100,-17,627,59,79,,13016
157514,3000,Male,GM0547,Leiderdorp,2016JJ00,2016,13016,,133,,101,,32,925,,102,823,823,,85,-5,738,102,123,,13139
157515,3000,Male,GM0547,Leiderdorp,2017JJ00,2017,13139,,120,,124,,-4,852,,79,773,818,,96,-22,722,34,30,,13169
157516,3000,Male,GM0547,Leiderdorp,2018JJ00,2018,13169,,110,,140,,-30,723,,81,642,748,,96,-24,652,-25,-49,,13120
157517,3000,Male,GM0547,Leiderdorp,2019JJ00,2019,13120,,154,,123,,31,719,,72,647,771,,67,-10,704,-52,-25,,13095
157518,3000,Male,GM0547,Leiderdorp,2020JJ00,2020,13095,,119,,114,,5,952,,111,841,767,,89,-10,678,185,192,,13287
157519,3000,Male,GM0547,Leiderdorp,2021JJ00,2021,13287,,125,,130,,-5,805,,71,734,781,,56,-4,725,24,19,,13306
157520,3000,Male,GM0547,Leiderdorp,2022JJ00,2022,13306,,135,,129,,6,823,,119,704,721,,55,-2,666,102,105,,13411
157521,3000,Male,GM0547,Leiderdorp,2023JJ00,2023,13411,,142,,121,,21,875,,135,740,814,,64,4,750,61,84,,13495
157674,3000,Male,GM1916,Leidschendam-Voorburg,2012JJ00,2012,34620,,402,,316,,86,2142,,357,1785,2137,,466,-85,1671,5,94,,34714
157675,3000,Male,GM1916,Leidschendam-Voorburg,2013JJ00,2013,34714,,416,,311,,105,2251,,414,1837,1979,,365,-20,1614,272,377,,35091
157676,3000,Male,GM1916,Leidschendam-Voorburg,2014JJ00,2014,35091,,433,,306,,127,2465,,395,2070,2230,,395,-20,1835,235,361,,35452
157677,3000,Male,GM1916,Leidschendam-Voorburg,2015JJ00,2015,35452,,400,,328,,72,2541,,404,2137,2462,,455,-81,2007,79,153,,35605
157678,3000,Male,GM1916,Leidschendam-Voorburg,2016JJ00,2016,35605,,391,,362,,29,2702,,422,2280,2511,,394,-19,2117,191,213,,35818
157679,3000,Male,GM1916,Leidschendam-Voorburg,2017JJ00,2017,35818,,353,,329,,24,2769,,457,2312,2537,,429,-23,2108,232,255,,36073
157680,3000,Male,GM1916,Leidschendam-Voorburg,2018JJ00,2018,36073,,373,,323,,50,2669,,495,2174,2466,,393,-40,2073,203,253,,36326
157681,3000,Male,GM1916,Leidschendam-Voorburg,2019JJ00,2019,36326,,411,,351,,60,2970,,564,2406,2430,,420,-48,2010,540,598,,36924
157682,3000,Male,GM1916,Leidschendam-Voorburg,2020JJ00,2020,36924,,340,,403,,-63,2717,,418,2299,2708,,366,-12,2342,9,-50,,36874
157683,3000,Male,GM1916,Leidschendam-Voorburg,2021JJ00,2021,36874,,365,,393,,-28,2869,,449,2420,2783,,383,-25,2400,86,60,,36934
157684,3000,Male,GM1916,Leidschendam-Voorburg,2022JJ00,2022,36934,,330,,405,,-75,3230,,622,2608,2651,,397,3,2254,579,501,,37435
157685,3000,Male,GM1916,Leidschendam-Voorburg,2023JJ00,2023,37435,,357,,392,,-35,2876,,585,2291,2643,,410,-47,2233,233,200,,37635
157920,3000,Male,GM0995,Lelystad,2012JJ00,2012,37546,,468,,225,,243,1504,,275,1229,1464,,314,-95,1150,40,280,,37826
157921,3000,Male,GM0995,Lelystad,2013JJ00,2013,37826,,452,,260,,192,1474,,283,1191,1484,,258,-41,1226,-10,176,,38002
157922,3000,Male,GM0995,Lelystad,2014JJ00,2014,38002,,456,,262,,194,1548,,276,1272,1655,,373,-88,1282,-107,106,,38108
157923,3000,Male,GM0995,Lelystad,2015JJ00,2015,38108,,435,,261,,174,1678,,294,1384,1595,,217,25,1378,83,259,,38367
157924,3000,Male,GM0995,Lelystad,2016JJ00,2016,38367,,449,,292,,157,1844,,429,1415,1809,,299,-92,1510,35,193,,38560
157925,3000,Male,GM0995,Lelystad,2017JJ00,2017,38560,,407,,273,,134,1951,,340,1611,1825,,207,25,1618,126,255,,38815
157926,3000,Male,GM0995,Lelystad,2018JJ00,2018,38815,,425,,289,,136,1933,,427,1506,1838,,281,-26,1557,95,233,,39048
157927,3000,Male,GM0995,Lelystad,2019JJ00,2019,39048,,388,,301,,87,2295,,594,1701,1941,,298,-52,1643,354,437,,39485
157928,3000,Male,GM0995,Lelystad,2020JJ00,2020,39485,,397,,366,,31,2583,,581,2002,1995,,325,-119,1670,588,625,,40110
157929,3000,Male,GM0995,Lelystad,2021JJ00,2021,40110,,446,,355,,91,2716,,573,2143,2069,,360,-58,1709,647,736,,40846
157930,3000,Male,GM0995,Lelystad,2022JJ00,2022,40846,,421,,362,,59,3184,,1084,2100,2316,,539,-118,1777,868,923,,41769
157931,3000,Male,GM0995,Lelystad,2023JJ00,2023,41769,,451,,340,,111,2853,,826,2027,2461,,670,-285,1791,392,501,,42270
158002,3000,Male,GM0082,Lemsterland,2012JJ00,2012,6902,,70,,62,,8,218,,21,197,237,,21,-1,216,-19,-11,,6891
158003,3000,Male,GM0082,Lemsterland,2013JJ00,2013,6891,,69,,52,,17,211,,20,191,265,,23,-2,242,-54,-37,,6854
158084,3000,Male,GM1640,Leudal,2012JJ00,2012,18443,,130,,155,,-25,870,,254,616,856,,130,-44,726,14,-10,,18433
158085,3000,Male,GM1640,Leudal,2013JJ00,2013,18433,,142,,163,,-21,798,,236,562,893,,120,-53,773,-95,-115,,18318
158086,3000,Male,GM1640,Leudal,2014JJ00,2014,18318,,139,,184,,-45,936,,350,586,860,,73,-14,787,76,31,,18349
158087,3000,Male,GM1640,Leudal,2015JJ00,2015,18349,,141,,183,,-42,983,,330,653,976,,124,-31,852,7,-37,,18312
158088,3000,Male,GM1640,Leudal,2016JJ00,2016,18312,,134,,177,,-43,1125,,312,813,1182,,109,-42,1073,-57,-100,,18212
158089,3000,Male,GM1640,Leudal,2017JJ00,2017,18212,,109,,164,,-55,1134,,183,951,1111,,136,-52,975,23,-32,,18180
158090,3000,Male,GM1640,Leudal,2018JJ00,2018,18180,,131,,199,,-68,1025,,184,841,1096,,140,-48,956,-71,-138,,18042
158091,3000,Male,GM1640,Leudal,2019JJ00,2019,18042,,137,,172,,-35,1130,,271,859,991,,144,-48,847,139,104,,18146
158092,3000,Male,GM1640,Leudal,2020JJ00,2020,18146,,155,,229,,-74,1165,,168,997,974,,131,-41,843,191,119,,18265
158093,3000,Male,GM1640,Leudal,2021JJ00,2021,18265,,140,,224,,-84,1153,,141,1012,1134,,178,-76,956,19,-65,,18200
158094,3000,Male,GM1640,Leudal,2022JJ00,2022,18200,,136,,198,,-62,1201,,235,966,1034,,169,-54,865,167,105,,18305
158095,3000,Male,GM1640,Leudal,2023JJ00,2023,18305,,167,,222,,-55,1068,,204,864,1053,,190,-70,863,15,-40,,18265
158166,3000,Male,GM0327,Leusden,2012JJ00,2012,14157,,146,,98,,48,507,,33,474,528,,55,-11,473,-21,28,,14185
158167,3000,Male,GM0327,Leusden,2013JJ00,2013,14185,,142,,116,,26,508,,51,457,470,,34,-2,436,38,66,,14251
158168,3000,Male,GM0327,Leusden,2014JJ00,2014,14251,,141,,103,,38,540,,50,490,565,,38,-5,527,-25,12,,14263
158169,3000,Male,GM0327,Leusden,2015JJ00,2015,14263,,132,,91,,41,698,,43,655,591,,39,2,552,107,148,,14411
158170,3000,Male,GM0327,Leusden,2016JJ00,2016,14411,,130,,101,,29,984,,46,938,831,,63,-13,768,153,183,,14594
158171,3000,Male,GM0327,Leusden,2017JJ00,2017,14594,,135,,121,,14,711,,39,672,700,,44,-11,656,11,25,,14619
158172,3000,Male,GM0327,Leusden,2018JJ00,2018,14619,,139,,126,,13,773,,44,729,683,,46,-5,637,90,104,,14723
158173,3000,Male,GM0327,Leusden,2019JJ00,2019,14723,,138,,107,,31,773,,62,711,615,,30,2,585,158,191,,14914
158174,3000,Male,GM0327,Leusden,2020JJ00,2020,14914,,154,,135,,19,794,,56,738,763,,52,-15,711,31,50,,14964
158175,3000,Male,GM0327,Leusden,2021JJ00,2021,14964,,155,,158,,-3,773,,61,712,715,,41,-10,674,58,55,,15019
158176,3000,Male,GM0327,Leusden,2022JJ00,2022,15019,,126,,139,,-13,1051,,200,851,670,,82,-33,588,381,367,,15386
158177,3000,Male,GM0327,Leusden,2023JJ00,2023,15386,,161,,162,,-1,851,,87,764,717,,72,-20,645,134,133,,15519
158822,3000,Male,GM0694,Liesveld,2012JJ00,2012,4917,,50,,35,,15,119,,10,109,143,,14,-5,129,-24,-14,,4903
159150,3000,Male,GM0733,Lingewaal,2012JJ00,2012,5438,,35,,45,,-10,240,,15,225,186,,15,0,171,54,44,,5482
159151,3000,Male,GM0733,Lingewaal,2013JJ00,2013,5482,,48,,33,,15,206,,16,190,203,,13,4,190,3,18,,5500
159152,3000,Male,GM0733,Lingewaal,2014JJ00,2014,5500,,53,,50,,3,200,,13,187,208,,16,-5,192,-8,-5,,5495
159153,3000,Male,GM0733,Lingewaal,2015JJ00,2015,5495,,48,,43,,5,247,,29,218,220,,19,-3,201,27,32,,5527
159154,3000,Male,GM0733,Lingewaal,2016JJ00,2016,5527,,70,,30,,40,263,,31,232,259,,15,3,244,4,44,,5571
159155,3000,Male,GM0733,Lingewaal,2017JJ00,2017,5571,,51,,56,,-5,275,,21,254,289,,16,3,273,-14,-19,,5552
159156,3000,Male,GM0733,Lingewaal,2018JJ00,2018,5552,,53,,49,,4,292,,18,274,287,,21,-2,266,5,8,,5560
159232,3000,Male,GM1705,Lingewaard,2012JJ00,2012,22704,,233,,186,,47,660,,54,606,676,,58,-16,618,-16,32,,22736
159233,3000,Male,GM1705,Lingewaard,2013JJ00,2013,22736,,211,,164,,47,694,,65,629,750,,50,5,700,-56,-7,,22729
159234,3000,Male,GM1705,Lingewaard,2014JJ00,2014,22729,,197,,167,,30,701,,54,647,726,,48,7,678,-25,4,,22733
159235,3000,Male,GM1705,Lingewaard,2015JJ00,2015,22733,,193,,177,,16,814,,74,740,791,,73,-16,718,23,41,,22774
159236,3000,Male,GM1705,Lingewaard,2016JJ00,2016,22774,,187,,196,,-9,994,,88,906,860,,72,-4,788,134,124,,22898
159237,3000,Male,GM1705,Lingewaard,2017JJ00,2017,22898,,186,,161,,25,905,,87,818,821,,59,2,762,84,111,,23009
159238,3000,Male,GM1705,Lingewaard,2018JJ00,2018,23009,,212,,197,,15,893,,77,816,875,,80,-10,795,18,32,,23041
159239,3000,Male,GM1705,Lingewaard,2019JJ00,2019,23041,,185,,197,,-12,893,,88,805,840,,77,-22,763,53,42,,23083
159240,3000,Male,GM1705,Lingewaard,2020JJ00,2020,23083,,196,,224,,-28,1008,,73,935,854,,46,6,808,154,124,,23207
159241,3000,Male,GM1705,Lingewaard,2021JJ00,2021,23207,,203,,247,,-44,972,,69,903,853,,62,-2,791,119,75,,23282
159242,3000,Male,GM1705,Lingewaard,2022JJ00,2022,23282,,214,,195,,19,900,,121,779,796,,61,-13,735,104,126,,23408
159243,3000,Male,GM1705,Lingewaard,2023JJ00,2023,23408,,206,,228,,-22,953,,143,810,866,,109,-26,757,87,64,,23472
159478,3000,Male,GM0553,Lisse,2012JJ00,2012,11087,,121,,93,,28,403,,97,306,473,,119,0,354,-70,-42,,11045
159479,3000,Male,GM0553,Lisse,2013JJ00,2013,11045,,111,,91,,20,385,,69,316,444,,77,6,367,-59,-38,,11007
159480,3000,Male,GM0553,Lisse,2014JJ00,2014,11007,,114,,97,,17,475,,57,418,418,,73,5,345,57,72,,11079
159481,3000,Male,GM0553,Lisse,2015JJ00,2015,11079,,114,,78,,36,486,,63,423,495,,62,7,433,-9,28,,11107
159482,3000,Male,GM0553,Lisse,2016JJ00,2016,11107,,104,,92,,12,527,,57,470,467,,50,-4,417,60,71,,11178
159483,3000,Male,GM0553,Lisse,2017JJ00,2017,11178,,112,,90,,22,550,,52,498,558,,49,3,509,-8,14,,11192
159484,3000,Male,GM0553,Lisse,2018JJ00,2018,11192,,103,,96,,7,508,,66,442,492,,59,-9,433,16,23,,11215
159485,3000,Male,GM0553,Lisse,2019JJ00,2019,11215,,123,,90,,33,582,,64,518,531,,57,-2,474,51,85,,11300
159486,3000,Male,GM0553,Lisse,2020JJ00,2020,11300,,104,,111,,-7,493,,52,441,463,,39,-3,424,30,24,,11324
159487,3000,Male,GM0553,Lisse,2021JJ00,2021,11324,,107,,95,,12,531,,63,468,507,,61,-12,446,24,36,,11360
159488,3000,Male,GM0553,Lisse,2022JJ00,2022,11360,,112,,121,,-9,650,,145,505,493,,62,-10,431,157,149,,11509
159489,3000,Male,GM0553,Lisse,2023JJ00,2023,11509,,109,,120,,-11,579,,123,456,565,,92,-17,473,14,3,,11512
159724,3000,Male,GM0140,Littenseradiel,2012JJ00,2012,5543,,60,,32,,28,178,,9,169,183,,19,0,164,-5,23,,5566
159725,3000,Male,GM0140,Littenseradiel,2013JJ00,2013,5566,,67,,42,,25,183,,6,177,198,,11,-1,187,-15,7,,5573
159726,3000,Male,GM0140,Littenseradiel,2014JJ00,2014,5573,,63,,48,,15,201,,5,196,247,,9,1,238,-46,-31,,5542
159727,3000,Male,GM0140,Littenseradiel,2015JJ00,2015,5542,,61,,37,,24,183,,12,171,237,,19,1,218,-54,-31,,5511
159728,3000,Male,GM0140,Littenseradiel,2016JJ00,2016,5511,,61,,47,,14,216,,18,198,246,,15,-3,231,-30,-16,,5495
159729,3000,Male,GM0140,Littenseradiel,2017JJ00,2017,5495,,55,,41,,14,260,,16,244,300,,15,-1,285,-40,-31,,5464
159806,3000,Male,GM0262,Lochem,2012JJ00,2012,16320,,101,,179,,-78,755,,45,710,655,,62,-12,593,100,22,,16342
159807,3000,Male,GM0262,Lochem,2013JJ00,2013,16342,,134,,207,,-73,746,,62,684,695,,64,-3,631,51,-21,,16321
159808,3000,Male,GM0262,Lochem,2014JJ00,2014,16321,,105,,177,,-72,812,,67,745,731,,65,-10,666,81,9,,16330
159809,3000,Male,GM0262,Lochem,2015JJ00,2015,16330,,133,,198,,-65,870,,80,790,703,,51,-6,652,167,103,,16433
159810,3000,Male,GM0262,Lochem,2016JJ00,2016,16433,,116,,175,,-59,953,,61,892,760,,65,-10,695,193,136,,16569
159811,3000,Male,GM0262,Lochem,2017JJ00,2017,16569,,107,,184,,-77,950,,38,912,907,,56,-9,851,43,-34,,16535
159812,3000,Male,GM0262,Lochem,2018JJ00,2018,16535,,123,,174,,-51,900,,52,848,816,,55,-19,761,84,33,,16568
159813,3000,Male,GM0262,Lochem,2019JJ00,2019,16568,,113,,210,,-97,943,,92,851,763,,41,-3,722,180,83,,16651
159814,3000,Male,GM0262,Lochem,2020JJ00,2020,16651,,108,,219,,-111,1013,,57,956,780,,39,-7,741,233,122,,16773
159815,3000,Male,GM0262,Lochem,2021JJ00,2021,16773,,134,,223,,-89,896,,52,844,723,,45,-5,678,173,83,,16856
159816,3000,Male,GM0262,Lochem,2022JJ00,2022,16856,,128,,227,,-99,984,,168,816,801,,76,-25,725,183,87,,16943
159817,3000,Male,GM0262,Lochem,2023JJ00,2023,16943,,112,,211,,-99,950,,75,875,843,,56,-8,787,107,8,,16951
160052,3000,Male,GM0809,Loon op Zand,2012JJ00,2012,11424,,111,,109,,2,472,,41,431,469,,43,-12,426,3,6,,11430
160053,3000,Male,GM0809,Loon op Zand,2013JJ00,2013,11430,,105,,111,,-6,499,,62,437,502,,61,-17,441,-3,-9,,11421
160054,3000,Male,GM0809,Loon op Zand,2014JJ00,2014,11421,,95,,96,,-1,444,,57,387,487,,49,-9,438,-43,-43,,11378
160055,3000,Male,GM0809,Loon op Zand,2015JJ00,2015,11378,,103,,110,,-7,538,,60,478,564,,61,-23,503,-26,-33,,11345
160056,3000,Male,GM0809,Loon op Zand,2016JJ00,2016,11345,,99,,101,,-2,641,,88,553,524,,52,-14,472,117,116,,11461
160057,3000,Male,GM0809,Loon op Zand,2017JJ00,2017,11461,,91,,118,,-27,655,,85,570,620,,61,-21,559,35,8,,11469
160058,3000,Male,GM0809,Loon op Zand,2018JJ00,2018,11469,,103,,117,,-14,676,,101,575,534,,61,-17,473,142,127,,11596
160059,3000,Male,GM0809,Loon op Zand,2019JJ00,2019,11596,,123,,105,,18,582,,72,510,567,,65,-16,502,15,33,,11629
160060,3000,Male,GM0809,Loon op Zand,2020JJ00,2020,11629,,100,,139,,-39,640,,64,576,580,,45,-1,535,60,21,,11650
160061,3000,Male,GM0809,Loon op Zand,2021JJ00,2021,11650,,122,,134,,-12,730,,68,662,603,,54,-10,549,127,115,,11765
160062,3000,Male,GM0809,Loon op Zand,2022JJ00,2022,11765,,110,,138,,-28,594,,92,502,570,,78,-14,492,24,-4,,11761
160063,3000,Male,GM0809,Loon op Zand,2023JJ00,2023,11761,,118,,127,,-9,564,,103,461,517,,66,-14,451,47,39,,11800
160216,3000,Male,GM0331,Lopik,2012JJ00,2012,7155,,64,,41,,23,205,,15,190,265,,24,-3,241,-60,-37,,7118
160217,3000,Male,GM0331,Lopik,2013JJ00,2013,7118,,63,,33,,30,235,,25,210,272,,26,-6,246,-37,-7,,7111
160218,3000,Male,GM0331,Lopik,2014JJ00,2014,7111,,61,,34,,27,238,,22,216,207,,7,3,200,31,59,,7170
160219,3000,Male,GM0331,Lopik,2015JJ00,2015,7170,,63,,48,,15,311,,38,273,310,,17,-2,293,1,19,,7189
160220,3000,Male,GM0331,Lopik,2016JJ00,2016,7189,,71,,57,,14,302,,26,276,312,,23,-4,289,-10,5,,7194
160221,3000,Male,GM0331,Lopik,2017JJ00,2017,7194,,82,,39,,43,386,,21,365,321,,19,-12,302,65,109,,7303
160222,3000,Male,GM0331,Lopik,2018JJ00,2018,7303,,67,,38,,29,336,,25,311,331,,18,-2,313,5,33,,7336
160223,3000,Male,GM0331,Lopik,2019JJ00,2019,7336,,93,,47,,46,301,,22,279,300,,20,-5,280,1,44,,7380
160224,3000,Male,GM0331,Lopik,2020JJ00,2020,7380,,65,,46,,19,303,,25,278,323,,23,-5,300,-20,-1,,7379
160225,3000,Male,GM0331,Lopik,2021JJ00,2021,7379,,80,,55,,25,337,,27,310,330,,11,-2,319,7,32,,7411
160226,3000,Male,GM0331,Lopik,2022JJ00,2022,7411,,78,,65,,13,382,,95,287,297,,43,-12,254,85,99,,7510
160227,3000,Male,GM0331,Lopik,2023JJ00,2023,7510,,68,,56,,12,329,,40,289,318,,46,-12,272,11,22,,7532
160298,3000,Male,GM0024,Loppersum,2012JJ00,2012,5284,,48,,48,,0,190,,3,187,266,,55,-42,211,-76,-76,,5208
160299,3000,Male,GM0024,Loppersum,2013JJ00,2013,5208,,45,,42,,3,176,,10,166,229,,11,0,218,-53,-51,,5157
160300,3000,Male,GM0024,Loppersum,2014JJ00,2014,5157,,34,,54,,-20,205,,12,193,232,,14,3,218,-27,-47,,5110
160301,3000,Male,GM0024,Loppersum,2015JJ00,2015,5110,,42,,33,,9,225,,20,205,264,,18,-2,246,-39,-30,,5080
160302,3000,Male,GM0024,Loppersum,2016JJ00,2016,5080,,46,,37,,9,250,,17,233,318,,16,-4,302,-68,-59,,5021
160303,3000,Male,GM0024,Loppersum,2017JJ00,2017,5021,,32,,50,,-18,222,,14,208,286,,10,0,276,-64,-82,,4939
160304,3000,Male,GM0024,Loppersum,2018JJ00,2018,4939,,37,,37,,0,254,,10,244,312,,8,1,304,-58,-58,,4881
160305,3000,Male,GM0024,Loppersum,2019JJ00,2019,4881,,38,,49,,-11,241,,17,224,281,,6,0,275,-40,-51,,4830
160306,3000,Male,GM0024,Loppersum,2020JJ00,2020,4830,,45,,36,,9,208,,12,196,218,,10,-2,208,-10,-2,,4828
160380,3000,Male,GM0168,Losser,2012JJ00,2012,11395,,82,,108,,-26,344,,49,295,385,,63,-11,322,-41,-66,,11329
160381,3000,Male,GM0168,Losser,2013JJ00,2013,11329,,104,,119,,-15,386,,45,341,356,,53,-1,303,30,15,,11344
160382,3000,Male,GM0168,Losser,2014JJ00,2014,11344,,74,,91,,-17,344,,42,302,374,,49,-8,325,-30,-49,,11295
160383,3000,Male,GM0168,Losser,2015JJ00,2015,11295,,79,,119,,-40,407,,67,340,403,,75,-12,328,4,-35,,11260
160384,3000,Male,GM0168,Losser,2016JJ00,2016,11260,,96,,126,,-30,443,,46,397,361,,42,3,319,82,52,,11312
160385,3000,Male,GM0168,Losser,2017JJ00,2017,11312,,104,,125,,-21,485,,47,438,409,,45,-2,364,76,54,,11366
160386,3000,Male,GM0168,Losser,2018JJ00,2018,11366,,101,,109,,-8,440,,45,395,382,,38,0,344,58,50,,11416
160387,3000,Male,GM0168,Losser,2019JJ00,2019,11416,,92,,122,,-30,434,,59,375,419,,33,-2,386,15,-13,,11403
160388,3000,Male,GM0168,Losser,2020JJ00,2020,11403,,104,,134,,-30,534,,67,467,397,,37,-11,360,137,110,,11513
160389,3000,Male,GM0168,Losser,2021JJ00,2021,11513,,113,,127,,-14,521,,57,464,360,,49,-12,311,161,148,,11661
160390,3000,Male,GM0168,Losser,2022JJ00,2022,11661,,82,,122,,-40,523,,97,426,352,,60,-8,292,171,132,,11793
160391,3000,Male,GM0168,Losser,2023JJ00,2023,11793,,98,,122,,-24,473,,93,380,403,,54,-13,349,70,46,,11839
161200,3000,Male,GM1671,Maasdonk,2012JJ00,2012,5644,,48,,35,,13,167,,12,155,201,,1,8,200,-34,-21,,5623
161201,3000,Male,GM1671,Maasdonk,2013JJ00,2013,5623,,56,,31,,25,231,,20,211,216,,13,-1,203,15,40,,5663
161202,3000,Male,GM1671,Maasdonk,2014JJ00,2014,5663,,49,,34,,15,279,,28,251,217,,17,0,200,62,69,,5732
161282,3000,Male,GM0263,Maasdriel,2012JJ00,2012,12120,,101,,96,,5,479,,148,331,442,,84,-19,358,37,43,,12163
161283,3000,Male,GM0263,Maasdriel,2013JJ00,2013,12163,,109,,74,,35,479,,195,284,464,,66,2,398,15,49,,12212
161284,3000,Male,GM0263,Maasdriel,2014JJ00,2014,12212,,137,,111,,26,511,,165,346,528,,120,-7,408,-17,9,,12221
161285,3000,Male,GM0263,Maasdriel,2015JJ00,2015,12221,,119,,109,,10,479,,122,357,535,,109,-25,426,-56,-45,,12176
161286,3000,Male,GM0263,Maasdriel,2016JJ00,2016,12176,,123,,98,,25,573,,128,445,474,,85,-17,389,99,124,,12300
161287,3000,Male,GM0263,Maasdriel,2017JJ00,2017,12300,,116,,94,,22,632,,110,522,608,,111,-25,497,24,46,,12346
161288,3000,Male,GM0263,Maasdriel,2018JJ00,2018,12346,,124,,116,,8,774,,247,527,591,,117,-22,474,183,191,,12537
161289,3000,Male,GM0263,Maasdriel,2019JJ00,2019,12537,,115,,94,,21,835,,320,515,658,,163,-58,495,177,196,,12733
161290,3000,Male,GM0263,Maasdriel,2020JJ00,2020,12733,,97,,115,,-18,1084,,560,524,854,,338,-145,516,230,214,,12947
161291,3000,Male,GM0263,Maasdriel,2021JJ00,2021,12947,,134,,123,,11,1020,,488,532,945,,430,-122,515,75,85,,13032
161292,3000,Male,GM0263,Maasdriel,2022JJ00,2022,13032,,101,,109,,-8,1307,,776,531,1019,,526,-260,493,288,276,,13308
161293,3000,Male,GM0263,Maasdriel,2023JJ00,2023,13308,,126,,110,,16,966,,438,528,850,,342,-140,508,116,132,,13440
161364,3000,Male,GM1641,Maasgouw,2012JJ00,2012,12037,,80,,122,,-42,474,,64,410,430,,43,-3,387,44,2,,12039
161365,3000,Male,GM1641,Maasgouw,2013JJ00,2013,12039,,89,,119,,-30,461,,61,400,486,,60,3,426,-25,-52,,11987
161366,3000,Male,GM1641,Maasgouw,2014JJ00,2014,11987,,76,,138,,-62,491,,65,426,522,,75,-19,447,-31,-92,,11895
161367,3000,Male,GM1641,Maasgouw,2015JJ00,2015,11895,,88,,113,,-25,501,,63,438,443,,45,-1,398,58,35,,11930
161368,3000,Male,GM1641,Maasgouw,2016JJ00,2016,11930,,92,,137,,-45,560,,51,509,500,,48,-8,452,60,15,,11945
161369,3000,Male,GM1641,Maasgouw,2017JJ00,2017,11945,,101,,136,,-35,600,,65,535,591,,62,-9,529,9,-25,,11920
161370,3000,Male,GM1641,Maasgouw,2018JJ00,2018,11920,,80,,134,,-54,649,,83,566,562,,56,-13,506,87,33,,11953
161371,3000,Male,GM1641,Maasgouw,2019JJ00,2019,11953,,69,,140,,-71,775,,104,671,552,,50,-7,502,223,151,,12104
161372,3000,Male,GM1641,Maasgouw,2020JJ00,2020,12104,,98,,160,,-62,628,,71,557,604,,62,-3,542,24,-35,,12069
161373,3000,Male,GM1641,Maasgouw,2021JJ00,2021,12069,,110,,187,,-77,635,,62,573,529,,70,-12,459,106,27,,12096
161374,3000,Male,GM1641,Maasgouw,2022JJ00,2022,12096,,98,,165,,-67,805,,142,663,626,,110,-23,516,179,112,,12208
161375,3000,Male,GM1641,Maasgouw,2023JJ00,2023,12208,,99,,157,,-58,649,,125,524,547,,70,-8,477,102,42,,12250
161538,3000,Male,GM1991,Maashorst,2022JJ00,2022,29201,,261,,299,,-38,1270,,314,956,1005,,146,-42,859,265,227,,29428
161539,3000,Male,GM1991,Maashorst,2023JJ00,2023,29428,,311,,279,,32,1289,,282,1007,1121,,204,-53,917,168,198,,29626
161774,3000,Male,GM0556,Maassluis,2012JJ00,2012,15603,,166,,140,,26,670,,101,569,603,,73,5,530,67,94,,15697
161775,3000,Male,GM0556,Maassluis,2013JJ00,2013,15697,,142,,128,,14,656,,116,540,655,,120,-21,535,1,14,,15711
161776,3000,Male,GM0556,Maassluis,2014JJ00,2014,15711,,173,,129,,44,659,,125,534,652,,125,-14,527,7,51,,15762
161777,3000,Male,GM0556,Maassluis,2015JJ00,2015,15762,,162,,127,,35,717,,127,590,691,,145,-40,546,26,67,,15829
161778,3000,Male,GM0556,Maassluis,2016JJ00,2016,15829,,177,,140,,37,740,,101,639,689,,102,-2,587,51,88,,15917
161779,3000,Male,GM0556,Maassluis,2017JJ00,2017,15917,,164,,150,,14,750,,104,646,700,,92,-1,608,50,64,,15981
161780,3000,Male,GM0556,Maassluis,2018JJ00,2018,15981,,163,,152,,11,757,,119,638,671,,123,-5,548,86,96,,16077
161781,3000,Male,GM0556,Maassluis,2019JJ00,2019,16077,,183,,160,,23,897,,164,733,703,,106,-13,597,194,217,,16294
161782,3000,Male,GM0556,Maassluis,2020JJ00,2020,16294,,187,,188,,-1,874,,115,759,686,,71,6,615,188,185,,16479
161783,3000,Male,GM0556,Maassluis,2021JJ00,2021,16479,,201,,181,,20,1032,,140,892,747,,113,-16,634,285,307,,16786
161784,3000,Male,GM0556,Maassluis,2022JJ00,2022,16786,,198,,183,,15,1196,,225,971,678,,118,-27,560,518,532,,17318
161785,3000,Male,GM0556,Maassluis,2023JJ00,2023,17318,,183,,196,,-13,1003,,193,810,782,,153,-45,629,221,204,,17522
161856,3000,Male,GM0935,Maastricht,2012JJ00,2012,58231,,437,,570,,-133,4363,,2121,2242,3896,,1470,-254,2426,467,333,,58564
161857,3000,Male,GM0935,Maastricht,2013JJ00,2013,58564,,464,,567,,-103,4590,,2184,2406,4199,,1766,-190,2433,391,290,,58854
161858,3000,Male,GM0935,Maastricht,2014JJ00,2014,58854,,445,,602,,-157,4547,,2153,2394,4439,,1941,-181,2498,108,-55,,58799
161859,3000,Male,GM0935,Maastricht,2015JJ00,2015,58799,,473,,616,,-143,5112,,2833,2279,4864,,1967,-71,2897,248,110,,58909
161860,3000,Male,GM0935,Maastricht,2016JJ00,2016,58909,,459,,580,,-121,5093,,2605,2488,4920,,1988,-58,2932,173,46,,58955
161861,3000,Male,GM0935,Maastricht,2017JJ00,2017,58955,,467,,615,,-148,4937,,2564,2373,4976,,2110,-44,2866,-39,-188,,58767
161862,3000,Male,GM0935,Maastricht,2018JJ00,2018,58767,,422,,596,,-174,4908,,2615,2293,5283,,2572,-75,2711,-375,-548,,58219
161863,3000,Male,GM0935,Maastricht,2019JJ00,2019,58219,,453,,605,,-152,5187,,2882,2305,5125,,2333,31,2792,62,-99,,58120
161864,3000,Male,GM0935,Maastricht,2020JJ00,2020,58120,,400,,721,,-321,5369,,2489,2880,5514,,2662,16,2852,-145,-471,,57649
161865,3000,Male,GM0935,Maastricht,2021JJ00,2021,57649,,485,,680,,-195,5835,,2879,2956,5337,,2326,2,3011,498,294,,57943
161866,3000,Male,GM0935,Maastricht,2022JJ00,2022,57943,,436,,657,,-221,6048,,3195,2853,5104,,2223,-13,2881,944,719,,58662
161867,3000,Male,GM0935,Maastricht,2023JJ00,2023,58662,,425,,624,,-199,6367,,3190,3177,5147,,2226,1,2921,1220,1022,,59684
162430,3000,Male,GM1663,De Marne,2012JJ00,2012,5305,,36,,56,,-20,168,,22,146,194,,15,-2,179,-26,-46,,5259
162431,3000,Male,GM1663,De Marne,2013JJ00,2013,5259,,40,,62,,-22,173,,19,154,227,,16,-6,211,-54,-76,,5183
162432,3000,Male,GM1663,De Marne,2014JJ00,2014,5183,,46,,52,,-6,196,,16,180,226,,6,1,220,-30,-35,,5148
162433,3000,Male,GM1663,De Marne,2015JJ00,2015,5148,,33,,49,,-16,208,,10,198,240,,30,-9,210,-32,-48,,5100
162434,3000,Male,GM1663,De Marne,2016JJ00,2016,5100,,51,,49,,2,215,,23,192,220,,23,-10,197,-5,0,,5100
162435,3000,Male,GM1663,De Marne,2017JJ00,2017,5100,,43,,53,,-10,222,,13,209,232,,19,-5,213,-10,-20,,5080
162436,3000,Male,GM1663,De Marne,2018JJ00,2018,5080,,50,,68,,-18,237,,17,220,222,,12,-5,210,15,-5,,5075
162512,3000,Male,GM0025,Marum,2012JJ00,2012,5339,,54,,43,,11,167,,26,141,208,,18,1,190,-41,-30,,5309
162513,3000,Male,GM0025,Marum,2013JJ00,2013,5309,,56,,30,,26,186,,16,170,210,,19,-6,191,-24,1,,5310
162514,3000,Male,GM0025,Marum,2014JJ00,2014,5310,,48,,44,,4,214,,15,199,213,,13,-2,200,1,6,,5316
162515,3000,Male,GM0025,Marum,2015JJ00,2015,5316,,52,,43,,9,221,,14,207,243,,10,-4,233,-22,-12,,5304
162516,3000,Male,GM0025,Marum,2016JJ00,2016,5304,,42,,35,,7,295,,12,283,242,,16,-2,226,53,60,,5364
162517,3000,Male,GM0025,Marum,2017JJ00,2017,5364,,48,,45,,3,331,,18,313,277,,16,-5,261,54,56,,5420
162518,3000,Male,GM0025,Marum,2018JJ00,2018,5420,,53,,49,,4,289,,21,268,284,,7,3,277,5,5,,5425
162676,3000,Male,GM0420,Medemblik,2012JJ00,2012,21916,,208,,150,,58,767,,120,647,711,,87,-15,624,56,117,,22033
162677,3000,Male,GM0420,Medemblik,2013JJ00,2013,22033,,177,,168,,9,740,,156,584,758,,72,15,686,-18,-6,,22027
162678,3000,Male,GM0420,Medemblik,2014JJ00,2014,22027,,215,,183,,32,985,,261,724,827,,133,-7,694,158,190,,22217
162679,3000,Male,GM0420,Medemblik,2015JJ00,2015,22217,,209,,210,,-1,1024,,222,802,992,,182,-11,810,32,32,,22249
162680,3000,Male,GM0420,Medemblik,2016JJ00,2016,22249,,203,,179,,24,1090,,202,888,934,,143,-2,791,156,178,,22427
162681,3000,Male,GM0420,Medemblik,2017JJ00,2017,22427,,206,,196,,10,1201,,205,996,994,,152,-1,842,207,217,,22644
162682,3000,Male,GM0420,Medemblik,2018JJ00,2018,22644,,199,,191,,8,1165,,220,945,1036,,135,-10,901,129,134,,22778
162683,3000,Male,GM0420,Medemblik,2019JJ00,2019,22778,,190,,198,,-8,1151,,283,868,959,,149,-19,810,192,184,,22962
162684,3000,Male,GM0420,Medemblik,2020JJ00,2020,22962,,185,,217,,-32,1190,,264,926,1141,,225,-79,916,49,17,,22979
162685,3000,Male,GM0420,Medemblik,2021JJ00,2021,22979,,231,,248,,-17,1286,,355,931,1141,,273,-49,868,145,131,,23110
162686,3000,Male,GM0420,Medemblik,2022JJ00,2022,23110,,200,,239,,-39,1445,,513,932,1180,,329,-73,851,265,227,,23337
162687,3000,Male,GM0420,Medemblik,2023JJ00,2023,23337,,183,,227,,-44,1220,,287,933,1197,,269,-63,928,23,-23,,23314
163086,3000,Male,GM0938,Meerssen,2012JJ00,2012,9553,,72,,82,,-10,385,,56,329,377,,56,-11,321,8,-3,,9550
163087,3000,Male,GM0938,Meerssen,2013JJ00,2013,9550,,58,,96,,-38,386,,50,336,417,,63,4,354,-31,-69,,9481
163088,3000,Male,GM0938,Meerssen,2014JJ00,2014,9481,,73,,96,,-23,392,,44,348,422,,50,2,372,-30,-54,,9427
163089,3000,Male,GM0938,Meerssen,2015JJ00,2015,9427,,60,,102,,-42,443,,39,404,421,,50,-12,371,22,-20,,9407
163090,3000,Male,GM0938,Meerssen,2016JJ00,2016,9407,,73,,95,,-22,431,,51,380,418,,48,-6,370,13,-9,,9398
163091,3000,Male,GM0938,Meerssen,2017JJ00,2017,9398,,69,,98,,-29,447,,51,396,446,,49,-9,397,1,-28,,9370
163092,3000,Male,GM0938,Meerssen,2018JJ00,2018,9370,,55,,114,,-59,460,,56,404,456,,50,-6,406,4,-56,,9314
163093,3000,Male,GM0938,Meerssen,2019JJ00,2019,9314,,42,,105,,-63,462,,55,407,449,,49,-5,400,13,-48,,9266
163094,3000,Male,GM0938,Meerssen,2020JJ00,2020,9266,,74,,122,,-48,439,,43,396,481,,46,-4,435,-42,-92,,9174
163095,3000,Male,GM0938,Meerssen,2021JJ00,2021,9174,,78,,131,,-53,465,,59,406,436,,66,-3,370,29,-23,,9151
163096,3000,Male,GM0938,Meerssen,2022JJ00,2022,9151,,65,,114,,-49,491,,88,403,438,,61,-2,377,53,5,,9156
163097,3000,Male,GM0938,Meerssen,2023JJ00,2023,9156,,61,,129,,-68,505,,70,435,443,,57,-6,386,62,-9,,9147
163255,3000,Male,GM1948,Meierijstad,2017JJ00,2017,40052,,419,,335,,84,1623,,312,1311,1505,,284,-86,1221,118,200,,40252
163256,3000,Male,GM1948,Meierijstad,2018JJ00,2018,40252,,372,,346,,26,1752,,374,1378,1458,,237,-71,1221,294,321,,40573
163257,3000,Male,GM1948,Meierijstad,2019JJ00,2019,40573,,373,,372,,1,1668,,410,1258,1420,,270,-56,1150,248,249,,40822
163258,3000,Male,GM1948,Meierijstad,2020JJ00,2020,40822,,401,,470,,-69,1907,,444,1463,1532,,283,-79,1249,375,306,,41128
163259,3000,Male,GM1948,Meierijstad,2021JJ00,2021,41128,,434,,411,,23,1890,,348,1542,1367,,202,-50,1165,523,547,,41675
163260,3000,Male,GM1948,Meierijstad,2022JJ00,2022,41675,,413,,394,,19,1929,,661,1268,1426,,337,-73,1089,503,519,,42194
163261,3000,Male,GM1948,Meierijstad,2023JJ00,2023,42194,,406,,404,,2,1952,,483,1469,1596,,282,-45,1314,356,362,,42556
163742,3000,Male,GM1908,Menameradiel,2012JJ00,2012,7008,,69,,38,,31,230,,25,205,256,,11,3,245,-26,5,,7013
163743,3000,Male,GM1908,Menameradiel,2013JJ00,2013,7013,,63,,51,,12,215,,14,201,255,,10,3,245,-40,-28,,6985
163744,3000,Male,GM1908,Menameradiel,2014JJ00,2014,6985,,58,,59,,-1,252,,23,229,276,,19,0,257,-24,-25,,6960
163745,3000,Male,GM1908,Menameradiel,2015JJ00,2015,6960,,65,,60,,5,271,,26,245,298,,15,-1,283,-27,-22,,6938
163746,3000,Male,GM1908,Menameradiel,2016JJ00,2016,6938,,60,,66,,-6,305,,19,286,340,,24,-6,316,-35,-39,,6899
163747,3000,Male,GM1908,Menameradiel,2017JJ00,2017,6899,,64,,55,,9,310,,16,294,322,,14,1,308,-12,-4,,6895
163824,3000,Male,GM1987,Menterwolde,2012JJ00,2012,6296,,63,,54,,9,228,,8,220,253,,13,-4,240,-25,-15,,6281
163825,3000,Male,GM1987,Menterwolde,2013JJ00,2013,6281,,46,,51,,-5,218,,11,207,272,,8,1,264,-54,-59,,6222
163826,3000,Male,GM1987,Menterwolde,2014JJ00,2014,6222,,50,,61,,-11,247,,6,241,282,,14,-1,268,-35,-46,,6176
163827,3000,Male,GM1987,Menterwolde,2015JJ00,2015,6176,,61,,59,,2,294,,13,281,279,,13,-1,266,15,17,,6193
163828,3000,Male,GM1987,Menterwolde,2016JJ00,2016,6193,,54,,43,,11,310,,10,300,333,,19,-10,314,-23,-12,,6181
163829,3000,Male,GM1987,Menterwolde,2017JJ00,2017,6181,,51,,60,,-9,322,,8,314,379,,11,1,368,-57,-66,,6115
163906,3000,Male,GM0119,Meppel,2012JJ00,2012,15919,,177,,144,,33,632,,61,571,564,,45,1,519,68,101,,16020
163907,3000,Male,GM0119,Meppel,2013JJ00,2013,16020,,178,,142,,36,582,,49,533,561,,46,2,515,21,57,,16077
163908,3000,Male,GM0119,Meppel,2014JJ00,2014,16077,,184,,127,,57,599,,54,545,687,,74,-14,613,-88,-31,,16046
163909,3000,Male,GM0119,Meppel,2015JJ00,2015,16046,,147,,131,,16,679,,63,616,702,,76,-8,626,-23,-6,,16040
163910,3000,Male,GM0119,Meppel,2016JJ00,2016,16040,,151,,150,,1,805,,47,758,708,,54,-9,654,97,97,,16137
163911,3000,Male,GM0119,Meppel,2017JJ00,2017,16137,,172,,166,,6,845,,52,793,700,,32,13,668,145,150,,16287
163912,3000,Male,GM0119,Meppel,2018JJ00,2018,16287,,140,,163,,-23,822,,81,741,710,,83,-24,627,112,89,,16376
163913,3000,Male,GM0119,Meppel,2019JJ00,2019,16376,,164,,135,,29,891,,69,822,723,,53,-1,670,168,197,,16573
163914,3000,Male,GM0119,Meppel,2020JJ00,2020,16573,,154,,154,,0,921,,58,863,693,,41,-13,652,228,227,,16800
163915,3000,Male,GM0119,Meppel,2021JJ00,2021,16800,,188,,201,,-13,909,,84,825,738,,50,-11,688,171,158,,16958
163916,3000,Male,GM0119,Meppel,2022JJ00,2022,16958,,148,,175,,-27,1092,,289,803,728,,110,-35,618,364,337,,17295
163917,3000,Male,GM0119,Meppel,2023JJ00,2023,17295,,168,,189,,-21,1111,,152,959,848,,112,-35,736,263,239,,17534
164234,3000,Male,GM0687,Middelburg (Z.),2012JJ00,2012,23242,,237,,219,,18,1087,,144,943,1299,,293,-185,1006,-212,-198,,23044
164235,3000,Male,GM0687,Middelburg (Z.),2013JJ00,2013,23044,,248,,189,,59,1144,,143,1001,1100,,141,-32,959,44,103,,23147
164236,3000,Male,GM0687,Middelburg (Z.),2014JJ00,2014,23147,,236,,211,,25,1086,,141,945,1156,,150,-36,1006,-70,-43,,23104
164237,3000,Male,GM0687,Middelburg (Z.),2015JJ00,2015,23104,,236,,203,,33,1352,,268,1084,1241,,145,-34,1096,111,141,,23245
164238,3000,Male,GM0687,Middelburg (Z.),2016JJ00,2016,23245,,234,,219,,15,1549,,327,1222,1480,,167,-39,1313,69,86,,23331
164239,3000,Male,GM0687,Middelburg (Z.),2017JJ00,2017,23331,,221,,217,,4,1577,,226,1351,1405,,162,-28,1243,172,175,,23506
164240,3000,Male,GM0687,Middelburg (Z.),2018JJ00,2018,23506,,212,,243,,-31,1471,,225,1246,1410,,168,-36,1242,61,33,,23539
164241,3000,Male,GM0687,Middelburg (Z.),2019JJ00,2019,23539,,243,,254,,-11,1462,,245,1217,1293,,175,-34,1118,169,161,,23700
164242,3000,Male,GM0687,Middelburg (Z.),2020JJ00,2020,23700,,226,,209,,17,1518,,275,1243,1440,,166,-44,1274,78,96,,23796
164243,3000,Male,GM0687,Middelburg (Z.),2021JJ00,2021,23796,,243,,304,,-61,1615,,281,1334,1396,,177,-46,1219,219,159,,23955
164244,3000,Male,GM0687,Middelburg (Z.),2022JJ00,2022,23955,,238,,249,,-11,1902,,457,1445,1571,,191,-22,1380,331,316,,24271
164245,3000,Male,GM0687,Middelburg (Z.),2023JJ00,2023,24271,,245,,239,,6,1737,,323,1414,1636,,260,-66,1376,101,111,,24382
164316,3000,Male,GM0559,Middelharnis,2012JJ00,2012,8855,,103,,112,,-9,253,,29,224,242,,14,5,228,11,-1,,8854
164562,3000,Male,GM1842,Midden-Delfland,2012JJ00,2012,9235,,93,,48,,45,370,,40,330,428,,31,-1,397,-58,-13,,9222
164563,3000,Male,GM1842,Midden-Delfland,2013JJ00,2013,9222,,95,,51,,44,393,,26,367,328,,28,0,300,65,111,,9333
164564,3000,Male,GM1842,Midden-Delfland,2014JJ00,2014,9333,,99,,58,,41,494,,37,457,405,,28,0,377,89,128,,9461
164565,3000,Male,GM1842,Midden-Delfland,2015JJ00,2015,9461,,89,,79,,10,472,,36,436,425,,41,1,384,47,57,,9518
164566,3000,Male,GM1842,Midden-Delfland,2016JJ00,2016,9518,,88,,60,,28,472,,27,445,444,,36,-7,408,28,55,,9573
164567,3000,Male,GM1842,Midden-Delfland,2017JJ00,2017,9573,,99,,85,,14,587,,36,551,478,,48,-9,430,109,124,,9697
164568,3000,Male,GM1842,Midden-Delfland,2018JJ00,2018,9697,,100,,66,,34,426,,28,398,440,,30,-4,410,-14,20,,9717
164569,3000,Male,GM1842,Midden-Delfland,2019JJ00,2019,9717,,82,,66,,16,390,,31,359,462,,36,-3,426,-72,-57,,9660
164570,3000,Male,GM1842,Midden-Delfland,2020JJ00,2020,9660,,85,,56,,29,463,,30,433,450,,19,6,431,13,43,,9703
164571,3000,Male,GM1842,Midden-Delfland,2021JJ00,2021,9703,,96,,65,,31,454,,38,416,428,,39,1,389,26,59,,9762
164572,3000,Male,GM1842,Midden-Delfland,2022JJ00,2022,9762,,106,,78,,28,389,,44,345,429,,39,1,390,-40,-12,,9750
164573,3000,Male,GM1842,Midden-Delfland,2023JJ00,2023,9750,,85,,70,,15,390,,59,331,441,,39,-3,402,-51,-36,,9714
164644,3000,Male,GM1731,Midden-Drenthe,2012JJ00,2012,16739,,134,,155,,-21,553,,30,523,604,,60,-12,544,-51,-71,,16668
164645,3000,Male,GM1731,Midden-Drenthe,2013JJ00,2013,16668,,147,,171,,-24,604,,31,573,599,,38,7,561,5,-18,,16650
164646,3000,Male,GM1731,Midden-Drenthe,2014JJ00,2014,16650,,145,,127,,18,568,,37,531,626,,39,0,587,-58,-40,,16610
164647,3000,Male,GM1731,Midden-Drenthe,2015JJ00,2015,16610,,139,,202,,-63,1125,,385,740,986,,42,8,944,139,78,,16688
164648,3000,Male,GM1731,Midden-Drenthe,2016JJ00,2016,16688,,149,,191,,-42,1236,,347,889,1207,,48,7,1159,29,-6,,16682
164649,3000,Male,GM1731,Midden-Drenthe,2017JJ00,2017,16682,,138,,170,,-32,926,,81,845,1040,,77,-31,963,-114,-138,,16544
164650,3000,Male,GM1731,Midden-Drenthe,2018JJ00,2018,16544,,144,,161,,-17,828,,64,764,799,,45,-1,754,29,12,,16556
164651,3000,Male,GM1731,Midden-Drenthe,2019JJ00,2019,16556,,116,,193,,-77,823,,65,758,739,,43,-9,696,84,6,,16562
164652,3000,Male,GM1731,Midden-Drenthe,2020JJ00,2020,16562,,124,,186,,-62,936,,76,860,742,,45,-13,697,194,131,,16693
164653,3000,Male,GM1731,Midden-Drenthe,2021JJ00,2021,16693,,163,,198,,-35,854,,28,826,676,,46,-8,630,178,144,,16837
164654,3000,Male,GM1731,Midden-Drenthe,2022JJ00,2022,16837,,116,,211,,-95,900,,157,743,712,,83,-13,629,188,91,,16928
164655,3000,Male,GM1731,Midden-Drenthe,2023JJ00,2023,16928,,163,,179,,-16,792,,97,695,704,,68,-17,636,88,69,,16997
164732,3000,Male,GM1952,Midden-Groningen,2018JJ00,2018,30560,,263,,310,,-47,1398,,161,1237,1345,,93,-25,1252,53,3,,30563
164733,3000,Male,GM1952,Midden-Groningen,2019JJ00,2019,30563,,272,,308,,-36,1336,,153,1183,1360,,89,8,1271,-24,-59,,30504
164734,3000,Male,GM1952,Midden-Groningen,2020JJ00,2020,30504,,243,,325,,-82,1458,,194,1264,1400,,116,-29,1284,58,-27,,30477
164735,3000,Male,GM1952,Midden-Groningen,2021JJ00,2021,30477,,250,,344,,-94,1575,,196,1379,1387,,175,-77,1212,188,94,,30571
164736,3000,Male,GM1952,Midden-Groningen,2022JJ00,2022,30571,,250,,360,,-110,1750,,441,1309,1289,,145,-18,1144,461,354,,30925
164737,3000,Male,GM1952,Midden-Groningen,2023JJ00,2023,30925,,271,,349,,-78,1698,,311,1387,1606,,263,-122,1343,92,14,,30939
165382,3000,Male,GM0815,Mill en Sint Hubert,2012JJ00,2012,5541,,36,,39,,-3,172,,18,154,171,,22,-8,149,1,-3,,5538
165383,3000,Male,GM0815,Mill en Sint Hubert,2013JJ00,2013,5538,,42,,52,,-10,157,,13,144,175,,12,-4,163,-18,-28,,5510
165384,3000,Male,GM0815,Mill en Sint Hubert,2014JJ00,2014,5510,,54,,51,,3,207,,28,179,199,,24,-4,175,8,11,,5521
165385,3000,Male,GM0815,Mill en Sint Hubert,2015JJ00,2015,5521,,42,,43,,-1,193,,12,181,202,,24,-3,178,-9,-9,,5512
165386,3000,Male,GM0815,Mill en Sint Hubert,2016JJ00,2016,5512,,31,,66,,-35,218,,9,209,175,,7,-2,168,43,8,,5520
165387,3000,Male,GM0815,Mill en Sint Hubert,2017JJ00,2017,5520,,39,,48,,-9,225,,13,212,196,,14,1,182,29,20,,5540
165388,3000,Male,GM0815,Mill en Sint Hubert,2018JJ00,2018,5540,,45,,49,,-4,244,,23,221,206,,28,-7,178,38,34,,5574
165389,3000,Male,GM0815,Mill en Sint Hubert,2019JJ00,2019,5574,,40,,45,,-5,244,,22,222,220,,21,-2,199,24,20,,5594
165390,3000,Male,GM0815,Mill en Sint Hubert,2020JJ00,2020,5594,,44,,68,,-24,248,,25,223,216,,22,-2,194,32,8,,5602
165391,3000,Male,GM0815,Mill en Sint Hubert,2021JJ00,2021,5602,,41,,56,,-15,253,,21,232,217,,20,-6,197,36,19,,5621
165546,3000,Male,GM0265,Millingen aan de Rijn,2012JJ00,2012,2955,,19,,35,,-16,85,,6,79,79,,4,-2,75,6,-10,,2945
165547,3000,Male,GM0265,Millingen aan de Rijn,2013JJ00,2013,2945,,26,,24,,2,100,,13,87,108,,11,1,97,-8,-6,,2939
165548,3000,Male,GM0265,Millingen aan de Rijn,2014JJ00,2014,2939,,23,,20,,3,101,,12,89,98,,15,1,83,3,5,,2944
165628,3000,Male,GM1709,Moerdijk,2012JJ00,2012,18195,,187,,177,,10,613,,92,521,520,,53,0,467,93,102,,18297
165629,3000,Male,GM1709,Moerdijk,2013JJ00,2013,18297,,160,,124,,36,604,,64,540,562,,74,-8,488,42,80,,18377
165630,3000,Male,GM1709,Moerdijk,2014JJ00,2014,18377,,178,,158,,20,652,,87,565,631,,86,-12,545,21,42,,18419
165631,3000,Male,GM1709,Moerdijk,2015JJ00,2015,18419,,180,,177,,3,645,,83,562,669,,86,-27,583,-24,-22,,18397
165632,3000,Male,GM1709,Moerdijk,2016JJ00,2016,18397,,152,,154,,-2,805,,67,738,709,,76,-4,633,96,94,,18491
165633,3000,Male,GM1709,Moerdijk,2017JJ00,2017,18491,,146,,156,,-10,819,,90,729,783,,95,-13,688,36,27,,18518
165634,3000,Male,GM1709,Moerdijk,2018JJ00,2018,18518,,182,,204,,-22,809,,129,680,770,,76,-10,694,39,17,,18535
165635,3000,Male,GM1709,Moerdijk,2019JJ00,2019,18535,,145,,185,,-40,891,,164,727,739,,87,-21,652,152,115,,18650
165636,3000,Male,GM1709,Moerdijk,2020JJ00,2020,18650,,147,,198,,-51,849,,99,750,781,,110,-47,671,68,16,,18666
165637,3000,Male,GM1709,Moerdijk,2021JJ00,2021,18666,,178,,240,,-62,884,,96,788,756,,97,-32,659,128,65,,18731
165638,3000,Male,GM1709,Moerdijk,2022JJ00,2022,18731,,163,,185,,-22,951,,197,754,759,,100,-8,659,192,172,,18903
165639,3000,Male,GM1709,Moerdijk,2023JJ00,2023,18903,,187,,178,,9,956,,159,797,770,,148,-50,622,186,197,,19100
166045,3000,Male,GM1978,Molenlanden,2019JJ00,2019,22226,,233,,163,,70,743,,93,650,781,,72,-5,709,-38,30,,22256
166046,3000,Male,GM1978,Molenlanden,2020JJ00,2020,22256,,221,,170,,51,845,,108,737,833,,53,-6,780,12,61,,22317
166047,3000,Male,GM1978,Molenlanden,2021JJ00,2021,22317,,271,,197,,74,959,,85,874,764,,86,-11,678,195,269,,22586
166048,3000,Male,GM1978,Molenlanden,2022JJ00,2022,22586,,247,,178,,69,934,,192,742,808,,126,-20,682,126,193,,22779
166049,3000,Male,GM1978,Molenlanden,2023JJ00,2023,22779,,276,,187,,89,888,,136,752,860,,101,-13,759,28,115,,22894
166121,3000,Male,GM1927,Molenwaard,2013JJ00,2013,14835,,185,,101,,84,305,,40,265,462,,60,-16,402,-157,-88,,14747
166122,3000,Male,GM1927,Molenwaard,2014JJ00,2014,14747,,178,,90,,88,392,,37,355,511,,49,-8,462,-119,-31,,14716
166123,3000,Male,GM1927,Molenwaard,2015JJ00,2015,14716,,163,,91,,72,440,,38,402,468,,32,-1,436,-28,45,,14761
166124,3000,Male,GM1927,Molenwaard,2016JJ00,2016,14761,,178,,101,,77,494,,54,440,493,,52,-10,441,1,77,,14838
166125,3000,Male,GM1927,Molenwaard,2017JJ00,2017,14838,,167,,88,,79,537,,50,487,581,,50,-6,531,-44,36,,14874
166126,3000,Male,GM1927,Molenwaard,2018JJ00,2018,14874,,162,,112,,50,526,,63,463,588,,61,-12,527,-62,-9,,14865
166366,3000,Male,GM1955,Montferland,2012JJ00,2012,17468,,122,,158,,-36,553,,62,491,620,,74,-11,546,-67,-102,,17366
166367,3000,Male,GM1955,Montferland,2013JJ00,2013,17366,,159,,152,,7,700,,85,615,581,,79,-20,502,119,128,,17494
166368,3000,Male,GM1955,Montferland,2014JJ00,2014,17494,,140,,163,,-23,770,,98,672,658,,92,-23,566,112,93,,17587
166369,3000,Male,GM1955,Montferland,2015JJ00,2015,17587,,132,,177,,-45,730,,78,652,676,,77,-26,599,54,8,,17595
166370,3000,Male,GM1955,Montferland,2016JJ00,2016,17595,,152,,166,,-14,808,,80,728,704,,99,-25,605,104,90,,17685
166371,3000,Male,GM1955,Montferland,2017JJ00,2017,17685,,159,,180,,-21,932,,128,804,766,,68,-3,698,166,148,,17833
166372,3000,Male,GM1955,Montferland,2018JJ00,2018,17833,,131,,184,,-53,957,,174,783,724,,132,-26,592,233,179,,18012
166373,3000,Male,GM1955,Montferland,2019JJ00,2019,18012,,173,,179,,-6,893,,130,763,858,,125,-27,733,35,30,,18042
166374,3000,Male,GM1955,Montferland,2020JJ00,2020,18042,,156,,221,,-65,845,,95,750,786,,96,-38,690,59,-6,,18036
166375,3000,Male,GM1955,Montferland,2021JJ00,2021,18036,,161,,225,,-64,953,,102,851,707,,69,-5,638,246,182,,18218
166376,3000,Male,GM1955,Montferland,2022JJ00,2022,18218,,154,,176,,-22,1057,,245,812,767,,146,-32,621,290,266,,18484
166377,3000,Male,GM1955,Montferland,2023JJ00,2023,18484,,146,,222,,-76,867,,158,709,808,,174,-25,634,59,-17,,18467
166448,3000,Male,GM0335,Montfoort,2012JJ00,2012,6809,,82,,42,,40,179,,20,159,188,,17,-2,171,-9,30,,6839
166449,3000,Male,GM0335,Montfoort,2013JJ00,2013,6839,,65,,39,,26,211,,19,192,241,,26,-4,215,-30,-4,,6835
166450,3000,Male,GM0335,Montfoort,2014JJ00,2014,6835,,75,,28,,47,218,,28,190,248,,25,-7,223,-30,17,,6852
166451,3000,Male,GM0335,Montfoort,2015JJ00,2015,6852,,77,,25,,52,251,,19,232,241,,20,-2,221,10,62,,6914
166452,3000,Male,GM0335,Montfoort,2016JJ00,2016,6914,,77,,43,,34,298,,36,262,303,,35,-8,268,-5,29,,6943
166453,3000,Male,GM0335,Montfoort,2017JJ00,2017,6943,,60,,46,,14,286,,20,266,289,,11,8,278,-3,11,,6954
166454,3000,Male,GM0335,Montfoort,2018JJ00,2018,6954,,74,,42,,32,300,,33,267,258,,22,-3,236,42,75,,7029
166455,3000,Male,GM0335,Montfoort,2019JJ00,2019,7029,,66,,53,,13,176,,38,138,266,,26,-6,240,-90,-75,,6954
166456,3000,Male,GM0335,Montfoort,2020JJ00,2020,6954,,74,,48,,26,268,,41,227,302,,29,-5,273,-34,-9,,6945
166457,3000,Male,GM0335,Montfoort,2021JJ00,2021,6945,,60,,43,,17,256,,21,235,326,,28,-6,298,-70,-53,,6892
166458,3000,Male,GM0335,Montfoort,2022JJ00,2022,6892,,61,,50,,11,311,,78,233,267,,23,1,244,44,58,,6950
166459,3000,Male,GM0335,Montfoort,2023JJ00,2023,6950,,61,,42,,19,257,,43,214,294,,46,-11,248,-37,-18,,6932
166612,3000,Male,GM0944,Mook en Middelaar,2012JJ00,2012,3922,,17,,33,,-16,187,,23,164,201,,20,-2,181,-14,-32,,3890
166613,3000,Male,GM0944,Mook en Middelaar,2013JJ00,2013,3890,,28,,36,,-8,171,,13,158,192,,15,4,177,-21,-31,,3859
166614,3000,Male,GM0944,Mook en Middelaar,2014JJ00,2014,3859,,26,,32,,-6,192,,22,170,207,,21,-4,186,-15,-20,,3839
166615,3000,Male,GM0944,Mook en Middelaar,2015JJ00,2015,3839,,27,,35,,-8,232,,29,203,230,,12,-2,218,2,-7,,3832
166616,3000,Male,GM0944,Mook en Middelaar,2016JJ00,2016,3832,,21,,28,,-7,262,,28,234,237,,23,-4,214,25,17,,3849
166617,3000,Male,GM0944,Mook en Middelaar,2017JJ00,2017,3849,,24,,28,,-4,271,,24,247,269,,20,-2,249,2,0,,3849
166618,3000,Male,GM0944,Mook en Middelaar,2018JJ00,2018,3849,,21,,28,,-7,250,,21,229,211,,16,-6,195,39,32,,3881
166619,3000,Male,GM0944,Mook en Middelaar,2019JJ00,2019,3881,,29,,40,,-11,230,,31,199,211,,11,-2,200,19,7,,3888
166620,3000,Male,GM0944,Mook en Middelaar,2020JJ00,2020,3888,,26,,39,,-13,274,,33,241,219,,18,-7,201,55,42,,3930
166621,3000,Male,GM0944,Mook en Middelaar,2021JJ00,2021,3930,,26,,45,,-19,217,,23,194,180,,6,1,174,37,18,,3948
166622,3000,Male,GM0944,Mook en Middelaar,2022JJ00,2022,3948,,30,,34,,-4,229,,29,200,195,,17,0,178,34,30,,3978
166623,3000,Male,GM0944,Mook en Middelaar,2023JJ00,2023,3978,,31,,43,,-12,277,,63,214,217,,23,-2,194,60,46,,4024
166776,3000,Male,GM0424,Muiden,2012JJ00,2012,3126,,27,,21,,6,128,,11,117,150,,14,0,136,-22,-16,,3110
166777,3000,Male,GM0424,Muiden,2013JJ00,2013,3110,,19,,24,,-5,148,,21,127,199,,4,5,195,-51,-56,,3054
166778,3000,Male,GM0424,Muiden,2014JJ00,2014,3054,,14,,26,,-12,149,,19,130,161,,10,2,151,-12,-25,,3029
166779,3000,Male,GM0424,Muiden,2015JJ00,2015,3029,,32,,31,,1,159,,21,138,175,,37,-4,138,-16,-16,,3013
167104,3000,Male,GM0425,Naarden,2012JJ00,2012,8257,,70,,81,,-11,443,,41,402,373,,18,4,355,70,60,,8317
167105,3000,Male,GM0425,Naarden,2013JJ00,2013,8317,,68,,74,,-6,443,,49,394,475,,58,0,417,-32,-35,,8282
167106,3000,Male,GM0425,Naarden,2014JJ00,2014,8282,,81,,69,,12,572,,49,523,539,,46,3,493,33,45,,8327
167107,3000,Male,GM0425,Naarden,2015JJ00,2015,8327,,65,,81,,-16,625,,62,563,523,,32,-3,491,102,83,,8410
167186,3000,Male,GM1740,Neder-Betuwe,2012JJ00,2012,11227,,135,,76,,59,381,,32,349,438,,38,-10,400,-57,3,,11230
167187,3000,Male,GM1740,Neder-Betuwe,2013JJ00,2013,11230,,170,,68,,102,327,,20,307,375,,12,0,363,-48,54,,11284
167188,3000,Male,GM1740,Neder-Betuwe,2014JJ00,2014,11271,,155,,90,,65,356,,47,309,333,,20,1,313,23,89,,11360
167189,3000,Male,GM1740,Neder-Betuwe,2015JJ00,2015,11360,,154,,70,,84,453,,46,407,376,,41,-13,335,77,161,,11521
167190,3000,Male,GM1740,Neder-Betuwe,2016JJ00,2016,11521,,139,,81,,58,483,,40,443,396,,23,-1,373,87,145,,11666
167191,3000,Male,GM1740,Neder-Betuwe,2017JJ00,2017,11666,,175,,88,,87,571,,39,532,472,,38,-14,434,99,185,,11851
167192,3000,Male,GM1740,Neder-Betuwe,2018JJ00,2018,11851,,186,,85,,101,617,,202,415,446,,31,-11,415,171,272,,12123
167193,3000,Male,GM1740,Neder-Betuwe,2019JJ00,2019,12123,,163,,87,,76,586,,140,446,511,,70,-35,441,75,151,,12274
167194,3000,Male,GM1740,Neder-Betuwe,2020JJ00,2020,12274,,181,,111,,70,558,,109,449,468,,69,-22,399,90,159,,12433
167195,3000,Male,GM1740,Neder-Betuwe,2021JJ00,2021,12433,,188,,108,,80,691,,199,492,553,,103,-56,450,138,220,,12653
167196,3000,Male,GM1740,Neder-Betuwe,2022JJ00,2022,12653,,170,,101,,69,695,,258,437,630,,166,-40,464,65,134,,12787
167197,3000,Male,GM1740,Neder-Betuwe,2023JJ00,2023,12787,,191,,93,,98,658,,174,484,619,,154,-86,465,39,137,,12924
167432,3000,Male,GM0643,Nederlek,2012JJ00,2012,6894,,84,,64,,20,258,,30,228,204,,21,-5,183,54,74,,6968
167433,3000,Male,GM0643,Nederlek,2013JJ00,2013,6968,,59,,67,,-8,189,,21,168,211,,24,-4,187,-22,-30,,6938
167434,3000,Male,GM0643,Nederlek,2014JJ00,2014,6938,,59,,64,,-5,279,,22,257,233,,20,3,213,46,36,,6974
167514,3000,Male,GM0946,Nederweert,2012JJ00,2012,8443,,74,,66,,8,257,,47,210,256,,30,-2,226,1,10,,8453
167515,3000,Male,GM0946,Nederweert,2013JJ00,2013,8453,,64,,77,,-13,263,,51,212,269,,48,-10,221,-6,-19,,8434
167516,3000,Male,GM0946,Nederweert,2014JJ00,2014,8434,,65,,59,,6,295,,45,250,266,,41,-15,225,29,34,,8468
167517,3000,Male,GM0946,Nederweert,2015JJ00,2015,8468,,61,,83,,-22,335,,42,293,292,,33,-2,259,43,20,,8488
167518,3000,Male,GM0946,Nederweert,2016JJ00,2016,8488,,83,,88,,-5,390,,51,339,353,,48,-16,305,37,31,,8519
167519,3000,Male,GM0946,Nederweert,2017JJ00,2017,8519,,60,,60,,0,437,,55,382,347,,39,-12,308,90,92,,8611
167520,3000,Male,GM0946,Nederweert,2018JJ00,2018,8611,,75,,79,,-4,338,,53,285,346,,53,-12,293,-8,-13,,8598
167521,3000,Male,GM0946,Nederweert,2019JJ00,2019,8598,,68,,60,,8,342,,69,273,346,,42,-4,304,-4,5,,8603
167522,3000,Male,GM0946,Nederweert,2020JJ00,2020,8603,,84,,92,,-8,451,,93,358,349,,38,-6,311,102,95,,8698
167523,3000,Male,GM0946,Nederweert,2021JJ00,2021,8698,,98,,90,,8,472,,94,378,387,,69,-25,318,85,96,,8794
167524,3000,Male,GM0946,Nederweert,2022JJ00,2022,8794,,78,,99,,-21,445,,153,292,353,,81,-16,272,92,71,,8865
167525,3000,Male,GM0946,Nederweert,2023JJ00,2023,8865,,83,,75,,8,412,,145,267,382,,84,-25,298,30,38,,8903
167760,3000,Male,GM0304,Neerijnen,2012JJ00,2012,5999,,62,,37,,25,212,,21,191,182,,11,-3,171,30,55,,6054
167761,3000,Male,GM0304,Neerijnen,2013JJ00,2013,6054,,71,,45,,26,208,,28,180,225,,21,0,204,-17,9,,6063
167762,3000,Male,GM0304,Neerijnen,2014JJ00,2014,6063,,78,,43,,35,208,,17,191,229,,12,0,217,-21,14,,6077
167763,3000,Male,GM0304,Neerijnen,2015JJ00,2015,6077,,75,,45,,30,270,,41,229,254,,10,1,244,16,46,,6123
167764,3000,Male,GM0304,Neerijnen,2016JJ00,2016,6123,,70,,45,,25,334,,26,308,249,,29,-6,220,85,110,,6233
167765,3000,Male,GM0304,Neerijnen,2017JJ00,2017,6233,,70,,39,,31,291,,24,267,277,,20,-1,257,14,45,,6278
167766,3000,Male,GM0304,Neerijnen,2018JJ00,2018,6278,,70,,53,,17,358,,42,316,317,,10,3,307,41,52,,6330
168416,3000,Male,GM0356,Nieuwegein,2012JJ00,2012,30060,,340,,200,,140,1538,,161,1377,1587,,147,-6,1440,-49,94,,30154
168417,3000,Male,GM0356,Nieuwegein,2013JJ00,2013,30154,,354,,212,,142,1545,,186,1359,1538,,125,30,1413,7,147,,30301
168418,3000,Male,GM0356,Nieuwegein,2014JJ00,2014,30301,,349,,217,,132,1714,,195,1519,1717,,134,31,1583,-3,133,,30434
168419,3000,Male,GM0356,Nieuwegein,2015JJ00,2015,30434,,333,,199,,134,1900,,208,1692,1734,,168,9,1566,166,299,,30733
168420,3000,Male,GM0356,Nieuwegein,2016JJ00,2016,30733,,311,,213,,98,1865,,193,1672,1933,,127,42,1806,-68,30,,30763
168421,3000,Male,GM0356,Nieuwegein,2017JJ00,2017,30763,,334,,229,,105,2110,,204,1906,1970,,155,-3,1815,140,240,,31003
168422,3000,Male,GM0356,Nieuwegein,2018JJ00,2018,31003,,302,,220,,82,2086,,257,1829,1861,,107,47,1754,225,305,,31308
168423,3000,Male,GM0356,Nieuwegein,2019JJ00,2019,31308,,383,,233,,150,2020,,266,1754,1996,,115,25,1881,24,174,,31482
168424,3000,Male,GM0356,Nieuwegein,2020JJ00,2020,31482,,346,,245,,101,2153,,240,1913,2067,,134,-5,1933,86,186,,31668
168425,3000,Male,GM0356,Nieuwegein,2021JJ00,2021,31668,,356,,242,,114,2208,,202,2006,2008,,129,-2,1879,200,311,,31979
168426,3000,Male,GM0356,Nieuwegein,2022JJ00,2022,31979,,318,,260,,58,2397,,349,2048,1988,,196,-24,1792,409,464,,32443
168427,3000,Male,GM0356,Nieuwegein,2023JJ00,2023,32443,,354,,287,,67,2307,,321,1986,2016,,215,-30,1801,291,359,,32802
169236,3000,Male,GM0569,Nieuwkoop,2012JJ00,2012,13649,,113,,91,,22,420,,82,338,358,,49,-4,309,62,86,,13735
169237,3000,Male,GM0569,Nieuwkoop,2013JJ00,2013,13735,,118,,87,,31,380,,58,322,377,,35,-2,342,3,34,,13769
169238,3000,Male,GM0569,Nieuwkoop,2014JJ00,2014,13769,,136,,89,,47,405,,46,359,443,,64,-19,379,-38,9,,13778
169239,3000,Male,GM0569,Nieuwkoop,2015JJ00,2015,13778,,115,,113,,2,615,,64,551,466,,59,-11,407,149,152,,13930
169240,3000,Male,GM0569,Nieuwkoop,2016JJ00,2016,13930,,128,,117,,11,720,,83,637,501,,45,3,456,219,230,,14160
169241,3000,Male,GM0569,Nieuwkoop,2017JJ00,2017,14160,,141,,83,,58,668,,64,604,560,,60,-23,500,108,165,,14325
169242,3000,Male,GM0569,Nieuwkoop,2018JJ00,2018,14325,,155,,107,,48,655,,89,566,551,,68,-16,483,104,150,,14475
169243,3000,Male,GM0569,Nieuwkoop,2019JJ00,2019,14475,,139,,105,,34,642,,84,558,600,,69,-15,531,42,75,,14550
169244,3000,Male,GM0569,Nieuwkoop,2020JJ00,2020,14550,,161,,138,,23,732,,83,649,582,,77,-8,505,150,174,,14724
169245,3000,Male,GM0569,Nieuwkoop,2021JJ00,2021,14724,,157,,112,,45,600,,74,526,552,,67,-19,485,48,93,,14817
169246,3000,Male,GM0569,Nieuwkoop,2022JJ00,2022,14817,,151,,142,,9,616,,131,485,572,,86,-23,486,44,51,,14868
169247,3000,Male,GM0569,Nieuwkoop,2023JJ00,2023,14868,,133,,134,,-1,619,,114,505,594,,93,-13,501,25,23,,14891
169400,3000,Male,GM0571,Nieuw-Lekkerland,2012JJ00,2012,4886,,64,,35,,29,116,,6,110,180,,13,-9,167,-64,-8,,4878
170302,3000,Male,GM0267,Nijkerk,2012JJ00,2012,19972,,244,,145,,99,616,,64,552,592,,74,-17,518,24,120,,20092
170303,3000,Male,GM0267,Nijkerk,2013JJ00,2013,20092,,248,,152,,96,690,,171,519,637,,67,-14,570,53,150,,20242
170304,3000,Male,GM0267,Nijkerk,2014JJ00,2014,20232,,232,,130,,102,762,,120,642,730,,114,-34,616,32,133,,20365
170305,3000,Male,GM0267,Nijkerk,2015JJ00,2015,20365,,221,,130,,91,838,,152,686,754,,92,-8,662,84,177,,20542
170306,3000,Male,GM0267,Nijkerk,2016JJ00,2016,20542,,223,,149,,74,930,,109,821,742,,119,-16,623,188,261,,20803
170307,3000,Male,GM0267,Nijkerk,2017JJ00,2017,20803,,239,,151,,88,1057,,111,946,910,,122,-16,788,147,233,,21036
170308,3000,Male,GM0267,Nijkerk,2018JJ00,2018,21036,,238,,133,,105,1019,,145,874,775,,103,-12,672,244,351,,21387
170309,3000,Male,GM0267,Nijkerk,2019JJ00,2019,21387,,231,,169,,62,960,,123,837,924,,119,-15,805,36,101,,21488
170310,3000,Male,GM0267,Nijkerk,2020JJ00,2020,21488,,228,,148,,80,972,,121,851,824,,80,-6,744,148,228,,21716
170311,3000,Male,GM0267,Nijkerk,2021JJ00,2021,21716,,254,,185,,69,1180,,132,1048,861,,89,-1,772,319,389,,22105
170312,3000,Male,GM0267,Nijkerk,2022JJ00,2022,22105,,243,,190,,53,1103,,228,875,822,,118,-22,704,281,331,,22436
170313,3000,Male,GM0267,Nijkerk,2023JJ00,2023,22436,,242,,188,,54,1087,,195,892,903,,143,-48,760,184,238,,22674
170384,3000,Male,GM0268,Nijmegen,2012JJ00,2012,79080,,859,,589,,270,5295,,939,4356,5017,,1049,-308,3968,278,539,,79619
170385,3000,Male,GM0268,Nijmegen,2013JJ00,2013,79619,,910,,633,,277,5659,,1107,4552,4868,,1108,-350,3760,791,1061,,80680
170386,3000,Male,GM0268,Nijmegen,2014JJ00,2014,80680,,902,,597,,305,6096,,1279,4817,5142,,1029,-248,4113,954,1254,,81934
170387,3000,Male,GM0268,Nijmegen,2015JJ00,2015,81934,,928,,621,,307,6061,,1335,4726,5425,,1031,-286,4394,636,943,,82877
170388,3000,Male,GM0268,Nijmegen,2016JJ00,2016,82877,,889,,629,,260,6827,,1596,5231,5984,,1094,-265,4890,843,1088,,83965
170389,3000,Male,GM0268,Nijmegen,2017JJ00,2017,83965,,905,,675,,230,6965,,1336,5629,6033,,1120,-299,4913,932,1154,,85119
170390,3000,Male,GM0268,Nijmegen,2018JJ00,2018,85119,,875,,712,,163,6204,,1386,4818,5894,,1106,-321,4788,310,478,,85597
170391,3000,Male,GM0268,Nijmegen,2019JJ00,2019,85582,,893,,642,,251,6178,,1488,4690,5988,,1293,-470,4695,190,461,,86043
170392,3000,Male,GM0268,Nijmegen,2020JJ00,2020,86043,,937,,772,,165,5637,,1201,4436,5805,,985,-236,4820,-168,-6,,86037
170393,3000,Male,GM0268,Nijmegen,2021JJ00,2021,86037,,920,,770,,150,5874,,1234,4640,5361,,866,-267,4495,513,662,,86699
170394,3000,Male,GM0268,Nijmegen,2022JJ00,2022,86699,,855,,779,,76,6621,,1865,4756,5226,,938,-173,4288,1395,1459,,88158
170395,3000,Male,GM0268,Nijmegen,2023JJ00,2023,88158,,902,,749,,153,7491,,1525,5966,5675,,1151,-284,4524,1816,1941,,90099
170551,3000,Male,GM1930,Nissewaard,2015JJ00,2015,41808,,428,,308,,120,1521,,185,1336,1578,,213,-45,1365,-57,27,,41835
170552,3000,Male,GM1930,Nissewaard,2016JJ00,2016,41835,,449,,326,,123,1517,,161,1356,1670,,177,-39,1493,-153,-32,,41803
170553,3000,Male,GM1930,Nissewaard,2017JJ00,2017,41803,,399,,345,,54,1895,,202,1693,1802,,260,-33,1542,93,147,,41950
170554,3000,Male,GM1930,Nissewaard,2018JJ00,2018,41360,,408,,342,,66,1825,,192,1633,1781,,164,-32,1617,44,110,,41470
170555,3000,Male,GM1930,Nissewaard,2019JJ00,2019,41470,,429,,336,,93,1927,,213,1714,1745,,164,-23,1581,182,277,,41747
170556,3000,Male,GM1930,Nissewaard,2020JJ00,2020,41747,,429,,406,,23,1936,,208,1728,1822,,130,-19,1692,114,136,,41883
170557,3000,Male,GM1930,Nissewaard,2021JJ00,2021,41883,,463,,390,,73,2127,,183,1944,1793,,149,2,1644,334,403,,42286
170558,3000,Male,GM1930,Nissewaard,2022JJ00,2022,42286,,463,,429,,34,2094,,346,1748,1871,,233,-20,1638,223,252,,42538
170559,3000,Male,GM1930,Nissewaard,2023JJ00,2023,42538,,414,,393,,21,2301,,349,1952,1831,,168,-13,1663,470,492,,43030
170719,3000,Male,GM1970,Noardeast-Fryslân,2019JJ00,2019,22791,,207,,218,,-11,770,,66,704,784,,50,-10,734,-14,-23,,22768
170720,3000,Male,GM1970,Noardeast-Fryslân,2020JJ00,2020,22768,,209,,259,,-50,897,,72,825,734,,46,-9,688,163,111,,22879
170721,3000,Male,GM1970,Noardeast-Fryslân,2021JJ00,2021,22879,,223,,267,,-44,836,,57,779,737,,43,-4,694,99,54,,22933
170722,3000,Male,GM1970,Noardeast-Fryslân,2022JJ00,2022,22933,,225,,249,,-24,893,,140,753,732,,79,-12,653,161,137,,23070
170723,3000,Male,GM1970,Noardeast-Fryslân,2023JJ00,2023,23070,,198,,264,,-66,853,,95,758,716,,85,-10,631,137,73,,23143
170876,3000,Male,GM1695,Noord-Beveland,2012JJ00,2012,3766,,31,,31,,0,207,,23,184,211,,16,-3,195,-4,-6,,3760
170877,3000,Male,GM1695,Noord-Beveland,2013JJ00,2013,3760,,35,,42,,-7,232,,24,208,213,,8,4,205,19,11,,3771
170878,3000,Male,GM1695,Noord-Beveland,2014JJ00,2014,3771,,39,,51,,-12,213,,38,175,247,,30,-11,217,-34,-47,,3724
170879,3000,Male,GM1695,Noord-Beveland,2015JJ00,2015,3724,,37,,56,,-19,197,,23,174,202,,21,-5,181,-5,-25,,3699
170880,3000,Male,GM1695,Noord-Beveland,2016JJ00,2016,3699,,29,,48,,-19,238,,27,211,227,,14,-3,213,11,-8,,3691
170881,3000,Male,GM1695,Noord-Beveland,2017JJ00,2017,3691,,35,,53,,-18,270,,25,245,264,,32,-9,232,6,-11,,3680
170882,3000,Male,GM1695,Noord-Beveland,2018JJ00,2018,3680,,28,,40,,-12,246,,32,214,245,,28,-5,217,1,-11,,3669
170883,3000,Male,GM1695,Noord-Beveland,2019JJ00,2019,3669,,28,,48,,-20,296,,41,255,230,,16,-4,214,66,46,,3715
170884,3000,Male,GM1695,Noord-Beveland,2020JJ00,2020,3715,,21,,56,,-35,354,,43,311,228,,29,-10,199,126,89,,3804
170885,3000,Male,GM1695,Noord-Beveland,2021JJ00,2021,3804,,36,,68,,-32,296,,38,258,210,,20,-6,190,86,51,,3855
170886,3000,Male,GM1695,Noord-Beveland,2022JJ00,2022,3855,,19,,50,,-31,321,,86,235,219,,39,-7,180,102,72,,3927
170887,3000,Male,GM1695,Noord-Beveland,2023JJ00,2023,3927,,25,,47,,-22,279,,59,220,213,,35,-7,178,66,45,,3972
171204,3000,Male,GM1699,Noordenveld,2012JJ00,2012,15342,,104,,149,,-45,742,,48,694,644,,1,26,643,98,54,,15396
171205,3000,Male,GM1699,Noordenveld,2013JJ00,2013,15396,,114,,150,,-36,792,,45,747,692,,11,32,681,100,67,,15463
171206,3000,Male,GM1699,Noordenveld,2014JJ00,2014,15463,,115,,155,,-40,838,,50,788,762,,-2,38,764,76,35,,15498
171207,3000,Male,GM1699,Noordenveld,2015JJ00,2015,15498,,111,,159,,-48,830,,46,784,871,,36,1,835,-41,-91,,15407
171208,3000,Male,GM1699,Noordenveld,2016JJ00,2016,15407,,106,,132,,-26,4255,,3430,825,3464,,26,9,3438,791,766,,16173
171209,3000,Male,GM1699,Noordenveld,2017JJ00,2017,16173,,132,,151,,-19,7848,,7040,808,8012,,32,3,7980,-164,-191,,15982
171210,3000,Male,GM1699,Noordenveld,2018JJ00,2018,15982,,116,,154,,-38,869,,52,817,1260,,23,9,1237,-391,-438,,15544
171211,3000,Male,GM1699,Noordenveld,2019JJ00,2019,15544,,110,,162,,-52,871,,52,819,866,,5,32,861,5,-44,,15500
171212,3000,Male,GM1699,Noordenveld,2020JJ00,2020,15500,,136,,184,,-48,847,,60,787,827,,1,32,826,20,-27,,15473
171213,3000,Male,GM1699,Noordenveld,2021JJ00,2021,15473,,118,,204,,-86,937,,32,905,801,,-7,32,808,136,50,,15523
171214,3000,Male,GM1699,Noordenveld,2022JJ00,2022,15523,,122,,163,,-41,981,,137,844,819,,32,16,787,162,121,,15644
171215,3000,Male,GM1699,Noordenveld,2023JJ00,2023,15644,,123,,202,,-79,899,,74,825,813,,54,-9,759,86,3,,15647
171532,3000,Male,GM0171,Noordoostpolder,2012JJ00,2012,23452,,271,,172,,99,901,,336,565,1046,,203,-130,843,-145,-42,,23410
171533,3000,Male,GM0171,Noordoostpolder,2013JJ00,2013,23410,,276,,180,,96,1027,,456,571,1067,,121,-37,946,-40,56,,23466
171534,3000,Male,GM0171,Noordoostpolder,2014JJ00,2014,23466,,270,,167,,103,1452,,830,622,1432,,139,-54,1293,20,123,,23589
171535,3000,Male,GM0171,Noordoostpolder,2015JJ00,2015,23589,,298,,160,,138,1813,,1082,731,1937,,175,-66,1762,-124,14,,23603
171536,3000,Male,GM0171,Noordoostpolder,2016JJ00,2016,23603,,282,,165,,117,1856,,738,1118,1924,,154,-64,1770,-68,59,,23662
171537,3000,Male,GM0171,Noordoostpolder,2017JJ00,2017,23662,,275,,176,,99,1258,,276,982,1372,,184,-102,1188,-114,-16,,23646
171538,3000,Male,GM0171,Noordoostpolder,2018JJ00,2018,23646,,302,,159,,143,1205,,298,907,1260,,190,-94,1070,-55,89,,23735
171539,3000,Male,GM0171,Noordoostpolder,2019JJ00,2019,23727,,288,,174,,114,1299,,350,949,1186,,186,-86,1000,113,231,,23958
171540,3000,Male,GM0171,Noordoostpolder,2020JJ00,2020,23958,,281,,201,,80,1333,,234,1099,1191,,145,-48,1046,142,222,,24180
171541,3000,Male,GM0171,Noordoostpolder,2021JJ00,2021,24180,,289,,228,,61,1580,,197,1383,1482,,246,-153,1236,98,164,,24344
171542,3000,Male,GM0171,Noordoostpolder,2022JJ00,2022,24344,,283,,178,,105,2234,,1018,1216,1557,,450,-86,1107,677,783,,25127
171543,3000,Male,GM0171,Noordoostpolder,2023JJ00,2023,25127,,284,,201,,83,1986,,633,1353,1825,,708,-99,1117,161,243,,25370
171696,3000,Male,GM0575,Noordwijk,2012JJ00,2012,12836,,95,,111,,-16,684,,155,529,607,,107,-15,500,77,62,,12898
171697,3000,Male,GM0575,Noordwijk,2013JJ00,2013,12898,,104,,101,,3,646,,129,517,665,,127,-32,538,-19,-11,,12887
171698,3000,Male,GM0575,Noordwijk,2014JJ00,2014,12887,,107,,112,,-5,639,,149,490,687,,115,-27,572,-48,-54,,12833
171699,3000,Male,GM0575,Noordwijk,2015JJ00,2015,12833,,114,,114,,0,774,,154,620,698,,110,-11,588,76,75,,12908
171700,3000,Male,GM0575,Noordwijk,2016JJ00,2016,12908,,111,,103,,8,765,,161,604,742,,119,-27,623,23,31,,12939
171701,3000,Male,GM0575,Noordwijk,2017JJ00,2017,12939,,117,,128,,-11,823,,145,678,712,,98,-15,614,111,99,,13038
171702,3000,Male,GM0575,Noordwijk,2018JJ00,2018,13038,,107,,142,,-35,799,,201,598,689,,97,-4,592,110,77,,13115
171703,3000,Male,GM0575,Noordwijk,2019JJ00,2019,21526,,176,,208,,-32,1333,,371,962,984,,186,-17,798,349,313,,21839
171704,3000,Male,GM0575,Noordwijk,2020JJ00,2020,21839,,196,,201,,-5,1338,,251,1087,1044,,220,-71,824,294,289,,22128
171705,3000,Male,GM0575,Noordwijk,2021JJ00,2021,22128,,210,,214,,-4,1196,,247,949,1018,,163,-18,855,178,174,,22302
171706,3000,Male,GM0575,Noordwijk,2022JJ00,2022,22302,,200,,223,,-23,1384,,446,938,1094,,238,-45,856,290,269,,22571
171707,3000,Male,GM0575,Noordwijk,2023JJ00,2023,22571,,187,,212,,-25,1334,,336,998,1024,,185,-25,839,310,281,,22852
171778,3000,Male,GM0576,Noordwijkerhout,2012JJ00,2012,7888,,70,,68,,2,387,,59,328,346,,51,-2,295,41,41,,7929
171779,3000,Male,GM0576,Noordwijkerhout,2013JJ00,2013,7929,,77,,63,,14,454,,70,384,375,,54,-17,321,79,87,,8016
171780,3000,Male,GM0576,Noordwijkerhout,2014JJ00,2014,8016,,75,,70,,5,406,,73,333,377,,70,-17,307,29,37,,8053
171781,3000,Male,GM0576,Noordwijkerhout,2015JJ00,2015,8053,,78,,72,,6,443,,81,362,408,,44,-3,364,35,44,,8097
171782,3000,Male,GM0576,Noordwijkerhout,2016JJ00,2016,8097,,72,,59,,13,559,,176,383,449,,96,-6,353,110,120,,8217
171783,3000,Male,GM0576,Noordwijkerhout,2017JJ00,2017,8217,,84,,60,,24,710,,259,451,582,,183,-12,399,128,149,,8366
171784,3000,Male,GM0576,Noordwijkerhout,2018JJ00,2018,8366,,90,,63,,27,553,,191,362,535,,174,-3,361,18,45,,8411
172024,3000,Male,GM0820,"Nuenen, Gerwen en Nederwetten",2012JJ00,2012,11185,,93,,83,,10,443,,43,400,391,,34,1,357,52,61,,11246
172025,3000,Male,GM0820,"Nuenen, Gerwen en Nederwetten",2013JJ00,2013,11246,,76,,93,,-17,440,,55,385,436,,53,4,383,4,-13,,11233
172026,3000,Male,GM0820,"Nuenen, Gerwen en Nederwetten",2014JJ00,2014,11233,,95,,82,,13,439,,42,397,444,,34,-4,410,-5,7,,11240
172027,3000,Male,GM0820,"Nuenen, Gerwen en Nederwetten",2015JJ00,2015,11240,,91,,105,,-14,518,,46,472,462,,47,1,415,56,42,,11282
172028,3000,Male,GM0820,"Nuenen, Gerwen en Nederwetten",2016JJ00,2016,11282,,114,,92,,22,543,,47,496,537,,31,3,506,6,29,,11311
172029,3000,Male,GM0820,"Nuenen, Gerwen en Nederwetten",2017JJ00,2017,11311,,93,,102,,-9,599,,55,544,543,,47,0,496,56,49,,11360
172030,3000,Male,GM0820,"Nuenen, Gerwen en Nederwetten",2018JJ00,2018,11360,,94,,109,,-15,631,,71,560,515,,39,1,476,116,100,,11460
172031,3000,Male,GM0820,"Nuenen, Gerwen en Nederwetten",2019JJ00,2019,11460,,104,,100,,4,589,,63,526,503,,44,-3,459,86,91,,11551
172032,3000,Male,GM0820,"Nuenen, Gerwen en Nederwetten",2020JJ00,2020,11551,,126,,107,,19,689,,55,634,501,,23,0,478,188,207,,11758
172033,3000,Male,GM0820,"Nuenen, Gerwen en Nederwetten",2021JJ00,2021,11758,,105,,108,,-3,597,,56,541,576,,31,-2,545,21,19,,11777
172034,3000,Male,GM0820,"Nuenen, Gerwen en Nederwetten",2022JJ00,2022,11777,,109,,115,,-6,637,,88,549,533,,70,-10,463,104,100,,11877
172035,3000,Male,GM0820,"Nuenen, Gerwen en Nederwetten",2023JJ00,2023,11877,,106,,120,,-14,661,,100,561,512,,58,-3,454,149,137,,12014
172352,3000,Male,GM0302,Nunspeet,2012JJ00,2012,13125,,156,,109,,47,383,,39,344,424,,35,-9,389,-41,8,,13133
172353,3000,Male,GM0302,Nunspeet,2013JJ00,2013,13133,,168,,102,,66,384,,37,347,422,,41,-14,381,-38,25,,13158
172354,3000,Male,GM0302,Nunspeet,2014JJ00,2014,13158,,177,,109,,68,422,,53,369,455,,18,10,437,-33,35,,13193
172355,3000,Male,GM0302,Nunspeet,2015JJ00,2015,13193,,169,,114,,55,495,,63,432,491,,40,-7,451,4,58,,13251
172356,3000,Male,GM0302,Nunspeet,2016JJ00,2016,13251,,137,,128,,9,535,,41,494,496,,33,-3,463,39,49,,13300
172357,3000,Male,GM0302,Nunspeet,2017JJ00,2017,13300,,170,,119,,51,573,,26,547,527,,28,-8,499,46,98,,13398
172358,3000,Male,GM0302,Nunspeet,2018JJ00,2018,13398,,164,,121,,43,647,,56,591,489,,62,-16,427,158,201,,13599
172359,3000,Male,GM0302,Nunspeet,2019JJ00,2019,13599,,170,,124,,46,624,,60,564,463,,36,-1,427,161,208,,13807
172360,3000,Male,GM0302,Nunspeet,2020JJ00,2020,13807,,168,,163,,5,594,,49,545,541,,17,2,524,53,56,,13863
172361,3000,Male,GM0302,Nunspeet,2021JJ00,2021,13863,,180,,127,,53,534,,26,508,490,,35,-11,455,44,96,,13959
172362,3000,Male,GM0302,Nunspeet,2022JJ00,2022,13959,,157,,141,,16,654,,130,524,469,,51,1,418,185,198,,14157
172363,3000,Male,GM0302,Nunspeet,2023JJ00,2023,14157,,169,,135,,34,666,,70,596,495,,68,-13,427,171,204,,14361
172434,3000,Male,GM0951,Nuth,2012JJ00,2012,7712,,57,,70,,-13,313,,35,278,339,,44,-6,295,-26,-38,,7674
172435,3000,Male,GM0951,Nuth,2013JJ00,2013,7674,,57,,67,,-10,328,,35,293,295,,21,-3,274,33,23,,7697
172436,3000,Male,GM0951,Nuth,2014JJ00,2014,7697,,50,,61,,-11,336,,42,294,363,,52,-13,311,-27,-38,,7659
172437,3000,Male,GM0951,Nuth,2015JJ00,2015,7659,,50,,78,,-28,345,,40,305,353,,31,-2,322,-8,-35,,7624
172438,3000,Male,GM0951,Nuth,2016JJ00,2016,7624,,43,,93,,-50,382,,43,339,394,,48,-17,346,-12,-63,,7561
172439,3000,Male,GM0951,Nuth,2017JJ00,2017,7561,,63,,82,,-19,405,,46,359,398,,26,5,372,7,-13,,7548
172440,3000,Male,GM0951,Nuth,2018JJ00,2018,7548,,49,,74,,-25,394,,37,357,377,,41,-11,336,17,-10,,7538
172926,3000,Male,GM0579,Oegstgeest,2012JJ00,2012,10950,,100,,84,,16,892,,185,707,679,,137,-14,542,213,229,,11179
172927,3000,Male,GM0579,Oegstgeest,2013JJ00,2013,11179,,104,,85,,19,722,,161,561,897,,163,-35,734,-175,-159,,11020
172928,3000,Male,GM0579,Oegstgeest,2014JJ00,2014,11020,,111,,89,,22,818,,128,690,813,,121,-31,692,5,25,,11045
172929,3000,Male,GM0579,Oegstgeest,2015JJ00,2015,11045,,109,,102,,7,879,,126,753,770,,104,-11,666,109,116,,11161
172930,3000,Male,GM0579,Oegstgeest,2016JJ00,2016,11161,,107,,96,,11,994,,130,864,827,,99,-7,728,167,180,,11341
172931,3000,Male,GM0579,Oegstgeest,2017JJ00,2017,11341,,108,,98,,10,910,,149,761,765,,93,2,672,145,154,,11495
172932,3000,Male,GM0579,Oegstgeest,2018JJ00,2018,11495,,134,,103,,31,1012,,120,892,774,,92,2,682,238,270,,11765
172933,3000,Male,GM0579,Oegstgeest,2019JJ00,2019,11765,,119,,84,,35,998,,147,851,795,,89,8,706,203,237,,12002
172934,3000,Male,GM0579,Oegstgeest,2020JJ00,2020,12002,,119,,122,,-3,999,,122,877,902,,93,-8,809,97,93,,12095
172935,3000,Male,GM0579,Oegstgeest,2021JJ00,2021,12095,,128,,90,,38,1009,,127,882,836,,85,1,751,173,210,,12305
172936,3000,Male,GM0579,Oegstgeest,2022JJ00,2022,12305,,112,,106,,6,1091,,204,887,998,,127,-6,871,93,100,,12405
172937,3000,Male,GM0579,Oegstgeest,2023JJ00,2023,12405,,116,,102,,14,1154,,157,997,1011,,99,-10,912,143,158,,12563
173172,3000,Male,GM0823,Oirschot,2012JJ00,2012,9051,,73,,72,,1,236,,36,200,205,,18,3,187,31,32,,9083
173173,3000,Male,GM0823,Oirschot,2013JJ00,2013,9083,,74,,88,,-14,242,,32,210,233,,22,2,211,9,-4,,9079
173174,3000,Male,GM0823,Oirschot,2014JJ00,2014,9079,,70,,88,,-18,281,,45,236,263,,34,-9,229,18,-1,,9078
173175,3000,Male,GM0823,Oirschot,2015JJ00,2015,9078,,75,,69,,6,351,,37,314,292,,39,-6,253,59,65,,9143
173176,3000,Male,GM0823,Oirschot,2016JJ00,2016,9143,,84,,63,,21,576,,77,499,435,,21,-7,414,141,162,,9305
173177,3000,Male,GM0823,Oirschot,2017JJ00,2017,9305,,69,,82,,-13,401,,41,360,353,,28,0,325,48,36,,9341
173178,3000,Male,GM0823,Oirschot,2018JJ00,2018,9341,,78,,85,,-7,379,,51,328,343,,41,-3,302,36,29,,9370
173179,3000,Male,GM0823,Oirschot,2019JJ00,2019,9370,,77,,98,,-21,403,,70,333,331,,47,-5,284,72,51,,9421
173180,3000,Male,GM0823,Oirschot,2020JJ00,2020,9421,,92,,89,,3,465,,70,395,357,,39,-10,318,108,108,,9529
173181,3000,Male,GM0823,Oirschot,2021JJ00,2021,9529,,93,,99,,-6,434,,53,381,346,,37,0,309,88,80,,9609
173182,3000,Male,GM0823,Oirschot,2022JJ00,2022,9609,,92,,81,,11,485,,106,379,388,,40,-8,348,97,108,,9717
173183,3000,Male,GM0823,Oirschot,2023JJ00,2023,9717,,85,,91,,-6,597,,92,505,541,,98,-21,443,56,52,,9769
173254,3000,Male,GM0824,Oisterwijk,2012JJ00,2012,12698,,114,,113,,1,615,,128,487,625,,53,-14,572,-10,-8,,12690
173255,3000,Male,GM0824,Oisterwijk,2013JJ00,2013,12690,,109,,117,,-8,586,,124,462,574,,69,-36,505,12,4,,12694
173256,3000,Male,GM0824,Oisterwijk,2014JJ00,2014,12694,,100,,120,,-20,705,,206,499,694,,56,-12,638,11,-7,,12687
173257,3000,Male,GM0824,Oisterwijk,2015JJ00,2015,12687,,100,,146,,-46,876,,329,547,779,,63,-20,716,97,58,,12745
173258,3000,Male,GM0824,Oisterwijk,2016JJ00,2016,12745,,100,,135,,-35,970,,253,717,921,,60,-19,861,49,13,,12758
173259,3000,Male,GM0824,Oisterwijk,2017JJ00,2017,12758,,111,,132,,-21,987,,107,880,858,,61,-21,797,129,108,,12866
173260,3000,Male,GM0824,Oisterwijk,2018JJ00,2018,12866,,103,,146,,-43,876,,104,772,834,,94,-28,740,42,-3,,12863
173261,3000,Male,GM0824,Oisterwijk,2019JJ00,2019,12863,,102,,150,,-48,865,,108,757,780,,111,-57,669,85,38,,12901
173262,3000,Male,GM0824,Oisterwijk,2020JJ00,2020,12901,,98,,147,,-49,922,,89,833,701,,48,-16,653,221,172,,13073
173263,3000,Male,GM0824,Oisterwijk,2021JJ00,2021,16056,,198,,179,,19,1116,,119,997,1017,,97,-21,920,99,120,,16176
173264,3000,Male,GM0824,Oisterwijk,2022JJ00,2022,16176,,158,,184,,-26,1373,,286,1087,1135,,110,-5,1025,238,211,,16387
173265,3000,Male,GM0824,Oisterwijk,2023JJ00,2023,16387,,152,,196,,-44,1382,,231,1151,1368,,163,-31,1205,14,-31,,16356
173336,3000,Male,GM1895,Oldambt,2012JJ00,2012,19331,,155,,207,,-52,622,,63,559,769,,112,-43,657,-147,-203,,19128
173337,3000,Male,GM1895,Oldambt,2013JJ00,2013,19128,,153,,215,,-62,727,,68,659,746,,101,-30,645,-19,-81,,19047
173338,3000,Male,GM1895,Oldambt,2014JJ00,2014,19047,,160,,206,,-46,722,,96,626,673,,62,-7,611,49,2,,19049
173339,3000,Male,GM1895,Oldambt,2015JJ00,2015,19049,,143,,202,,-59,742,,74,668,778,,71,-13,707,-36,-96,,18953
173340,3000,Male,GM1895,Oldambt,2016JJ00,2016,18953,,168,,234,,-66,955,,148,807,927,,70,-7,857,28,-39,,18914
173341,3000,Male,GM1895,Oldambt,2017JJ00,2017,18914,,147,,236,,-89,827,,82,745,742,,48,3,694,85,-1,,18913
173342,3000,Male,GM1895,Oldambt,2018JJ00,2018,18913,,129,,248,,-119,882,,83,799,697,,44,12,653,185,67,,18980
173343,3000,Male,GM1895,Oldambt,2019JJ00,2019,18980,,152,,227,,-75,921,,75,846,774,,50,6,724,147,69,,19049
173344,3000,Male,GM1895,Oldambt,2020JJ00,2020,19049,,162,,241,,-79,934,,79,855,772,,38,-1,734,162,80,,19129
173345,3000,Male,GM1895,Oldambt,2021JJ00,2021,19129,,176,,282,,-106,1062,,97,965,772,,32,23,740,290,183,,19312
173346,3000,Male,GM1895,Oldambt,2022JJ00,2022,19312,,152,,260,,-108,1211,,204,1007,817,,99,-17,718,394,285,,19597
173347,3000,Male,GM1895,Oldambt,2023JJ00,2023,19597,,142,,296,,-154,1208,,183,1025,874,,97,-27,777,334,176,,19773
173418,3000,Male,GM0269,Oldebroek,2012JJ00,2012,11453,,124,,69,,55,369,,25,344,402,,27,-7,375,-33,22,,11475
173419,3000,Male,GM0269,Oldebroek,2013JJ00,2013,11475,,128,,84,,44,349,,26,323,373,,22,-5,351,-24,21,,11496
173420,3000,Male,GM0269,Oldebroek,2014JJ00,2014,11496,,138,,82,,56,443,,66,377,409,,25,0,384,34,89,,11585
173421,3000,Male,GM0269,Oldebroek,2015JJ00,2015,11585,,126,,78,,48,478,,71,407,441,,52,-21,389,37,85,,11670
173422,3000,Male,GM0269,Oldebroek,2016JJ00,2016,11670,,127,,90,,37,483,,72,411,454,,48,-23,406,29,66,,11736
173423,3000,Male,GM0269,Oldebroek,2017JJ00,2017,11736,,143,,103,,40,539,,72,467,496,,79,-15,417,43,85,,11821
173424,3000,Male,GM0269,Oldebroek,2018JJ00,2018,11821,,113,,100,,13,586,,100,486,557,,99,-8,458,29,43,,11864
173425,3000,Male,GM0269,Oldebroek,2019JJ00,2019,11864,,145,,79,,66,520,,76,444,523,,62,-9,461,-3,61,,11925
173426,3000,Male,GM0269,Oldebroek,2020JJ00,2020,11925,,136,,137,,-1,525,,53,472,496,,32,-3,464,29,26,,11951
173427,3000,Male,GM0269,Oldebroek,2021JJ00,2021,11951,,130,,104,,26,555,,52,503,500,,45,-6,455,55,82,,12033
173428,3000,Male,GM0269,Oldebroek,2022JJ00,2022,12033,,123,,110,,13,632,,197,435,506,,86,-23,420,126,140,,12173
173429,3000,Male,GM0269,Oldebroek,2023JJ00,2023,12173,,92,,100,,-8,524,,64,460,510,,52,-6,458,14,6,,12179
173746,3000,Male,GM0173,Oldenzaal,2012JJ00,2012,16074,,163,,159,,4,455,,60,395,457,,58,0,399,-2,2,,16076
173747,3000,Male,GM0173,Oldenzaal,2013JJ00,2013,16076,,147,,146,,1,446,,71,375,486,,58,-2,428,-40,-38,,16038
173748,3000,Male,GM0173,Oldenzaal,2014JJ00,2014,16038,,152,,129,,23,458,,50,408,531,,73,-2,458,-73,-50,,15988
173749,3000,Male,GM0173,Oldenzaal,2015JJ00,2015,15988,,152,,150,,2,453,,63,390,481,,89,-8,392,-28,-28,,15960
173750,3000,Male,GM0173,Oldenzaal,2016JJ00,2016,15960,,135,,148,,-13,477,,59,418,538,,79,-9,459,-61,-74,,15886
173751,3000,Male,GM0173,Oldenzaal,2017JJ00,2017,15886,,142,,172,,-30,512,,62,450,560,,72,-4,488,-48,-74,,15812
173752,3000,Male,GM0173,Oldenzaal,2018JJ00,2018,15812,,126,,134,,-8,501,,57,444,516,,61,-9,455,-15,-24,,15788
173753,3000,Male,GM0173,Oldenzaal,2019JJ00,2019,15788,,131,,174,,-43,573,,69,504,532,,52,-4,480,41,-2,,15786
173754,3000,Male,GM0173,Oldenzaal,2020JJ00,2020,15786,,111,,179,,-68,482,,58,424,509,,35,4,474,-27,-93,,15693
173755,3000,Male,GM0173,Oldenzaal,2021JJ00,2021,15693,,157,,194,,-37,522,,52,470,447,,57,-4,390,75,38,,15731
173756,3000,Male,GM0173,Oldenzaal,2022JJ00,2022,15731,,141,,184,,-43,589,,124,465,466,,71,-7,395,123,78,,15809
173757,3000,Male,GM0173,Oldenzaal,2023JJ00,2023,15809,,122,,200,,-78,532,,60,472,510,,57,-4,453,22,-52,,15757
173910,3000,Male,GM1773,Olst-Wijhe,2012JJ00,2012,8922,,78,,64,,14,328,,31,297,297,,19,-2,278,31,46,,8968
173911,3000,Male,GM1773,Olst-Wijhe,2013JJ00,2013,8968,,86,,77,,9,303,,29,274,294,,17,1,277,9,18,,8986
173912,3000,Male,GM1773,Olst-Wijhe,2014JJ00,2014,8986,,66,,82,,-16,324,,24,300,297,,21,-6,276,27,12,,8998
173913,3000,Male,GM1773,Olst-Wijhe,2015JJ00,2015,8998,,87,,86,,1,339,,28,311,308,,12,0,296,31,32,,9030
173914,3000,Male,GM1773,Olst-Wijhe,2016JJ00,2016,9030,,86,,90,,-4,404,,18,386,359,,20,2,339,45,41,,9071
173915,3000,Male,GM1773,Olst-Wijhe,2017JJ00,2017,9071,,85,,93,,-8,460,,35,425,408,,35,-5,373,52,43,,9114
173916,3000,Male,GM1773,Olst-Wijhe,2018JJ00,2018,9114,,80,,73,,7,416,,24,392,392,,29,-2,363,24,31,,9145
173917,3000,Male,GM1773,Olst-Wijhe,2019JJ00,2019,9145,,73,,83,,-10,488,,28,460,363,,30,1,333,125,115,,9260
173918,3000,Male,GM1773,Olst-Wijhe,2020JJ00,2020,9260,,92,,98,,-6,462,,28,434,380,,20,-4,360,82,76,,9336
173919,3000,Male,GM1773,Olst-Wijhe,2021JJ00,2021,9336,,80,,102,,-22,419,,28,391,348,,27,-3,321,71,49,,9385
173920,3000,Male,GM1773,Olst-Wijhe,2022JJ00,2022,9385,,89,,94,,-5,442,,50,392,331,,27,0,304,111,107,,9492
173921,3000,Male,GM1773,Olst-Wijhe,2023JJ00,2023,9492,,69,,110,,-41,437,,66,371,330,,37,-4,293,107,68,,9560
173992,3000,Male,GM0175,Ommen,2012JJ00,2012,8698,,97,,70,,27,365,,74,291,422,,38,-4,384,-57,-30,,8668
173993,3000,Male,GM0175,Ommen,2013JJ00,2013,8668,,96,,49,,47,350,,69,281,331,,24,5,307,19,66,,8734
173994,3000,Male,GM0175,Ommen,2014JJ00,2014,8734,,106,,78,,28,397,,89,308,417,,48,-6,369,-20,14,,8748
173995,3000,Male,GM0175,Ommen,2015JJ00,2015,8748,,87,,79,,8,892,,466,426,672,,57,-14,615,220,232,,8980
173996,3000,Male,GM0175,Ommen,2016JJ00,2016,8980,,90,,83,,7,527,,136,391,658,,59,-3,599,-131,-125,,8855
173997,3000,Male,GM0175,Ommen,2017JJ00,2017,8855,,86,,94,,-8,506,,80,426,469,,73,-21,396,37,29,,8884
173998,3000,Male,GM0175,Ommen,2018JJ00,2018,8884,,82,,82,,0,560,,90,470,443,,70,-21,373,117,118,,9002
173999,3000,Male,GM0175,Ommen,2019JJ00,2019,9002,,87,,60,,27,501,,105,396,406,,64,-14,342,95,120,,9122
174000,3000,Male,GM0175,Ommen,2020JJ00,2020,9122,,92,,90,,2,586,,158,428,440,,50,-15,390,146,148,,9270
174001,3000,Male,GM0175,Ommen,2021JJ00,2021,9270,,92,,91,,1,484,,77,407,395,,93,-37,302,89,89,,9359
174002,3000,Male,GM0175,Ommen,2022JJ00,2022,9359,,71,,105,,-34,660,,202,458,424,,72,-16,352,236,203,,9562
174003,3000,Male,GM0175,Ommen,2023JJ00,2023,9562,,73,,105,,-32,560,,125,435,464,,76,-17,388,96,64,,9626
174074,3000,Male,GM0881,Onderbanken,2012JJ00,2012,3951,,26,,35,,-9,186,,25,161,187,,27,-1,160,-1,-9,,3942
174075,3000,Male,GM0881,Onderbanken,2013JJ00,2013,3942,,25,,40,,-15,178,,30,148,179,,28,2,151,-1,-15,,3927
174076,3000,Male,GM0881,Onderbanken,2014JJ00,2014,3927,,33,,31,,2,193,,21,172,182,,17,2,165,11,11,,3938
174077,3000,Male,GM0881,Onderbanken,2015JJ00,2015,3938,,27,,46,,-19,204,,20,184,166,,11,3,155,38,19,,3957
174078,3000,Male,GM0881,Onderbanken,2016JJ00,2016,3957,,37,,32,,5,214,,17,197,222,,31,-3,191,-8,-3,,3954
174079,3000,Male,GM0881,Onderbanken,2017JJ00,2017,3954,,28,,44,,-16,252,,28,224,226,,25,-3,201,26,8,,3962
174080,3000,Male,GM0881,Onderbanken,2018JJ00,2018,3962,,25,,41,,-16,226,,18,208,270,,21,-10,249,-44,-57,,3905
174320,3000,Male,GM1586,Oost Gelre,2012JJ00,2012,15294,,133,,130,,3,507,,29,478,582,,29,-12,553,-75,-72,,15222
174321,3000,Male,GM1586,Oost Gelre,2013JJ00,2013,15222,,134,,137,,-3,485,,31,454,598,,52,-1,546,-113,-116,,15106
174322,3000,Male,GM1586,Oost Gelre,2014JJ00,2014,15106,,106,,152,,-46,496,,34,462,590,,51,-11,539,-94,-140,,14966
174323,3000,Male,GM1586,Oost Gelre,2015JJ00,2015,14966,,112,,151,,-39,524,,42,482,512,,23,1,489,12,-28,,14938
174324,3000,Male,GM1586,Oost Gelre,2016JJ00,2016,14938,,140,,152,,-12,587,,47,540,518,,34,-8,484,69,59,,14997
174325,3000,Male,GM1586,Oost Gelre,2017JJ00,2017,14997,,143,,146,,-3,571,,33,538,541,,29,-3,512,30,27,,15024
174326,3000,Male,GM1586,Oost Gelre,2018JJ00,2018,15024,,110,,121,,-11,596,,43,553,546,,28,1,518,50,41,,15065
174327,3000,Male,GM1586,Oost Gelre,2019JJ00,2019,15065,,116,,131,,-15,525,,35,490,563,,26,-3,537,-38,-52,,15013
174328,3000,Male,GM1586,Oost Gelre,2020JJ00,2020,15013,,146,,152,,-6,497,,26,471,533,,38,-14,495,-36,-40,,14973
174329,3000,Male,GM1586,Oost Gelre,2021JJ00,2021,14973,,136,,158,,-22,537,,45,492,512,,22,0,490,25,2,,14975
174330,3000,Male,GM1586,Oost Gelre,2022JJ00,2022,14975,,126,,159,,-33,595,,109,486,475,,48,-2,427,120,86,,15061
174331,3000,Male,GM1586,Oost Gelre,2023JJ00,2023,15061,,150,,157,,-7,572,,66,506,571,,39,-8,532,1,-5,,15056
174894,3000,Male,GM0826,Oosterhout,2012JJ00,2012,26608,,207,,228,,-21,866,,125,741,1000,,120,-12,880,-134,-151,,26457
174895,3000,Male,GM0826,Oosterhout,2013JJ00,2013,26457,,214,,224,,-10,1036,,132,904,1045,,155,-33,890,-9,-19,,26438
174896,3000,Male,GM0826,Oosterhout,2014JJ00,2014,26438,,253,,233,,20,1053,,127,926,1024,,156,-48,868,29,47,,26485
174897,3000,Male,GM0826,Oosterhout,2015JJ00,2015,26485,,243,,245,,-2,1186,,144,1042,1060,,142,-34,918,126,127,,26612
174898,3000,Male,GM0826,Oosterhout,2016JJ00,2016,26612,,234,,229,,5,1414,,156,1258,1159,,162,-54,997,255,260,,26872
174899,3000,Male,GM0826,Oosterhout,2017JJ00,2017,26872,,282,,257,,25,1484,,163,1321,1179,,126,-24,1053,305,330,,27202
174900,3000,Male,GM0826,Oosterhout,2018JJ00,2018,27202,,269,,270,,-1,1479,,214,1265,1240,,167,-51,1073,239,237,,27439
174901,3000,Male,GM0826,Oosterhout,2019JJ00,2019,27439,,249,,257,,-8,1376,,251,1125,1189,,166,-44,1023,187,178,,27617
174902,3000,Male,GM0826,Oosterhout,2020JJ00,2020,27617,,274,,308,,-34,1353,,206,1147,1210,,148,-39,1062,143,110,,27727
174903,3000,Male,GM0826,Oosterhout,2021JJ00,2021,27727,,269,,281,,-12,1310,,202,1108,1148,,134,-32,1014,162,148,,27875
174904,3000,Male,GM0826,Oosterhout,2022JJ00,2022,27875,,237,,303,,-66,1569,,329,1240,1130,,184,-32,946,439,372,,28247
174905,3000,Male,GM0826,Oosterhout,2023JJ00,2023,28247,,243,,285,,-42,1407,,185,1222,1173,,208,-60,965,234,190,,28437
175058,3000,Male,GM0580,Oostflakkee,2012JJ00,2012,5203,,35,,41,,-6,122,,17,105,158,,8,2,150,-36,-43,,5160
175304,3000,Male,GM0085,Ooststellingwerf,2012JJ00,2012,12940,,113,,140,,-27,449,,35,414,430,,33,-9,397,19,-7,,12933
175305,3000,Male,GM0085,Ooststellingwerf,2013JJ00,2013,12933,,119,,144,,-25,427,,26,401,475,,38,-6,437,-48,-74,,12859
175306,3000,Male,GM0085,Ooststellingwerf,2014JJ00,2014,12859,,119,,154,,-35,527,,28,499,550,,38,-7,512,-23,-60,,12799
175307,3000,Male,GM0085,Ooststellingwerf,2015JJ00,2015,12799,,102,,161,,-59,508,,33,475,482,,33,5,449,26,-33,,12766
175308,3000,Male,GM0085,Ooststellingwerf,2016JJ00,2016,12766,,121,,149,,-28,615,,40,575,576,,46,-3,530,39,11,,12777
175309,3000,Male,GM0085,Ooststellingwerf,2017JJ00,2017,12777,,108,,140,,-32,621,,43,578,623,,24,0,599,-2,-34,,12743
175310,3000,Male,GM0085,Ooststellingwerf,2018JJ00,2018,12743,,92,,125,,-33,624,,37,587,535,,36,-3,499,89,57,,12800
175311,3000,Male,GM0085,Ooststellingwerf,2019JJ00,2019,12800,,110,,126,,-16,548,,38,510,534,,31,-4,503,14,-4,,12796
175312,3000,Male,GM0085,Ooststellingwerf,2020JJ00,2020,12796,,86,,143,,-57,602,,38,564,572,,25,-1,547,30,-26,,12770
175313,3000,Male,GM0085,Ooststellingwerf,2021JJ00,2021,12770,,96,,161,,-65,649,,37,612,498,,28,-4,470,151,87,,12857
175314,3000,Male,GM0085,Ooststellingwerf,2022JJ00,2022,12857,,107,,168,,-61,632,,86,546,500,,57,-17,443,132,68,,12925
175315,3000,Male,GM0085,Ooststellingwerf,2023JJ00,2023,12925,,110,,164,,-54,598,,87,511,556,,61,-21,495,42,-11,,12914
175468,3000,Male,GM0431,Oostzaan,2012JJ00,2012,4449,,31,,33,,-2,148,,12,136,130,,3,7,127,18,16,,4465
175469,3000,Male,GM0431,Oostzaan,2013JJ00,2013,4465,,33,,27,,6,129,,14,115,133,,17,-4,116,-4,2,,4467
175470,3000,Male,GM0431,Oostzaan,2014JJ00,2014,4467,,34,,29,,5,168,,14,154,154,,18,-5,136,14,18,,4485
175471,3000,Male,GM0431,Oostzaan,2015JJ00,2015,4485,,36,,41,,-5,295,,14,281,140,,18,-6,122,155,150,,4635
175472,3000,Male,GM0431,Oostzaan,2016JJ00,2016,4635,,54,,23,,31,260,,13,247,194,,15,-5,179,66,97,,4732
175473,3000,Male,GM0431,Oostzaan,2017JJ00,2017,4732,,53,,33,,20,231,,17,214,194,,14,3,180,37,57,,4789
175474,3000,Male,GM0431,Oostzaan,2018JJ00,2018,4789,,45,,31,,14,213,,16,197,226,,13,0,213,-13,1,,4790
175475,3000,Male,GM0431,Oostzaan,2019JJ00,2019,4790,,43,,34,,9,210,,14,196,206,,9,1,197,4,13,,4803
175476,3000,Male,GM0431,Oostzaan,2020JJ00,2020,4803,,44,,46,,-2,193,,18,175,227,,10,3,217,-34,-36,,4767
175477,3000,Male,GM0431,Oostzaan,2021JJ00,2021,4767,,34,,43,,-9,187,,19,168,201,,21,-9,180,-14,-26,,4741
175478,3000,Male,GM0431,Oostzaan,2022JJ00,2022,4741,,48,,44,,4,223,,36,187,205,,21,-7,184,18,26,,4767
175479,3000,Male,GM0431,Oostzaan,2023JJ00,2023,4767,,35,,54,,-19,251,,56,195,231,,22,0,209,20,1,,4768
175878,3000,Male,GM0432,Opmeer,2012JJ00,2012,5771,,43,,44,,-1,155,,18,137,199,,10,5,189,-44,-45,,5726
175879,3000,Male,GM0432,Opmeer,2013JJ00,2013,5726,,56,,39,,17,184,,27,157,179,,17,-3,162,5,22,,5748
175880,3000,Male,GM0432,Opmeer,2014JJ00,2014,5748,,54,,55,,-1,165,,19,146,212,,23,-9,189,-47,-48,,5700
175881,3000,Male,GM0432,Opmeer,2015JJ00,2015,5700,,51,,60,,-9,240,,31,209,209,,16,-5,193,31,24,,5724
175882,3000,Male,GM0432,Opmeer,2016JJ00,2016,5724,,57,,40,,17,242,,20,222,191,,22,-6,169,51,68,,5792
175883,3000,Male,GM0432,Opmeer,2017JJ00,2017,5792,,59,,48,,11,287,,43,244,236,,22,-5,214,51,61,,5853
175884,3000,Male,GM0432,Opmeer,2018JJ00,2018,5853,,49,,40,,9,373,,108,265,246,,33,-9,213,127,132,,5985
175885,3000,Male,GM0432,Opmeer,2019JJ00,2019,5985,,42,,48,,-6,322,,103,219,288,,63,-23,225,34,28,,6013
175886,3000,Male,GM0432,Opmeer,2020JJ00,2020,6013,,55,,47,,8,368,,80,288,278,,65,-13,213,90,99,,6112
175887,3000,Male,GM0432,Opmeer,2021JJ00,2021,6112,,55,,53,,2,324,,59,265,314,,70,-26,244,10,13,,6125
175888,3000,Male,GM0432,Opmeer,2022JJ00,2022,6125,,77,,65,,12,383,,126,257,334,,86,-11,248,49,60,,6185
175889,3000,Male,GM0432,Opmeer,2023JJ00,2023,6185,,74,,54,,20,350,,114,236,359,,112,-5,247,-9,11,,6196
176042,3000,Male,GM0086,Opsterland,2012JJ00,2012,14945,,134,,121,,13,531,,31,500,553,,43,-16,510,-22,-10,,14935
176043,3000,Male,GM0086,Opsterland,2013JJ00,2013,14935,,130,,131,,-1,568,,44,524,591,,34,-13,557,-23,-22,,14913
176044,3000,Male,GM0086,Opsterland,2014JJ00,2014,14913,,137,,128,,9,605,,31,574,581,,22,-3,559,24,35,,14948
176045,3000,Male,GM0086,Opsterland,2015JJ00,2015,14948,,135,,131,,4,603,,34,569,642,,46,-10,596,-39,-36,,14912
176046,3000,Male,GM0086,Opsterland,2016JJ00,2016,14912,,132,,118,,14,685,,39,646,731,,50,-20,681,-46,-33,,14879
176047,3000,Male,GM0086,Opsterland,2017JJ00,2017,14879,,133,,119,,14,779,,40,739,719,,43,-12,676,60,72,,14951
176048,3000,Male,GM0086,Opsterland,2018JJ00,2018,14951,,139,,126,,13,717,,37,680,731,,37,-3,694,-14,-1,,14950
176049,3000,Male,GM0086,Opsterland,2019JJ00,2019,14950,,135,,132,,3,713,,42,671,741,,34,-4,707,-28,-25,,14925
176050,3000,Male,GM0086,Opsterland,2020JJ00,2020,14925,,131,,143,,-12,712,,33,679,669,,25,0,644,43,29,,14954
176051,3000,Male,GM0086,Opsterland,2021JJ00,2021,14954,,153,,149,,4,684,,37,647,676,,38,-8,638,8,13,,14967
176052,3000,Male,GM0086,Opsterland,2022JJ00,2022,14967,,150,,151,,-1,765,,117,648,639,,58,-12,581,126,125,,15092
176053,3000,Male,GM0086,Opsterland,2023JJ00,2023,15092,,138,,153,,-15,664,,48,616,648,,44,-10,604,16,0,,15092
176124,3000,Male,GM0828,Oss,2012JJ00,2012,42280,,406,,316,,90,1320,,297,1023,1308,,231,-22,1077,12,100,,42380
176125,3000,Male,GM0828,Oss,2013JJ00,2013,42380,,384,,332,,52,1340,,318,1022,1331,,286,-49,1045,9,56,,42436
176126,3000,Male,GM0828,Oss,2014JJ00,2014,42436,,432,,305,,127,1459,,326,1133,1423,,264,-56,1159,36,163,,42599
176127,3000,Male,GM0828,Oss,2015JJ00,2015,44935,,447,,364,,83,1548,,312,1236,1484,,275,-96,1209,64,144,,45079
176128,3000,Male,GM0828,Oss,2016JJ00,2016,45079,,436,,427,,9,1969,,595,1374,1703,,259,-48,1444,266,271,,45350
176129,3000,Male,GM0828,Oss,2017JJ00,2017,45350,,453,,353,,100,1822,,403,1419,1714,,267,-85,1447,108,214,,45564
176130,3000,Male,GM0828,Oss,2018JJ00,2018,45564,,456,,400,,56,1855,,468,1387,1582,,259,-86,1323,273,327,,45891
176131,3000,Male,GM0828,Oss,2019JJ00,2019,45891,,467,,398,,69,2032,,661,1371,1780,,310,-100,1470,252,322,,46213
176132,3000,Male,GM0828,Oss,2020JJ00,2020,46213,,427,,452,,-25,2127,,587,1540,1750,,293,-64,1457,377,351,,46564
176133,3000,Male,GM0828,Oss,2021JJ00,2021,46564,,435,,459,,-24,2263,,661,1602,1838,,402,-101,1436,425,405,,46969
176134,3000,Male,GM0828,Oss,2022JJ00,2022,46969,,431,,440,,-9,2352,,780,1572,1675,,344,-60,1331,677,662,,47631
176135,3000,Male,GM0828,Oss,2023JJ00,2023,47631,,425,,460,,-35,2186,,639,1547,2081,,524,-206,1557,105,72,,47703
176698,3000,Male,GM0584,Oud-Beijerland,2012JJ00,2012,11504,,124,,78,,46,367,,29,338,436,,42,-8,394,-69,-23,,11481
176699,3000,Male,GM0584,Oud-Beijerland,2013JJ00,2013,11481,,137,,93,,44,449,,39,410,381,,22,6,359,68,113,,11594
176700,3000,Male,GM0584,Oud-Beijerland,2014JJ00,2014,11594,,121,,84,,37,381,,23,358,420,,35,4,385,-39,-3,,11591
176701,3000,Male,GM0584,Oud-Beijerland,2015JJ00,2015,11591,,119,,82,,37,500,,34,466,443,,48,-13,395,57,95,,11686
176702,3000,Male,GM0584,Oud-Beijerland,2016JJ00,2016,11686,,111,,98,,13,542,,40,502,456,,28,0,428,86,98,,11784
176703,3000,Male,GM0584,Oud-Beijerland,2017JJ00,2017,11784,,128,,90,,38,571,,46,525,454,,20,1,434,117,155,,11939
176704,3000,Male,GM0584,Oud-Beijerland,2018JJ00,2018,11939,,108,,101,,7,476,,40,436,464,,28,-6,436,12,42,,11981
176862,3000,Male,GM1509,Oude IJsselstreek,2012JJ00,2012,19892,,165,,190,,-25,660,,52,608,632,,58,-2,574,28,6,,19898
176863,3000,Male,GM1509,Oude IJsselstreek,2013JJ00,2013,19898,,186,,214,,-28,610,,59,551,651,,68,-6,583,-41,-69,,19829
176864,3000,Male,GM1509,Oude IJsselstreek,2014JJ00,2014,19829,,185,,212,,-27,656,,72,584,606,,63,2,543,50,23,,19852
176865,3000,Male,GM1509,Oude IJsselstreek,2015JJ00,2015,19852,,144,,190,,-46,717,,64,653,661,,93,-28,568,56,11,,19863
176866,3000,Male,GM1509,Oude IJsselstreek,2016JJ00,2016,19863,,186,,214,,-28,712,,85,627,678,,63,-6,615,34,3,,19866
176867,3000,Male,GM1509,Oude IJsselstreek,2017JJ00,2017,19866,,166,,196,,-30,816,,82,734,782,,81,-10,701,34,0,,19866
176868,3000,Male,GM1509,Oude IJsselstreek,2018JJ00,2018,19866,,150,,239,,-89,819,,91,728,746,,78,-18,668,73,-15,,19851
176869,3000,Male,GM1509,Oude IJsselstreek,2019JJ00,2019,19851,,159,,207,,-48,761,,81,680,694,,60,-15,634,67,20,,19871
176870,3000,Male,GM1509,Oude IJsselstreek,2020JJ00,2020,19871,,165,,262,,-97,771,,81,690,692,,69,-8,623,79,-15,,19856
176871,3000,Male,GM1509,Oude IJsselstreek,2021JJ00,2021,19856,,150,,272,,-122,780,,55,725,643,,56,0,587,137,19,,19875
176872,3000,Male,GM1509,Oude IJsselstreek,2022JJ00,2022,19875,,160,,242,,-82,869,,148,721,681,,83,-20,598,188,108,,19983
176873,3000,Male,GM1509,Oude IJsselstreek,2023JJ00,2023,19983,,150,,245,,-95,819,,141,678,798,,101,-15,697,21,-76,,19907
177518,3000,Male,GM0437,Ouder-Amstel,2012JJ00,2012,6452,,55,,62,,-7,331,,41,290,322,,45,-6,277,9,2,,6454
177519,3000,Male,GM0437,Ouder-Amstel,2013JJ00,2013,6454,,68,,60,,8,335,,48,287,346,,50,-8,296,-11,-3,,6451
177520,3000,Male,GM0437,Ouder-Amstel,2014JJ00,2014,6451,,60,,71,,-11,391,,57,334,391,,52,-4,339,0,-14,,6437
177521,3000,Male,GM0437,Ouder-Amstel,2015JJ00,2015,6437,,60,,56,,4,478,,61,417,391,,75,-13,316,87,91,,6528
177522,3000,Male,GM0437,Ouder-Amstel,2016JJ00,2016,6528,,54,,54,,0,450,,49,401,423,,56,-9,367,27,26,,6554
177523,3000,Male,GM0437,Ouder-Amstel,2017JJ00,2017,6554,,56,,40,,16,465,,62,403,425,,55,-5,370,40,56,,6610
177524,3000,Male,GM0437,Ouder-Amstel,2018JJ00,2018,6610,,64,,57,,7,612,,71,541,424,,64,-6,360,188,192,,6802
177525,3000,Male,GM0437,Ouder-Amstel,2019JJ00,2019,6802,,67,,46,,21,485,,66,419,452,,73,-1,379,33,54,,6856
177526,3000,Male,GM0437,Ouder-Amstel,2020JJ00,2020,6856,,59,,50,,9,550,,83,467,506,,46,-4,460,44,54,,6910
177527,3000,Male,GM0437,Ouder-Amstel,2021JJ00,2021,6910,,89,,51,,38,562,,59,503,553,,69,-5,484,9,46,,6956
177528,3000,Male,GM0437,Ouder-Amstel,2022JJ00,2022,6956,,68,,85,,-17,507,,118,389,482,,73,-2,409,25,11,,6967
177529,3000,Male,GM0437,Ouder-Amstel,2023JJ00,2023,6967,,60,,60,,0,681,,153,528,586,,75,-9,511,95,95,,7062
177600,3000,Male,GM0644,Ouderkerk,2012JJ00,2012,3975,,50,,20,,30,190,,11,179,163,,13,-1,150,27,56,,4031
177601,3000,Male,GM0644,Ouderkerk,2013JJ00,2013,4031,,45,,21,,24,138,,4,134,132,,8,-2,124,6,30,,4061
177602,3000,Male,GM0644,Ouderkerk,2014JJ00,2014,4061,,41,,32,,9,164,,10,154,148,,9,2,139,16,22,,4083
177846,3000,Male,GM0589,Oudewater,2012JJ00,2012,4851,,44,,46,,-2,149,,12,137,146,,28,-10,118,3,3,,4854
177847,3000,Male,GM0589,Oudewater,2013JJ00,2013,4854,,44,,44,,0,122,,14,108,119,,12,-6,107,3,3,,4857
177848,3000,Male,GM0589,Oudewater,2014JJ00,2014,4857,,48,,35,,13,157,,21,136,153,,20,-3,133,4,17,,4874
177849,3000,Male,GM0589,Oudewater,2015JJ00,2015,4874,,44,,51,,-7,231,,30,201,166,,22,-2,144,65,57,,4931
177850,3000,Male,GM0589,Oudewater,2016JJ00,2016,4931,,61,,48,,13,225,,27,198,179,,16,-3,163,46,58,,4989
177851,3000,Male,GM0589,Oudewater,2017JJ00,2017,4989,,53,,41,,12,206,,35,171,206,,35,-13,171,0,12,,5001
177852,3000,Male,GM0589,Oudewater,2018JJ00,2018,5001,,57,,46,,11,215,,39,176,210,,28,-2,182,5,17,,5018
177853,3000,Male,GM0589,Oudewater,2019JJ00,2019,5018,,68,,36,,32,162,,31,131,166,,22,-7,144,-4,28,,5046
177854,3000,Male,GM0589,Oudewater,2020JJ00,2020,5046,,37,,36,,1,154,,24,130,188,,17,-7,171,-34,-34,,5012
177855,3000,Male,GM0589,Oudewater,2021JJ00,2021,5012,,47,,37,,10,182,,22,160,173,,18,-7,155,9,19,,5031
177856,3000,Male,GM0589,Oudewater,2022JJ00,2022,5031,,49,,48,,1,211,,53,158,169,,16,2,153,42,44,,5075
177857,3000,Male,GM0589,Oudewater,2023JJ00,2023,5075,,55,,61,,-6,207,,48,159,197,,25,-3,172,10,5,,5080
178256,3000,Male,GM1734,Overbetuwe,2012JJ00,2012,22994,,267,,152,,115,954,,68,886,981,,81,-7,900,-27,90,,23084
178257,3000,Male,GM1734,Overbetuwe,2013JJ00,2013,23084,,238,,145,,93,921,,65,856,925,,85,-18,840,-4,95,,23179
178258,3000,Male,GM1734,Overbetuwe,2014JJ00,2014,23179,,271,,148,,123,991,,62,929,990,,87,-11,903,1,123,,23302
178259,3000,Male,GM1734,Overbetuwe,2015JJ00,2015,23302,,232,,149,,83,1064,,68,996,1101,,83,5,1018,-37,48,,23350
178260,3000,Male,GM1734,Overbetuwe,2016JJ00,2016,23350,,245,,162,,83,1210,,65,1145,1086,,59,6,1027,124,211,,23561
178261,3000,Male,GM1734,Overbetuwe,2017JJ00,2017,23561,,265,,173,,92,1186,,90,1096,1267,,79,-10,1188,-81,13,,23574
178262,3000,Male,GM1734,Overbetuwe,2018JJ00,2018,23574,,232,,180,,52,1141,,107,1034,1133,,90,-19,1043,8,64,,23638
178263,3000,Male,GM1734,Overbetuwe,2019JJ00,2019,23638,,217,,194,,23,1296,,150,1146,1128,,88,-10,1040,168,191,,23829
178264,3000,Male,GM1734,Overbetuwe,2020JJ00,2020,23829,,247,,200,,47,1248,,88,1160,1183,,74,8,1109,65,111,,23940
178265,3000,Male,GM1734,Overbetuwe,2021JJ00,2021,23940,,225,,200,,25,1081,,72,1009,1120,,67,-4,1053,-39,-15,,23925
178266,3000,Male,GM1734,Overbetuwe,2022JJ00,2022,23925,,234,,188,,46,1298,,178,1120,1089,,116,-9,973,209,253,,24178
178267,3000,Male,GM1734,Overbetuwe,2023JJ00,2023,24178,,212,,194,,18,1129,,105,1024,1064,,109,-15,955,65,85,,24263
178666,3000,Male,GM0590,Papendrecht,2012JJ00,2012,15748,,182,,135,,47,575,,60,515,615,,76,-19,539,-40,5,,15753
178667,3000,Male,GM0590,Papendrecht,2013JJ00,2013,15753,,165,,99,,66,485,,46,439,517,,61,-5,456,-32,39,,15792
178668,3000,Male,GM0590,Papendrecht,2014JJ00,2014,15792,,191,,114,,77,526,,58,468,547,,60,-14,487,-21,56,,15848
178669,3000,Male,GM0590,Papendrecht,2015JJ00,2015,15848,,161,,129,,32,576,,65,511,580,,44,6,536,-4,29,,15877
178670,3000,Male,GM0590,Papendrecht,2016JJ00,2016,15877,,155,,115,,40,618,,53,565,665,,82,-32,583,-47,-6,,15871
178671,3000,Male,GM0590,Papendrecht,2017JJ00,2017,15871,,139,,143,,-4,709,,45,664,716,,55,-19,661,-7,-11,,15860
178672,3000,Male,GM0590,Papendrecht,2018JJ00,2018,15860,,138,,145,,-7,717,,82,635,672,,66,-28,606,45,38,,15898
178673,3000,Male,GM0590,Papendrecht,2019JJ00,2019,15898,,141,,132,,9,640,,76,564,746,,67,-13,679,-106,-99,,15799
178674,3000,Male,GM0590,Papendrecht,2020JJ00,2020,15799,,138,,175,,-37,782,,62,720,744,,64,-13,680,38,2,,15801
178675,3000,Male,GM0590,Papendrecht,2021JJ00,2021,15801,,182,,143,,39,762,,61,701,763,,53,-11,710,-1,36,,15837
178676,3000,Male,GM0590,Papendrecht,2022JJ00,2022,15837,,121,,161,,-40,744,,94,650,663,,77,0,586,81,40,,15877
178677,3000,Male,GM0590,Papendrecht,2023JJ00,2023,15877,,153,,156,,-3,708,,79,629,726,,64,-13,662,-18,-19,,15858
178748,3000,Male,GM1894,Peel en Maas,2012JJ00,2012,21970,,191,,166,,25,520,,122,398,538,,83,-2,455,-18,8,,21978
178749,3000,Male,GM1894,Peel en Maas,2013JJ00,2013,21978,,159,,167,,-8,531,,146,385,551,,96,-16,455,-20,-26,,21952
178750,3000,Male,GM1894,Peel en Maas,2014JJ00,2014,21952,,178,,173,,5,744,,244,500,628,,106,-9,522,116,118,,22070
178751,3000,Male,GM1894,Peel en Maas,2015JJ00,2015,22070,,174,,176,,-2,723,,258,465,800,,210,-19,590,-77,-82,,21988
178752,3000,Male,GM1894,Peel en Maas,2016JJ00,2016,21988,,207,,183,,24,677,,164,513,692,,186,-40,506,-15,11,,21999
178753,3000,Male,GM1894,Peel en Maas,2017JJ00,2017,21999,,167,,193,,-26,734,,156,578,718,,129,-21,589,16,-11,,21988
178754,3000,Male,GM1894,Peel en Maas,2018JJ00,2018,21988,,187,,174,,13,695,,160,535,699,,157,-39,542,-4,9,,21997
178755,3000,Male,GM1894,Peel en Maas,2019JJ00,2019,21997,,171,,214,,-43,815,,239,576,707,,138,-6,569,108,64,,22061
178756,3000,Male,GM1894,Peel en Maas,2020JJ00,2020,22061,,196,,268,,-72,1043,,401,642,834,,314,-26,520,209,136,,22197
178757,3000,Male,GM1894,Peel en Maas,2021JJ00,2021,22197,,222,,204,,18,1172,,497,675,798,,249,-45,549,374,393,,22590
178758,3000,Male,GM1894,Peel en Maas,2022JJ00,2022,22590,,198,,214,,-16,1375,,762,613,888,,354,-126,534,487,470,,23060
178759,3000,Male,GM1894,Peel en Maas,2023JJ00,2023,23060,,210,,231,,-21,1231,,614,617,1103,,407,-134,696,128,109,,23169
178912,3000,Male,GM0765,Pekela,2012JJ00,2012,6452,,64,,79,,-15,331,,67,264,336,,18,-3,318,-5,-19,,6433
178913,3000,Male,GM0765,Pekela,2013JJ00,2013,6433,,55,,68,,-13,398,,175,223,430,,21,-6,409,-32,-43,,6390
178914,3000,Male,GM0765,Pekela,2014JJ00,2014,6390,,68,,63,,5,512,,237,275,497,,23,-4,474,15,22,,6412
178915,3000,Male,GM0765,Pekela,2015JJ00,2015,6412,,60,,65,,-5,559,,235,324,588,,30,-18,558,-29,-32,,6380
178916,3000,Male,GM0765,Pekela,2016JJ00,2016,6380,,72,,63,,9,586,,177,409,633,,11,7,622,-47,-39,,6341
178917,3000,Male,GM0765,Pekela,2017JJ00,2017,6341,,62,,60,,2,405,,50,355,571,,104,-92,467,-166,-167,,6174
178918,3000,Male,GM0765,Pekela,2018JJ00,2018,6174,,59,,51,,8,281,,13,268,293,,7,1,286,-12,-4,,6170
178919,3000,Male,GM0765,Pekela,2019JJ00,2019,6170,,50,,72,,-22,325,,23,302,329,,20,-2,309,-4,-26,,6144
178920,3000,Male,GM0765,Pekela,2020JJ00,2020,6144,,55,,55,,0,333,,24,309,326,,26,-7,300,7,7,,6151
178921,3000,Male,GM0765,Pekela,2021JJ00,2021,6151,,54,,91,,-37,372,,12,360,331,,17,-3,314,41,5,,6156
178922,3000,Male,GM0765,Pekela,2022JJ00,2022,6156,,54,,87,,-33,472,,156,316,362,,29,-16,333,110,76,,6232
178923,3000,Male,GM0765,Pekela,2023JJ00,2023,6232,,54,,69,,-15,425,,151,274,365,,61,-20,304,60,44,,6276
179322,3000,Male,GM1926,Pijnacker-Nootdorp,2012JJ00,2012,25023,,310,,131,,179,1064,,115,949,1117,,122,-2,995,-53,126,,25149
179323,3000,Male,GM1926,Pijnacker-Nootdorp,2013JJ00,2013,25149,,256,,129,,127,1249,,103,1146,1077,,154,-16,923,172,301,,25450
179324,3000,Male,GM1926,Pijnacker-Nootdorp,2014JJ00,2014,25450,,271,,153,,118,1148,,87,1061,1235,,151,-27,1084,-87,34,,25484
179325,3000,Male,GM1926,Pijnacker-Nootdorp,2015JJ00,2015,25484,,266,,126,,140,1452,,126,1326,1248,,120,1,1128,204,344,,25828
179326,3000,Male,GM1926,Pijnacker-Nootdorp,2016JJ00,2016,25828,,279,,159,,120,1536,,141,1395,1265,,121,-19,1144,271,387,,26215
179327,3000,Male,GM1926,Pijnacker-Nootdorp,2017JJ00,2017,26215,,285,,141,,144,1679,,136,1543,1316,,97,3,1219,363,508,,26723
179328,3000,Male,GM1926,Pijnacker-Nootdorp,2018JJ00,2018,26723,,260,,157,,103,1496,,145,1351,1306,,144,-10,1162,190,294,,27017
179329,3000,Male,GM1926,Pijnacker-Nootdorp,2019JJ00,2019,27017,,283,,156,,127,1652,,177,1475,1275,,126,1,1149,377,503,,27520
179330,3000,Male,GM1926,Pijnacker-Nootdorp,2020JJ00,2020,27520,,266,,147,,119,1458,,120,1338,1393,,120,-22,1273,65,184,,27704
179331,3000,Male,GM1926,Pijnacker-Nootdorp,2021JJ00,2021,27704,,317,,174,,143,1694,,148,1546,1406,,133,-1,1273,288,434,,28138
179332,3000,Male,GM1926,Pijnacker-Nootdorp,2022JJ00,2022,28138,,262,,161,,101,1783,,264,1519,1349,,161,-7,1188,434,536,,28674
179333,3000,Male,GM1926,Pijnacker-Nootdorp,2023JJ00,2023,28674,,283,,172,,111,1427,,199,1228,1399,,182,-17,1217,28,140,,28814
179896,3000,Male,GM0439,Purmerend,2012JJ00,2012,38731,,377,,332,,45,1376,,187,1189,1268,,199,-42,1069,108,155,,38886
179897,3000,Male,GM0439,Purmerend,2013JJ00,2013,38886,,350,,317,,33,1293,,199,1094,1338,,204,-31,1134,-45,-8,,38878
179898,3000,Male,GM0439,Purmerend,2014JJ00,2014,38878,,356,,319,,37,1372,,159,1213,1409,,218,-38,1191,-37,1,,38879
179899,3000,Male,GM0439,Purmerend,2015JJ00,2015,38879,,365,,314,,51,1509,,193,1316,1460,,239,-81,1221,49,101,,38980
179900,3000,Male,GM0439,Purmerend,2016JJ00,2016,38980,,371,,337,,34,1548,,214,1334,1585,,204,-53,1381,-37,-7,,38973
179901,3000,Male,GM0439,Purmerend,2017JJ00,2017,38973,,367,,368,,-1,1625,,242,1383,1611,,189,-46,1422,14,13,,38986
179902,3000,Male,GM0439,Purmerend,2018JJ00,2018,38986,,357,,367,,-10,1700,,266,1434,1612,,215,-36,1397,88,79,,39065
179903,3000,Male,GM0439,Purmerend,2019JJ00,2019,39065,,358,,392,,-34,2132,,286,1846,1524,,168,-15,1356,608,577,,39642
179904,3000,Male,GM0439,Purmerend,2020JJ00,2020,39642,,371,,375,,-4,1854,,227,1627,1680,,189,-54,1491,174,175,,39817
179905,3000,Male,GM0439,Purmerend,2021JJ00,2021,39817,,374,,443,,-69,1901,,219,1682,1825,,179,-34,1646,76,13,,39830
179906,3000,Male,GM0439,Purmerend,2022JJ00,2022,45167,,448,,430,,18,2612,,549,2063,1738,,269,-31,1469,874,891,,46058
179907,3000,Male,GM0439,Purmerend,2023JJ00,2023,46058,,425,,406,,19,2400,,466,1934,1814,,334,-89,1480,586,603,,46661
180060,3000,Male,GM0273,Putten,2012JJ00,2012,11833,,130,,93,,37,398,,75,323,369,,49,-3,320,29,68,,11901
180061,3000,Male,GM0273,Putten,2013JJ00,2013,11901,,130,,88,,42,393,,69,324,483,,69,-3,414,-90,-49,,11852
180062,3000,Male,GM0273,Putten,2014JJ00,2014,11852,,125,,72,,53,714,,290,424,483,,96,2,387,231,282,,12134
180063,3000,Male,GM0273,Putten,2015JJ00,2015,12134,,120,,112,,8,595,,160,435,578,,101,-36,477,17,15,,12149
180064,3000,Male,GM0273,Putten,2016JJ00,2016,12149,,157,,110,,47,501,,100,401,569,,144,-69,425,-68,-20,,12129
180065,3000,Male,GM0273,Putten,2017JJ00,2017,12129,,111,,112,,-1,476,,85,391,563,,109,-34,454,-87,-88,,12041
180066,3000,Male,GM0273,Putten,2018JJ00,2018,12041,,123,,103,,20,413,,71,342,483,,73,-25,410,-70,-49,,11992
180067,3000,Male,GM0273,Putten,2019JJ00,2019,11992,,120,,102,,18,432,,90,342,504,,73,-8,431,-72,-51,,11941
180068,3000,Male,GM0273,Putten,2020JJ00,2020,11941,,132,,109,,23,575,,68,507,452,,52,-9,400,123,147,,12088
180069,3000,Male,GM0273,Putten,2021JJ00,2021,12088,,125,,128,,-3,510,,65,445,387,,58,-16,329,123,118,,12206
180070,3000,Male,GM0273,Putten,2022JJ00,2022,12206,,136,,138,,-2,545,,125,420,378,,60,-17,318,167,166,,12372
180071,3000,Male,GM0273,Putten,2023JJ00,2023,12372,,134,,109,,25,473,,87,386,469,,93,-21,376,4,29,,12401
180224,3000,Male,GM0177,Raalte,2012JJ00,2012,18328,,184,,159,,25,447,,49,398,491,,53,-13,438,-44,-20,,18308
180225,3000,Male,GM0177,Raalte,2013JJ00,2013,18308,,172,,161,,11,498,,34,464,472,,62,-13,410,26,37,,18345
180226,3000,Male,GM0177,Raalte,2014JJ00,2014,18345,,180,,159,,21,502,,58,444,505,,43,-7,462,-3,18,,18363
180227,3000,Male,GM0177,Raalte,2015JJ00,2015,18363,,161,,129,,32,561,,44,517,530,,40,2,490,31,63,,18426
180228,3000,Male,GM0177,Raalte,2016JJ00,2016,18426,,176,,153,,23,614,,38,576,514,,36,-2,478,100,123,,18549
180229,3000,Male,GM0177,Raalte,2017JJ00,2017,18549,,179,,177,,2,656,,37,619,566,,56,-9,510,90,89,,18638
180230,3000,Male,GM0177,Raalte,2018JJ00,2018,18638,,176,,192,,-16,746,,71,675,518,,41,-1,477,228,215,,18853
180231,3000,Male,GM0177,Raalte,2019JJ00,2019,18853,,160,,176,,-16,617,,69,548,526,,37,-11,489,91,74,,18927
180232,3000,Male,GM0177,Raalte,2020JJ00,2020,18927,,189,,198,,-9,667,,63,604,565,,28,-3,537,102,94,,19021
180233,3000,Male,GM0177,Raalte,2021JJ00,2021,19021,,193,,220,,-27,644,,52,592,519,,40,-3,479,125,98,,19119
180234,3000,Male,GM0177,Raalte,2022JJ00,2022,19119,,168,,190,,-22,673,,132,541,468,,43,-3,425,205,186,,19305
180235,3000,Male,GM0177,Raalte,2023JJ00,2023,19305,,156,,181,,-25,557,,77,480,583,,69,-6,514,-26,-52,,19253
180798,3000,Male,GM0703,Reimerswaal,2012JJ00,2012,10902,,173,,81,,92,365,,110,255,387,,65,-27,322,-22,74,,10976
180799,3000,Male,GM0703,Reimerswaal,2013JJ00,2013,10976,,139,,83,,56,374,,144,230,394,,82,-30,312,-20,36,,11012
180800,3000,Male,GM0703,Reimerswaal,2014JJ00,2014,11012,,155,,80,,75,382,,126,256,409,,74,-7,335,-27,46,,11058
180801,3000,Male,GM0703,Reimerswaal,2015JJ00,2015,11058,,186,,85,,101,411,,105,306,378,,59,3,319,33,134,,11192
180802,3000,Male,GM0703,Reimerswaal,2016JJ00,2016,11192,,166,,87,,79,483,,140,343,498,,117,-41,381,-15,65,,11257
180803,3000,Male,GM0703,Reimerswaal,2017JJ00,2017,11257,,159,,78,,81,508,,170,338,507,,95,-15,412,1,78,,11335
180804,3000,Male,GM0703,Reimerswaal,2018JJ00,2018,11335,,164,,99,,65,549,,224,325,546,,132,-24,414,3,69,,11404
180805,3000,Male,GM0703,Reimerswaal,2019JJ00,2019,11404,,156,,80,,76,509,,147,362,552,,179,-21,373,-43,34,,11438
180806,3000,Male,GM0703,Reimerswaal,2020JJ00,2020,11438,,163,,87,,76,564,,166,398,503,,102,-18,401,61,137,,11575
180807,3000,Male,GM0703,Reimerswaal,2021JJ00,2021,11575,,137,,106,,31,500,,151,349,519,,119,-10,400,-19,13,,11588
180808,3000,Male,GM0703,Reimerswaal,2022JJ00,2022,11588,,146,,92,,54,592,,225,367,522,,126,-14,396,70,122,,11710
180809,3000,Male,GM0703,Reimerswaal,2023JJ00,2023,11710,,146,,85,,61,535,,150,385,534,,130,-25,404,1,62,,11772
180962,3000,Male,GM0274,Renkum,2012JJ00,2012,15273,,106,,171,,-65,949,,62,887,864,,68,-4,796,85,18,,15291
180963,3000,Male,GM0274,Renkum,2013JJ00,2013,15291,,131,,179,,-48,957,,77,880,901,,66,-2,835,56,8,,15299
180964,3000,Male,GM0274,Renkum,2014JJ00,2014,15299,,125,,165,,-40,1025,,73,952,1054,,100,-9,954,-29,-69,,15230
180965,3000,Male,GM0274,Renkum,2015JJ00,2015,15230,,119,,193,,-74,1043,,96,947,1015,,44,17,971,28,-46,,15184
180966,3000,Male,GM0274,Renkum,2016JJ00,2016,15184,,123,,171,,-48,1155,,73,1082,971,,54,10,917,184,134,,15318
180967,3000,Male,GM0274,Renkum,2017JJ00,2017,15318,,112,,172,,-60,1137,,90,1047,1075,,54,9,1021,62,5,,15323
180968,3000,Male,GM0274,Renkum,2018JJ00,2018,15323,,120,,184,,-64,1014,,83,931,983,,61,1,922,31,-30,,15293
180969,3000,Male,GM0274,Renkum,2019JJ00,2019,15293,,100,,174,,-74,1055,,88,967,916,,59,8,857,139,65,,15358
180970,3000,Male,GM0274,Renkum,2020JJ00,2020,15358,,108,,218,,-110,1055,,88,967,947,,64,-4,883,108,-2,,15356
180971,3000,Male,GM0274,Renkum,2021JJ00,2021,15356,,80,,201,,-121,983,,73,910,876,,42,0,834,107,-18,,15338
180972,3000,Male,GM0274,Renkum,2022JJ00,2022,15338,,100,,228,,-128,1038,,164,874,853,,69,-2,784,185,58,,15396
180973,3000,Male,GM0274,Renkum,2023JJ00,2023,15396,,95,,197,,-102,1072,,112,960,966,,67,-5,899,106,6,,15402
181044,3000,Male,GM0339,Renswoude,2012JJ00,2012,2395,,35,,14,,21,115,,10,105,87,,2,-1,85,28,49,,2444
181045,3000,Male,GM0339,Renswoude,2013JJ00,2013,2444,,36,,5,,31,83,,7,76,99,,8,-3,91,-16,15,,2459
181046,3000,Male,GM0339,Renswoude,2014JJ00,2014,2459,,45,,10,,35,91,,12,79,111,,10,-2,101,-20,16,,2475
181047,3000,Male,GM0339,Renswoude,2015JJ00,2015,2475,,31,,15,,16,132,,21,111,108,,9,0,99,24,41,,2516
181048,3000,Male,GM0339,Renswoude,2016JJ00,2016,2516,,45,,16,,29,132,,14,118,137,,8,-4,129,-5,24,,2540
181049,3000,Male,GM0339,Renswoude,2017JJ00,2017,2540,,35,,15,,20,186,,22,164,155,,12,-7,143,31,51,,2591
181050,3000,Male,GM0339,Renswoude,2018JJ00,2018,2591,,46,,14,,32,146,,11,135,144,,9,-3,135,2,34,,2625
181051,3000,Male,GM0339,Renswoude,2019JJ00,2019,2625,,39,,18,,21,241,,20,221,165,,18,-5,147,76,97,,2722
181052,3000,Male,GM0339,Renswoude,2020JJ00,2020,2722,,47,,12,,35,183,,21,162,158,,8,-2,150,25,61,,2783
181053,3000,Male,GM0339,Renswoude,2021JJ00,2021,2783,,50,,7,,43,177,,18,159,167,,15,-4,152,10,53,,2836
181054,3000,Male,GM0339,Renswoude,2022JJ00,2022,2836,,44,,10,,34,268,,174,94,243,,40,-25,203,25,59,,2895
181055,3000,Male,GM0339,Renswoude,2023JJ00,2023,2895,,42,,21,,21,154,,30,124,167,,39,-21,128,-13,6,,2901
181290,3000,Male,GM1667,Reusel-De Mierden,2012JJ00,2012,6461,,82,,55,,27,170,,36,134,192,,45,-9,147,-22,4,,6465
181291,3000,Male,GM1667,Reusel-De Mierden,2013JJ00,2013,6465,,77,,49,,28,224,,61,163,207,,28,-4,179,17,45,,6510
181292,3000,Male,GM1667,Reusel-De Mierden,2014JJ00,2014,6510,,59,,44,,15,219,,70,149,204,,38,-12,166,15,29,,6539
181293,3000,Male,GM1667,Reusel-De Mierden,2015JJ00,2015,6539,,74,,39,,35,223,,42,181,222,,53,-3,169,1,38,,6577
181294,3000,Male,GM1667,Reusel-De Mierden,2016JJ00,2016,6577,,63,,46,,17,256,,48,208,216,,36,-3,180,40,58,,6635
181295,3000,Male,GM1667,Reusel-De Mierden,2017JJ00,2017,6635,,70,,44,,26,305,,65,240,258,,35,-4,223,47,73,,6708
181296,3000,Male,GM1667,Reusel-De Mierden,2018JJ00,2018,6708,,67,,59,,8,271,,61,210,272,,39,-1,233,-1,6,,6714
181297,3000,Male,GM1667,Reusel-De Mierden,2019JJ00,2019,6714,,69,,40,,29,251,,61,190,265,,44,-4,221,-14,15,,6729
181298,3000,Male,GM1667,Reusel-De Mierden,2020JJ00,2020,6729,,63,,60,,3,269,,47,222,289,,50,-4,239,-20,-17,,6712
181299,3000,Male,GM1667,Reusel-De Mierden,2021JJ00,2021,6712,,75,,57,,18,289,,45,244,224,,35,-3,189,65,83,,6795
181300,3000,Male,GM1667,Reusel-De Mierden,2022JJ00,2022,6795,,69,,51,,18,334,,78,256,207,,43,-18,164,127,144,,6939
181301,3000,Male,GM1667,Reusel-De Mierden,2023JJ00,2023,6939,,78,,65,,13,265,,56,209,223,,51,-4,172,42,54,,6993
181372,3000,Male,GM0275,Rheden,2012JJ00,2012,21216,,187,,255,,-68,1293,,125,1168,1137,,156,-64,981,156,86,,21302
181373,3000,Male,GM0275,Rheden,2013JJ00,2013,21302,,169,,254,,-85,1338,,104,1234,1246,,70,-6,1176,92,4,,21306
181374,3000,Male,GM0275,Rheden,2014JJ00,2014,21306,,177,,238,,-61,1396,,131,1265,1301,,133,-39,1168,95,35,,21341
181375,3000,Male,GM0275,Rheden,2015JJ00,2015,21341,,176,,260,,-84,1628,,374,1254,1426,,73,21,1353,202,120,,21461
181376,3000,Male,GM0275,Rheden,2016JJ00,2016,21461,,163,,275,,-112,1654,,255,1399,1661,,143,-20,1518,-7,-120,,21341
181377,3000,Male,GM0275,Rheden,2017JJ00,2017,21341,,189,,274,,-85,1565,,192,1373,1543,,139,-55,1404,22,-67,,21274
181378,3000,Male,GM0275,Rheden,2018JJ00,2018,21274,,171,,284,,-113,1521,,167,1354,1356,,176,-65,1180,165,51,,21325
181379,3000,Male,GM0275,Rheden,2019JJ00,2019,21325,,164,,268,,-104,1562,,315,1247,1324,,158,-31,1166,238,138,,21463
181380,3000,Male,GM0275,Rheden,2020JJ00,2020,21463,,188,,301,,-113,1421,,171,1250,1485,,217,-111,1268,-64,-177,,21286
181381,3000,Male,GM0275,Rheden,2021JJ00,2021,21286,,155,,279,,-124,1421,,191,1230,1337,,149,-64,1188,84,-40,,21246
181382,3000,Male,GM0275,Rheden,2022JJ00,2022,21246,,158,,279,,-121,1571,,234,1337,1387,,155,-26,1232,184,63,,21309
181383,3000,Male,GM0275,Rheden,2023JJ00,2023,21309,,165,,332,,-167,1707,,314,1393,1448,,167,-66,1281,259,89,,21398
181454,3000,Male,GM0340,Rhenen,2012JJ00,2012,9439,,100,,69,,31,392,,28,364,424,,25,-1,399,-32,-9,,9430
181455,3000,Male,GM0340,Rhenen,2013JJ00,2013,9430,,112,,67,,45,390,,15,375,394,,32,-1,362,-4,41,,9471
181456,3000,Male,GM0340,Rhenen,2014JJ00,2014,9471,,93,,85,,8,487,,23,464,464,,31,-3,433,23,32,,9503
181457,3000,Male,GM0340,Rhenen,2015JJ00,2015,9503,,99,,72,,27,507,,47,460,474,,33,-11,441,33,57,,9560
181458,3000,Male,GM0340,Rhenen,2016JJ00,2016,9560,,88,,79,,9,605,,38,567,523,,35,-7,488,82,93,,9653
181459,3000,Male,GM0340,Rhenen,2017JJ00,2017,9653,,115,,88,,27,620,,47,573,501,,32,-5,469,119,144,,9797
181460,3000,Male,GM0340,Rhenen,2018JJ00,2018,9797,,116,,88,,28,629,,69,560,510,,37,-12,473,119,147,,9944
181461,3000,Male,GM0340,Rhenen,2019JJ00,2019,9944,,121,,68,,53,599,,62,537,563,,30,-2,533,36,90,,10034
181462,3000,Male,GM0340,Rhenen,2020JJ00,2020,10034,,109,,98,,11,576,,70,506,565,,42,-5,523,11,20,,10054
181463,3000,Male,GM0340,Rhenen,2021JJ00,2021,10054,,125,,119,,6,540,,39,501,509,,30,1,479,31,37,,10091
181464,3000,Male,GM0340,Rhenen,2022JJ00,2022,10091,,105,,97,,8,509,,96,413,511,,44,-19,467,-2,6,,10097
181465,3000,Male,GM0340,Rhenen,2023JJ00,2023,10097,,76,,105,,-29,538,,55,483,558,,42,-6,516,-20,-50,,10047
181618,3000,Male,GM0597,Ridderkerk,2012JJ00,2012,21866,,243,,236,,7,716,,59,657,693,,84,-16,609,23,28,,21894
181619,3000,Male,GM0597,Ridderkerk,2013JJ00,2013,21894,,214,,214,,0,700,,77,623,726,,71,1,655,-26,-25,,21869
181620,3000,Male,GM0597,Ridderkerk,2014JJ00,2014,21869,,212,,211,,1,712,,70,642,755,,59,-1,696,-43,-43,,21826
181621,3000,Male,GM0597,Ridderkerk,2015JJ00,2015,21826,,204,,222,,-18,826,,77,749,830,,89,-24,741,-4,-25,,21801
181622,3000,Male,GM0597,Ridderkerk,2016JJ00,2016,21801,,210,,201,,9,1039,,66,973,844,,87,-17,757,195,202,,22003
181623,3000,Male,GM0597,Ridderkerk,2017JJ00,2017,22003,,215,,249,,-34,1108,,106,1002,891,,80,-21,811,217,184,,22187
181624,3000,Male,GM0597,Ridderkerk,2018JJ00,2018,22187,,250,,246,,4,1210,,102,1108,992,,75,-8,917,218,225,,22412
181625,3000,Male,GM0597,Ridderkerk,2019JJ00,2019,22412,,209,,261,,-52,925,,89,836,941,,93,-29,848,-16,-72,,22340
181626,3000,Male,GM0597,Ridderkerk,2020JJ00,2020,22340,,239,,320,,-81,1255,,78,1177,950,,71,-13,879,305,227,,22567
181627,3000,Male,GM0597,Ridderkerk,2021JJ00,2021,22567,,256,,282,,-26,1229,,108,1121,1008,,70,-19,938,221,192,,22759
181628,3000,Male,GM0597,Ridderkerk,2022JJ00,2022,22759,,250,,268,,-18,1224,,150,1074,1025,,92,-6,933,199,181,,22940
181629,3000,Male,GM0597,Ridderkerk,2023JJ00,2023,22940,,201,,258,,-57,1197,,105,1092,983,,83,-10,900,214,156,,23096
182192,3000,Male,GM0196,Rijnwaarden,2012JJ00,2012,5461,,43,,50,,-7,195,,32,163,192,,15,-3,177,3,-4,,5457
182193,3000,Male,GM0196,Rijnwaarden,2013JJ00,2013,5457,,49,,56,,-7,194,,25,169,219,,31,-2,188,-25,-32,,5425
182194,3000,Male,GM0196,Rijnwaarden,2014JJ00,2014,5425,,51,,58,,-7,205,,25,180,199,,10,7,189,6,1,,5426
182195,3000,Male,GM0196,Rijnwaarden,2015JJ00,2015,5426,,51,,59,,-8,187,,20,167,209,,25,-7,184,-22,-27,,5399
182196,3000,Male,GM0196,Rijnwaarden,2016JJ00,2016,5399,,44,,43,,1,199,,25,174,210,,30,1,180,-11,-11,,5388
182197,3000,Male,GM0196,Rijnwaarden,2017JJ00,2017,5388,,42,,52,,-10,236,,23,213,252,,21,-4,231,-16,-35,,5353
182274,3000,Male,GM1672,Rijnwoude,2012JJ00,2012,9368,,92,,44,,48,259,,29,230,338,,30,-7,308,-79,-30,,9338
182275,3000,Male,GM1672,Rijnwoude,2013JJ00,2013,9338,,90,,52,,38,235,,31,204,331,,28,-5,303,-96,-60,,9278
182602,3000,Male,GM1742,Rijssen-Holten,2012JJ00,2012,18665,,266,,147,,119,342,,36,306,432,,34,-2,398,-90,29,,18694
182603,3000,Male,GM1742,Rijssen-Holten,2013JJ00,2013,18694,,246,,154,,92,343,,39,304,405,,48,-11,357,-62,30,,18724
182604,3000,Male,GM1742,Rijssen-Holten,2014JJ00,2014,18724,,264,,116,,148,407,,51,356,416,,43,-11,373,-9,135,,18859
182605,3000,Male,GM1742,Rijssen-Holten,2015JJ00,2015,18859,,226,,143,,83,418,,50,368,454,,53,-1,401,-36,46,,18905
182606,3000,Male,GM1742,Rijssen-Holten,2016JJ00,2016,18905,,250,,140,,110,457,,38,419,529,,51,-3,478,-72,36,,18941
182607,3000,Male,GM1742,Rijssen-Holten,2017JJ00,2017,18941,,221,,147,,74,489,,32,457,515,,42,-1,473,-26,45,,18986
182608,3000,Male,GM1742,Rijssen-Holten,2018JJ00,2018,18986,,222,,144,,78,514,,44,470,494,,39,-1,455,20,98,,19084
182609,3000,Male,GM1742,Rijssen-Holten,2019JJ00,2019,19084,,214,,158,,56,447,,59,388,534,,45,1,489,-87,-32,,19052
182610,3000,Male,GM1742,Rijssen-Holten,2020JJ00,2020,19052,,232,,197,,35,481,,76,405,505,,45,-8,460,-24,11,,19063
182611,3000,Male,GM1742,Rijssen-Holten,2021JJ00,2021,19063,,199,,171,,28,458,,50,408,474,,42,-4,432,-16,10,,19073
182612,3000,Male,GM1742,Rijssen-Holten,2022JJ00,2022,19073,,218,,154,,64,564,,154,410,474,,77,-16,397,90,155,,19228
182613,3000,Male,GM1742,Rijssen-Holten,2023JJ00,2023,19228,,213,,153,,60,558,,84,474,492,,66,-1,426,66,126,,19354
182766,3000,Male,GM0603,Rijswijk (ZH.),2012JJ00,2012,22178,,258,,283,,-25,1765,,250,1515,1520,,315,-95,1205,245,218,,22396
182767,3000,Male,GM0603,Rijswijk (ZH.),2013JJ00,2013,22396,,295,,257,,38,1636,,237,1399,1518,,268,-50,1250,118,157,,22553
182768,3000,Male,GM0603,Rijswijk (ZH.),2014JJ00,2014,22553,,282,,282,,0,1906,,295,1611,1647,,317,-96,1330,259,259,,22812
182769,3000,Male,GM0603,Rijswijk (ZH.),2015JJ00,2015,22812,,291,,251,,40,2272,,328,1944,1730,,283,-50,1447,542,581,,23393
182770,3000,Male,GM0603,Rijswijk (ZH.),2016JJ00,2016,23393,,340,,275,,65,2702,,422,2280,1839,,235,-32,1604,863,931,,24324
182771,3000,Male,GM0603,Rijswijk (ZH.),2017JJ00,2017,24324,,321,,251,,70,2809,,397,2412,2227,,267,-60,1960,582,649,,24973
182772,3000,Male,GM0603,Rijswijk (ZH.),2018JJ00,2018,24973,,378,,273,,105,2663,,413,2250,2108,,266,-66,1842,555,659,,25632
182773,3000,Male,GM0603,Rijswijk (ZH.),2019JJ00,2019,25632,,340,,256,,84,2884,,474,2410,2429,,337,-106,2092,455,535,,26167
182774,3000,Male,GM0603,Rijswijk (ZH.),2020JJ00,2020,26167,,339,,301,,38,2699,,344,2355,2319,,244,-37,2075,380,417,,26584
182775,3000,Male,GM0603,Rijswijk (ZH.),2021JJ00,2021,26584,,384,,331,,53,3328,,446,2882,2495,,332,-75,2163,833,880,,27464
182776,3000,Male,GM0603,Rijswijk (ZH.),2022JJ00,2022,27464,,330,,289,,41,2875,,639,2236,2453,,293,-48,2160,422,457,,27921
182777,3000,Male,GM0603,Rijswijk (ZH.),2023JJ00,2023,27921,,379,,263,,116,2894,,493,2401,2109,,275,-58,1834,785,898,,28819
183176,3000,Male,GM1669,Roerdalen,2012JJ00,2012,10564,,84,,100,,-16,365,,53,312,411,,57,-5,354,-46,-63,,10501
183177,3000,Male,GM1669,Roerdalen,2013JJ00,2013,10501,,82,,101,,-19,385,,73,312,448,,84,-25,364,-63,-81,,10420
183178,3000,Male,GM1669,Roerdalen,2014JJ00,2014,10420,,66,,98,,-32,400,,51,349,450,,62,-20,388,-50,-80,,10340
183179,3000,Male,GM1669,Roerdalen,2015JJ00,2015,10340,,60,,108,,-48,494,,61,433,431,,60,-21,371,63,14,,10354
183180,3000,Male,GM1669,Roerdalen,2016JJ00,2016,10354,,83,,126,,-43,491,,78,413,448,,64,-8,384,43,-2,,10352
183181,3000,Male,GM1669,Roerdalen,2017JJ00,2017,10352,,75,,110,,-35,509,,83,426,465,,61,-8,404,44,9,,10361
183182,3000,Male,GM1669,Roerdalen,2018JJ00,2018,10361,,72,,119,,-47,508,,68,440,522,,61,-1,461,-14,-61,,10300
183183,3000,Male,GM1669,Roerdalen,2019JJ00,2019,10300,,70,,101,,-31,535,,95,440,496,,67,-15,429,39,10,,10310
183184,3000,Male,GM1669,Roerdalen,2020JJ00,2020,10310,,77,,111,,-34,573,,77,496,517,,63,-16,454,56,19,,10329
183185,3000,Male,GM1669,Roerdalen,2021JJ00,2021,10329,,88,,137,,-49,466,,54,412,436,,55,-1,381,30,-19,,10310
183186,3000,Male,GM1669,Roerdalen,2022JJ00,2022,10310,,84,,118,,-34,501,,75,426,395,,82,-14,313,106,72,,10382
183187,3000,Male,GM1669,Roerdalen,2023JJ00,2023,10382,,72,,128,,-56,522,,93,429,424,,71,-25,353,98,43,,10425
183258,3000,Male,GM0957,Roermond,2012JJ00,2012,27743,,257,,258,,-1,1452,,263,1189,1173,,165,39,1008,279,276,,28019
183259,3000,Male,GM0957,Roermond,2013JJ00,2013,28019,,279,,278,,1,1354,,222,1132,1245,,246,-42,999,109,109,,28128
183260,3000,Male,GM0957,Roermond,2014JJ00,2014,28128,,244,,249,,-5,1374,,247,1127,1334,,246,-3,1088,40,32,,28160
183261,3000,Male,GM0957,Roermond,2015JJ00,2015,28160,,292,,310,,-18,1419,,267,1152,1431,,309,-42,1122,-12,-27,,28133
183262,3000,Male,GM0957,Roermond,2016JJ00,2016,28133,,281,,271,,10,1534,,274,1260,1338,,239,-25,1099,196,205,,28338
183263,3000,Male,GM0957,Roermond,2017JJ00,2017,28338,,286,,265,,21,1596,,307,1289,1429,,235,-30,1194,167,182,,28520
183264,3000,Male,GM0957,Roermond,2018JJ00,2018,28520,,257,,254,,3,1672,,356,1316,1455,,223,-43,1232,217,220,,28740
183265,3000,Male,GM0957,Roermond,2019JJ00,2019,28740,,249,,284,,-35,1627,,382,1245,1506,,292,-72,1214,121,81,,28821
183266,3000,Male,GM0957,Roermond,2020JJ00,2020,28821,,264,,306,,-42,1773,,396,1377,1451,,259,-47,1192,322,279,,29100
183267,3000,Male,GM0957,Roermond,2021JJ00,2021,29100,,300,,363,,-63,1674,,356,1318,1413,,235,-49,1178,261,197,,29297
183268,3000,Male,GM0957,Roermond,2022JJ00,2022,29297,,283,,311,,-28,1937,,591,1346,1465,,287,-52,1178,472,445,,29742
183269,3000,Male,GM0957,Roermond,2023JJ00,2023,29742,,278,,330,,-52,2001,,509,1492,1543,,319,-65,1224,458,401,,30143
183586,3000,Male,GM0736,De Ronde Venen,2012JJ00,2012,21355,,165,,162,,3,666,,108,558,722,,86,6,636,-56,-53,,21302
183587,3000,Male,GM0736,De Ronde Venen,2013JJ00,2013,21302,,172,,180,,-8,599,,110,489,737,,88,5,649,-138,-145,,21157
183588,3000,Male,GM0736,De Ronde Venen,2014JJ00,2014,21157,,184,,163,,21,729,,111,618,776,,100,-15,676,-47,-28,,21129
183589,3000,Male,GM0736,De Ronde Venen,2015JJ00,2015,21129,,155,,169,,-14,826,,121,705,904,,130,-10,774,-78,-90,,21039
183590,3000,Male,GM0736,De Ronde Venen,2016JJ00,2016,21039,,195,,168,,27,947,,99,848,872,,110,-17,762,75,105,,21144
183591,3000,Male,GM0736,De Ronde Venen,2017JJ00,2017,21144,,193,,155,,38,1286,,130,1156,872,,102,-8,770,414,454,,21598
183592,3000,Male,GM0736,De Ronde Venen,2018JJ00,2018,21598,,182,,196,,-14,1138,,153,985,900,,118,-3,782,238,225,,21823
183593,3000,Male,GM0736,De Ronde Venen,2019JJ00,2019,21823,,200,,189,,11,1063,,160,903,871,,101,-11,770,192,205,,22028
183594,3000,Male,GM0736,De Ronde Venen,2020JJ00,2020,22028,,202,,181,,21,1026,,123,903,936,,96,-12,840,90,112,,22140
183595,3000,Male,GM0736,De Ronde Venen,2021JJ00,2021,22140,,228,,211,,17,1092,,114,978,999,,118,-16,881,93,111,,22251
183596,3000,Male,GM0736,De Ronde Venen,2022JJ00,2022,22251,,205,,202,,3,1206,,211,995,945,,131,-15,814,261,264,,22515
183597,3000,Male,GM0736,De Ronde Venen,2023JJ00,2023,22515,,206,,201,,5,1101,,179,922,937,,117,-9,820,164,168,,22683
183668,3000,Male,GM1674,Roosendaal,2012JJ00,2012,38246,,414,,380,,34,1156,,319,837,1349,,350,-114,999,-193,-160,,38086
183669,3000,Male,GM1674,Roosendaal,2013JJ00,2013,38086,,393,,368,,25,1302,,308,994,1380,,309,-33,1071,-78,-50,,38036
183670,3000,Male,GM1674,Roosendaal,2014JJ00,2014,38036,,389,,360,,29,1380,,336,1044,1474,,320,-80,1154,-94,-71,,37965
183671,3000,Male,GM1674,Roosendaal,2015JJ00,2015,37965,,359,,357,,2,1526,,393,1133,1458,,342,-90,1116,68,68,,38033
183672,3000,Male,GM1674,Roosendaal,2016JJ00,2016,38033,,416,,359,,57,1643,,391,1252,1583,,363,-123,1220,60,114,,38147
183673,3000,Male,GM1674,Roosendaal,2017JJ00,2017,38147,,354,,389,,-35,1677,,428,1249,1683,,364,-104,1319,-6,-42,,38105
183674,3000,Male,GM1674,Roosendaal,2018JJ00,2018,38105,,357,,367,,-10,1757,,510,1247,1648,,368,-130,1280,109,95,,38200
183675,3000,Male,GM1674,Roosendaal,2019JJ00,2019,38200,,368,,401,,-33,1933,,626,1307,1693,,397,-123,1296,240,209,,38409
183676,3000,Male,GM1674,Roosendaal,2020JJ00,2020,38409,,351,,407,,-56,1786,,504,1282,1701,,360,-98,1341,85,27,,38436
183677,3000,Male,GM1674,Roosendaal,2021JJ00,2021,38436,,382,,435,,-53,1789,,519,1270,1655,,437,-161,1218,134,80,,38516
183678,3000,Male,GM1674,Roosendaal,2022JJ00,2022,38516,,334,,418,,-84,1951,,716,1235,1685,,418,-101,1267,266,182,,38698
183679,3000,Male,GM1674,Roosendaal,2023JJ00,2023,38698,,328,,407,,-79,1844,,582,1262,1674,,321,-73,1353,170,92,,38790
184078,3000,Male,GM0599,Rotterdam,2012JJ00,2012,303769,,4181,,2623,,1558,16687,,5623,11064,18753,,7465,-3730,11288,-2066,-512,,303257
184079,3000,Male,GM0599,Rotterdam,2013JJ00,2013,303257,,4054,,2619,,1435,16601,,5371,11230,16975,,6093,-2194,10882,-374,1096,,304353
184080,3000,Male,GM0599,Rotterdam,2014JJ00,2014,304353,,4169,,2453,,1716,17471,,5482,11989,16556,,5311,-1285,11245,915,2648,,307001
184081,3000,Male,GM0599,Rotterdam,2015JJ00,2015,307001,,4098,,2617,,1481,18662,,5816,12846,16993,,5005,-903,11988,1669,3199,,310200
184082,3000,Male,GM0599,Rotterdam,2016JJ00,2016,310200,,4127,,2700,,1427,19730,,6059,13671,18573,,5195,-1124,13378,1157,2581,,312781
184083,3000,Male,GM0599,Rotterdam,2017JJ00,2017,312781,,3964,,2610,,1354,20240,,6765,13475,19582,,5512,-1586,14070,658,1985,,314766
184084,3000,Male,GM0599,Rotterdam,2018JJ00,2018,314766,,4066,,2783,,1283,20311,,7077,13234,18444,,4505,-522,13939,1867,3169,,317935
184085,3000,Male,GM0599,Rotterdam,2019JJ00,2019,317935,,3860,,2704,,1156,22159,,8366,13793,19897,,5047,-690,14850,2262,3409,,321344
184086,3000,Male,GM0599,Rotterdam,2020JJ00,2020,321339,,3973,,3195,,778,21310,,7180,14130,21374,,4942,-747,16432,-64,701,,322040
184087,3000,Male,GM0599,Rotterdam,2021JJ00,2021,322040,,3924,,2964,,960,22980,,8130,14850,21675,,4471,-557,17204,1305,2269,,324309
184088,3000,Male,GM0599,Rotterdam,2022JJ00,2022,324309,,3735,,3034,,701,25095,,10678,14417,21550,,5091,-728,16459,3545,4313,,328622
184089,3000,Male,GM0599,Rotterdam,2023JJ00,2023,328622,,3561,,2927,,634,25568,,9712,15856,22581,,5889,-1226,16692,2987,3645,,332267
184242,3000,Male,GM0277,Rozendaal,2012JJ00,2012,749,,6,,7,,-1,47,,8,39,48,,6,-1,42,-1,-2,,747
184243,3000,Male,GM0277,Rozendaal,2013JJ00,2013,747,,2,,8,,-6,48,,5,43,49,,0,0,49,-1,-7,,740
184244,3000,Male,GM0277,Rozendaal,2014JJ00,2014,740,,2,,3,,-1,46,,1,45,41,,2,0,39,5,4,,744
184245,3000,Male,GM0277,Rozendaal,2015JJ00,2015,744,,2,,9,,-7,38,,4,34,38,,4,1,34,0,-7,,737
184246,3000,Male,GM0277,Rozendaal,2016JJ00,2016,737,,2,,8,,-6,45,,1,44,33,,3,1,30,12,6,,743
184247,3000,Male,GM0277,Rozendaal,2017JJ00,2017,743,,5,,10,,-5,111,,5,106,72,,6,0,66,39,35,,778
184248,3000,Male,GM0277,Rozendaal,2018JJ00,2018,778,,7,,10,,-3,82,,8,74,42,,5,0,37,40,37,,815
184249,3000,Male,GM0277,Rozendaal,2019JJ00,2019,815,,6,,2,,4,70,,8,62,54,,4,0,50,16,20,,835
184250,3000,Male,GM0277,Rozendaal,2020JJ00,2020,835,,7,,9,,-2,60,,5,55,44,,2,0,42,16,14,,849
184251,3000,Male,GM0277,Rozendaal,2021JJ00,2021,849,,7,,3,,4,67,,6,61,45,,1,0,44,22,26,,875
184252,3000,Male,GM0277,Rozendaal,2022JJ00,2022,875,,4,,8,,-4,60,,11,49,65,,2,0,63,-5,-9,,866
184253,3000,Male,GM0277,Rozendaal,2023JJ00,2023,866,,5,,6,,-1,97,,36,61,56,,7,-2,49,41,40,,906
184324,3000,Male,GM0840,Rucphen,2012JJ00,2012,11169,,91,,112,,-21,289,,49,240,306,,49,-6,257,-17,-38,,11131
184325,3000,Male,GM0840,Rucphen,2013JJ00,2013,11131,,104,,106,,-2,353,,67,286,357,,58,-20,299,-4,-6,,11125
184326,3000,Male,GM0840,Rucphen,2014JJ00,2014,11125,,81,,126,,-45,430,,73,357,347,,68,-7,279,83,37,,11162
184327,3000,Male,GM0840,Rucphen,2015JJ00,2015,11162,,83,,129,,-46,484,,101,383,396,,84,-4,312,88,42,,11204
184328,3000,Male,GM0840,Rucphen,2016JJ00,2016,11204,,89,,134,,-45,543,,93,450,434,,84,1,350,109,66,,11270
184329,3000,Male,GM0840,Rucphen,2017JJ00,2017,11270,,98,,138,,-40,549,,118,431,519,,106,-9,413,30,-8,,11262
184330,3000,Male,GM0840,Rucphen,2018JJ00,2018,11262,,92,,122,,-30,643,,124,519,494,,107,-17,387,149,118,,11380
184331,3000,Male,GM0840,Rucphen,2019JJ00,2019,11380,,83,,128,,-45,718,,187,531,522,,152,-14,370,196,151,,11531
184332,3000,Male,GM0840,Rucphen,2020JJ00,2020,11531,,99,,135,,-36,715,,155,560,547,,140,-14,407,168,135,,11666
184333,3000,Male,GM0840,Rucphen,2021JJ00,2021,11666,,124,,134,,-10,658,,152,506,535,,143,-22,392,123,111,,11777
184334,3000,Male,GM0840,Rucphen,2022JJ00,2022,11777,,105,,166,,-61,638,,169,469,436,,114,-8,322,202,140,,11917
184335,3000,Male,GM0840,Rucphen,2023JJ00,2023,11917,,100,,146,,-46,713,,111,602,512,,104,-4,408,201,155,,12072
185144,3000,Male,GM0441,Schagen,2012JJ00,2012,9105,,87,,83,,4,317,,18,299,371,,37,-8,334,-54,-45,,9060
185145,3000,Male,GM0441,Schagen,2013JJ00,2013,23127,,179,,210,,-31,732,,152,580,783,,127,-25,656,-51,-93,,23034
185146,3000,Male,GM0441,Schagen,2014JJ00,2014,23034,,197,,175,,22,905,,171,734,810,,128,-18,682,95,120,,23154
185147,3000,Male,GM0441,Schagen,2015JJ00,2015,23154,,163,,201,,-38,860,,134,726,895,,161,-27,734,-35,-68,,23086
185148,3000,Male,GM0441,Schagen,2016JJ00,2016,23086,,206,,214,,-8,1042,,237,805,1011,,126,-15,885,31,22,,23108
185149,3000,Male,GM0441,Schagen,2017JJ00,2017,23108,,190,,193,,-3,1004,,145,859,904,,106,-20,798,100,96,,23204
185150,3000,Male,GM0441,Schagen,2018JJ00,2018,23204,,165,,229,,-64,1065,,125,940,915,,107,-8,808,150,87,,23291
185151,3000,Male,GM0441,Schagen,2019JJ00,2019,23291,,184,,241,,-57,959,,180,779,954,,120,-11,834,5,-50,,23241
185152,3000,Male,GM0441,Schagen,2020JJ00,2020,23241,,179,,243,,-64,889,,107,782,836,,100,-31,736,53,-11,,23230
185153,3000,Male,GM0441,Schagen,2021JJ00,2021,23230,,176,,273,,-97,1097,,136,961,859,,102,-16,757,238,140,,23370
185154,3000,Male,GM0441,Schagen,2022JJ00,2022,23370,,178,,256,,-78,1199,,293,906,919,,187,-47,732,280,203,,23573
185155,3000,Male,GM0441,Schagen,2023JJ00,2023,23573,,197,,266,,-69,1141,,188,953,874,,143,-24,731,267,202,,23775
185718,3000,Male,GM0458,Schermer,2012JJ00,2012,2774,,33,,15,,18,157,,40,117,148,,18,1,130,9,29,,2803
185719,3000,Male,GM0458,Schermer,2013JJ00,2013,2803,,32,,14,,18,129,,35,94,124,,24,-1,100,5,23,,2826
185720,3000,Male,GM0458,Schermer,2014JJ00,2014,2826,,22,,19,,3,139,,37,102,200,,59,-11,141,-61,-58,,2768
185964,3000,Male,GM0279,Scherpenzeel,2012JJ00,2012,4638,,67,,31,,36,128,,27,101,160,,5,1,155,-32,4,,4642
185965,3000,Male,GM0279,Scherpenzeel,2013JJ00,2013,4642,,63,,35,,28,175,,22,153,161,,18,-7,143,14,43,,4685
185966,3000,Male,GM0279,Scherpenzeel,2014JJ00,2014,4685,,60,,33,,27,168,,22,146,183,,16,-2,167,-15,12,,4697
185967,3000,Male,GM0279,Scherpenzeel,2015JJ00,2015,4697,,46,,39,,7,192,,38,154,192,,14,-4,178,0,8,,4705
185968,3000,Male,GM0279,Scherpenzeel,2016JJ00,2016,4705,,72,,32,,40,294,,40,254,229,,16,0,213,65,105,,4810
185969,3000,Male,GM0279,Scherpenzeel,2017JJ00,2017,4810,,54,,35,,19,267,,23,244,254,,17,-1,237,13,31,,4841
185970,3000,Male,GM0279,Scherpenzeel,2018JJ00,2018,4841,,80,,42,,38,212,,22,190,201,,20,-8,181,11,49,,4890
185971,3000,Male,GM0279,Scherpenzeel,2019JJ00,2019,4890,,45,,42,,3,235,,26,209,232,,25,-2,207,3,7,,4897
185972,3000,Male,GM0279,Scherpenzeel,2020JJ00,2020,4897,,74,,32,,42,316,,21,295,211,,26,-11,185,105,147,,5044
185973,3000,Male,GM0279,Scherpenzeel,2021JJ00,2021,5044,,67,,51,,16,282,,21,261,223,,13,-5,210,59,76,,5120
185974,3000,Male,GM0279,Scherpenzeel,2022JJ00,2022,5120,,59,,47,,12,243,,70,173,221,,35,-7,186,22,35,,5155
185975,3000,Male,GM0279,Scherpenzeel,2023JJ00,2023,5155,,56,,39,,17,176,,25,151,237,,18,-1,219,-61,-43,,5112
186046,3000,Male,GM0606,Schiedam,2012JJ00,2012,37492,,439,,383,,56,2468,,676,1792,2563,,731,-388,1832,-95,-46,,37446
186047,3000,Male,GM0606,Schiedam,2013JJ00,2013,37446,,429,,336,,93,2433,,674,1759,2362,,619,-199,1743,71,162,,37608
186048,3000,Male,GM0606,Schiedam,2014JJ00,2014,37608,,468,,297,,171,2585,,710,1875,2502,,714,-300,1788,83,256,,37864
186049,3000,Male,GM0606,Schiedam,2015JJ00,2015,37864,,463,,335,,128,2614,,716,1898,2582,,715,-267,1867,32,162,,38026
186050,3000,Male,GM0606,Schiedam,2016JJ00,2016,38026,,465,,327,,138,2870,,760,2110,2575,,582,-201,1993,295,434,,38460
186051,3000,Male,GM0606,Schiedam,2017JJ00,2017,38460,,452,,333,,119,2893,,747,2146,2869,,728,-339,2141,24,146,,38606
186052,3000,Male,GM0606,Schiedam,2018JJ00,2018,38606,,439,,371,,68,2791,,818,1973,2794,,537,-166,2257,-3,69,,38675
186053,3000,Male,GM0606,Schiedam,2019JJ00,2019,38675,,431,,379,,52,3406,,1138,2268,2890,,592,-127,2298,516,569,,39244
186054,3000,Male,GM0606,Schiedam,2020JJ00,2020,39244,,441,,423,,18,3227,,836,2391,2989,,532,-73,2457,238,252,,39496
186055,3000,Male,GM0606,Schiedam,2021JJ00,2021,39496,,485,,413,,72,3300,,908,2392,3209,,681,-254,2528,91,161,,39657
186056,3000,Male,GM0606,Schiedam,2022JJ00,2022,39657,,449,,342,,107,3333,,1045,2288,2971,,653,-195,2318,362,463,,40120
186057,3000,Male,GM0606,Schiedam,2023JJ00,2023,40120,,493,,340,,153,3538,,1030,2508,2910,,522,-89,2388,628,778,,40898
186128,3000,Male,GM0088,Schiermonnikoog,2012JJ00,2012,464,,6,,5,,1,36,,3,33,16,,-2,3,18,20,20,,484
186129,3000,Male,GM0088,Schiermonnikoog,2013JJ00,2013,484,,4,,8,,-4,32,,2,30,39,,3,0,36,-7,-10,,474
186130,3000,Male,GM0088,Schiermonnikoog,2014JJ00,2014,474,,3,,7,,-4,38,,3,35,36,,3,0,33,2,-2,,472
186131,3000,Male,GM0088,Schiermonnikoog,2015JJ00,2015,472,,4,,2,,2,30,,1,29,36,,2,0,34,-6,-4,,468
186132,3000,Male,GM0088,Schiermonnikoog,2016JJ00,2016,468,,2,,2,,0,44,,5,39,29,,3,0,26,15,15,,483
186133,3000,Male,GM0088,Schiermonnikoog,2017JJ00,2017,483,,1,,4,,-3,39,,1,38,35,,3,0,32,4,1,,484
186134,3000,Male,GM0088,Schiermonnikoog,2018JJ00,2018,484,,4,,5,,-1,34,,6,28,29,,3,2,26,5,4,,488
186135,3000,Male,GM0088,Schiermonnikoog,2019JJ00,2019,488,,2,,3,,-1,45,,10,35,46,,6,0,40,-1,-2,,486
186136,3000,Male,GM0088,Schiermonnikoog,2020JJ00,2020,486,,2,,9,,-7,34,,4,30,32,,3,0,29,2,-5,,481
186137,3000,Male,GM0088,Schiermonnikoog,2021JJ00,2021,481,,2,,6,,-4,54,,11,43,33,,4,0,29,21,17,,498
186138,3000,Male,GM0088,Schiermonnikoog,2022JJ00,2022,498,,3,,3,,0,64,,40,24,43,,11,-1,32,21,21,,519
186139,3000,Male,GM0088,Schiermonnikoog,2023JJ00,2023,519,,2,,3,,-1,55,,28,27,60,,30,-14,30,-5,-7,,512
186210,3000,Male,GM0844,Schijndel,2012JJ00,2012,11527,,102,,90,,12,435,,58,377,342,,48,-25,294,93,104,,11631
186211,3000,Male,GM0844,Schijndel,2013JJ00,2013,11631,,107,,83,,24,425,,74,351,374,,46,-24,328,51,76,,11707
186212,3000,Male,GM0844,Schijndel,2014JJ00,2014,11707,,121,,68,,53,467,,59,408,405,,44,-17,361,62,115,,11822
186213,3000,Male,GM0844,Schijndel,2015JJ00,2015,11822,,106,,81,,25,465,,81,384,480,,57,-26,423,-15,10,,11832
186214,3000,Male,GM0844,Schijndel,2016JJ00,2016,11832,,112,,96,,16,470,,68,402,464,,69,-24,395,6,58,,11890
186374,3000,Male,GM0962,Schinnen,2012JJ00,2012,6644,,56,,57,,-1,289,,40,249,495,,184,-150,311,-206,-206,,6438
186375,3000,Male,GM0962,Schinnen,2013JJ00,2013,6438,,43,,67,,-24,302,,26,276,280,,33,-7,247,22,-1,,6437
186376,3000,Male,GM0962,Schinnen,2014JJ00,2014,6437,,54,,68,,-14,533,,231,302,463,,24,0,439,70,58,,6495
186377,3000,Male,GM0962,Schinnen,2015JJ00,2015,6495,,52,,56,,-4,541,,183,358,550,,52,-20,498,-9,-15,,6480
186378,3000,Male,GM0962,Schinnen,2016JJ00,2016,6480,,39,,83,,-44,538,,124,414,506,,31,-12,475,32,-12,,6468
186379,3000,Male,GM0962,Schinnen,2017JJ00,2017,6468,,49,,78,,-29,503,,57,446,508,,30,-11,478,-5,-34,,6434
186380,3000,Male,GM0962,Schinnen,2018JJ00,2018,6434,,42,,81,,-39,429,,37,392,479,,46,-13,433,-50,-92,,6342
186784,3000,Male,GM0608,Schoonhoven,2012JJ00,2012,5828,,62,,58,,4,233,,17,216,207,,17,-2,190,26,31,,5859
186785,3000,Male,GM0608,Schoonhoven,2013JJ00,2013,5859,,52,,40,,12,205,,13,192,211,,15,-3,196,-6,6,,5865
186786,3000,Male,GM0608,Schoonhoven,2014JJ00,2014,5865,,67,,43,,24,237,,24,213,234,,12,4,222,3,14,,5879
187030,3000,Male,GM1676,Schouwen-Duiveland,2012JJ00,2012,16864,,145,,151,,-6,411,,60,351,431,,69,-4,362,-20,-27,,16837
187031,3000,Male,GM1676,Schouwen-Duiveland,2013JJ00,2013,16837,,153,,205,,-52,459,,67,392,493,,53,-2,440,-34,-85,,16752
187032,3000,Male,GM1676,Schouwen-Duiveland,2014JJ00,2014,16752,,139,,177,,-38,491,,70,421,481,,60,1,421,10,-29,,16723
187033,3000,Male,GM1676,Schouwen-Duiveland,2015JJ00,2015,16723,,147,,186,,-39,498,,75,423,480,,71,-16,409,18,-22,,16701
187034,3000,Male,GM1676,Schouwen-Duiveland,2016JJ00,2016,16701,,118,,177,,-59,539,,85,454,461,,50,-12,411,78,20,,16721
187035,3000,Male,GM1676,Schouwen-Duiveland,2017JJ00,2017,16721,,134,,188,,-54,573,,67,506,595,,64,-1,531,-22,-78,,16643
187036,3000,Male,GM1676,Schouwen-Duiveland,2018JJ00,2018,16643,,136,,178,,-42,617,,78,539,492,,45,2,447,125,82,,16725
187037,3000,Male,GM1676,Schouwen-Duiveland,2019JJ00,2019,16725,,157,,194,,-37,566,,79,487,530,,64,-7,466,36,-1,,16724
187038,3000,Male,GM1676,Schouwen-Duiveland,2020JJ00,2020,16724,,132,,200,,-68,674,,63,611,494,,65,-24,429,180,115,,16839
187039,3000,Male,GM1676,Schouwen-Duiveland,2021JJ00,2021,16839,,158,,264,,-106,590,,72,518,459,,60,-7,399,131,27,,16866
187040,3000,Male,GM1676,Schouwen-Duiveland,2022JJ00,2022,16866,,142,,216,,-74,763,,210,553,532,,84,-7,448,231,158,,17024
187041,3000,Male,GM1676,Schouwen-Duiveland,2023JJ00,2023,17024,,148,,208,,-60,652,,133,519,542,,77,7,465,110,53,,17077
187440,3000,Male,GM0965,Simpelveld,2012JJ00,2012,5430,,40,,52,,-12,248,,20,228,253,,31,-6,222,-5,-17,,5413
187441,3000,Male,GM0965,Simpelveld,2013JJ00,2013,5413,,30,,58,,-28,210,,22,188,219,,38,-3,181,-9,-37,,5376
187442,3000,Male,GM0965,Simpelveld,2014JJ00,2014,5376,,44,,56,,-12,218,,16,202,223,,25,0,198,-5,-19,,5357
187443,3000,Male,GM0965,Simpelveld,2015JJ00,2015,5357,,41,,56,,-15,234,,20,214,261,,27,-5,234,-27,-42,,5315
187444,3000,Male,GM0965,Simpelveld,2016JJ00,2016,5315,,41,,59,,-18,248,,24,224,309,,18,2,291,-61,-79,,5236
187445,3000,Male,GM0965,Simpelveld,2017JJ00,2017,5236,,43,,52,,-9,269,,21,248,270,,24,-4,246,-1,-9,,5227
187446,3000,Male,GM0965,Simpelveld,2018JJ00,2018,5227,,50,,44,,6,274,,24,250,277,,24,0,253,-3,4,,5231
187447,3000,Male,GM0965,Simpelveld,2019JJ00,2019,5231,,44,,51,,-7,295,,32,263,276,,26,-4,250,19,11,,5242
187448,3000,Male,GM0965,Simpelveld,2020JJ00,2020,5242,,39,,51,,-12,279,,28,251,317,,32,-8,285,-38,-49,,5193
187449,3000,Male,GM0965,Simpelveld,2021JJ00,2021,5193,,34,,73,,-39,280,,35,245,292,,24,-2,268,-12,-50,,5143
187450,3000,Male,GM0965,Simpelveld,2022JJ00,2022,5143,,40,,55,,-15,287,,52,235,269,,38,-9,231,18,3,,5146
187451,3000,Male,GM0965,Simpelveld,2023JJ00,2023,5146,,35,,50,,-15,225,,35,190,293,,41,-11,252,-68,-82,,5064
187522,3000,Male,GM1702,Sint Anthonis,2012JJ00,2012,6062,,46,,46,,0,181,,15,166,185,,15,0,170,-4,-4,,6058
187523,3000,Male,GM1702,Sint Anthonis,2013JJ00,2013,6058,,51,,43,,8,185,,19,166,224,,26,-3,198,-39,-29,,6029
187524,3000,Male,GM1702,Sint Anthonis,2014JJ00,2014,6029,,47,,40,,7,178,,11,167,219,,22,-3,197,-41,-34,,5995
187525,3000,Male,GM1702,Sint Anthonis,2015JJ00,2015,5995,,52,,44,,8,193,,17,176,215,,11,0,204,-22,-13,,5982
187526,3000,Male,GM1702,Sint Anthonis,2016JJ00,2016,5982,,47,,39,,8,218,,19,199,198,,13,-2,185,20,25,,6007
187527,3000,Male,GM1702,Sint Anthonis,2017JJ00,2017,6007,,57,,63,,-6,236,,19,217,239,,8,-3,231,-3,-9,,5998
187528,3000,Male,GM1702,Sint Anthonis,2018JJ00,2018,5998,,54,,55,,-1,232,,27,205,222,,21,0,201,10,8,,6006
187529,3000,Male,GM1702,Sint Anthonis,2019JJ00,2019,6006,,66,,53,,13,252,,30,222,269,,23,-6,246,-17,-4,,6002
187530,3000,Male,GM1702,Sint Anthonis,2020JJ00,2020,6002,,52,,57,,-5,271,,12,259,234,,21,0,213,37,32,,6034
187531,3000,Male,GM1702,Sint Anthonis,2021JJ00,2021,6034,,57,,63,,-6,310,,26,284,227,,6,1,221,83,76,,6110
188342,3000,Male,GM0845,Sint-Michielsgestel,2012JJ00,2012,14143,,121,,115,,6,482,,53,429,538,,61,-16,477,-56,-50,,14093
188343,3000,Male,GM0845,Sint-Michielsgestel,2013JJ00,2013,14093,,93,,112,,-19,569,,53,516,515,,57,-14,458,54,35,,14128
188344,3000,Male,GM0845,Sint-Michielsgestel,2014JJ00,2014,14128,,131,,131,,0,716,,77,639,565,,53,-7,512,151,149,,14277
188345,3000,Male,GM0845,Sint-Michielsgestel,2015JJ00,2015,14277,,115,,137,,-22,674,,54,620,675,,73,-6,602,-1,-23,,14254
188346,3000,Male,GM0845,Sint-Michielsgestel,2016JJ00,2016,14254,,110,,132,,-22,742,,82,660,601,,47,-5,554,141,118,,14372
188347,3000,Male,GM0845,Sint-Michielsgestel,2017JJ00,2017,14372,,122,,170,,-48,778,,54,724,709,,75,-22,634,69,22,,14394
188348,3000,Male,GM0845,Sint-Michielsgestel,2018JJ00,2018,14394,,115,,137,,-22,790,,89,701,602,,56,-7,546,188,167,,14561
188349,3000,Male,GM0845,Sint-Michielsgestel,2019JJ00,2019,14561,,129,,121,,8,703,,88,615,594,,52,-10,542,109,116,,14677
188350,3000,Male,GM0845,Sint-Michielsgestel,2020JJ00,2020,14677,,140,,156,,-16,802,,67,735,631,,41,-12,590,171,154,,14831
188351,3000,Male,GM0845,Sint-Michielsgestel,2021JJ00,2021,14831,,118,,151,,-33,789,,85,704,632,,55,-20,577,157,126,,14957
188352,3000,Male,GM0845,Sint-Michielsgestel,2022JJ00,2022,14957,,162,,148,,14,827,,122,705,649,,71,-11,578,178,193,,15150
188353,3000,Male,GM0845,Sint-Michielsgestel,2023JJ00,2023,15150,,125,,146,,-21,684,,71,613,665,,64,-15,601,19,1,,15151
188424,3000,Male,GM0846,Sint-Oedenrode,2012JJ00,2012,8950,,73,,72,,1,249,,48,201,259,,9,7,250,-10,-9,,8941
188425,3000,Male,GM0846,Sint-Oedenrode,2013JJ00,2013,8941,,84,,64,,20,259,,49,210,282,,49,-8,233,-23,-3,,8938
188426,3000,Male,GM0846,Sint-Oedenrode,2014JJ00,2014,8938,,77,,77,,0,294,,72,222,310,,34,-5,276,-16,-16,,8922
188427,3000,Male,GM0846,Sint-Oedenrode,2015JJ00,2015,8922,,74,,68,,6,320,,38,282,343,,51,-15,292,-23,-17,,8905
188428,3000,Male,GM0846,Sint-Oedenrode,2016JJ00,2016,8905,,67,,76,,-9,385,,84,301,349,,60,-13,289,36,14,,8919
188588,3000,Male,GM1883,Sittard-Geleen,2012JJ00,2012,46504,,414,,504,,-90,1803,,338,1465,1926,,276,88,1650,-123,-215,,46289
188589,3000,Male,GM1883,Sittard-Geleen,2013JJ00,2013,46289,,380,,492,,-112,1703,,303,1400,1751,,219,76,1532,-48,-163,,46126
188590,3000,Male,GM1883,Sittard-Geleen,2014JJ00,2014,46126,,380,,485,,-105,1895,,283,1612,1771,,257,-5,1514,124,16,,46142
188591,3000,Male,GM1883,Sittard-Geleen,2015JJ00,2015,46142,,367,,537,,-170,2030,,314,1716,1945,,289,19,1656,85,-92,,46050
188592,3000,Male,GM1883,Sittard-Geleen,2016JJ00,2016,46050,,368,,523,,-155,2090,,294,1796,1981,,292,-12,1689,109,-45,,46005
188593,3000,Male,GM1883,Sittard-Geleen,2017JJ00,2017,46005,,364,,488,,-124,2103,,357,1746,2125,,431,-101,1694,-22,-146,,45859
188594,3000,Male,GM1883,Sittard-Geleen,2018JJ00,2018,45859,,390,,502,,-112,2012,,366,1646,2074,,351,-35,1723,-62,-174,,45685
188595,3000,Male,GM1883,Sittard-Geleen,2019JJ00,2019,45685,,383,,561,,-178,2145,,459,1686,1973,,330,2,1643,172,5,,45690
188596,3000,Male,GM1883,Sittard-Geleen,2020JJ00,2020,45690,,344,,625,,-281,2150,,370,1780,2082,,246,-1,1836,68,-218,,45472
188597,3000,Male,GM1883,Sittard-Geleen,2021JJ00,2021,45472,,378,,639,,-261,2244,,386,1858,2008,,336,-22,1672,236,-26,,45446
188598,3000,Male,GM1883,Sittard-Geleen,2022JJ00,2022,45446,,411,,529,,-118,2411,,659,1752,1964,,313,1,1651,447,326,,45772
188599,3000,Male,GM1883,Sittard-Geleen,2023JJ00,2023,45772,,362,,567,,-205,2660,,595,2065,2112,,348,-40,1764,548,346,,46118
188670,3000,Male,GM0051,Skarsterlân,2012JJ00,2012,13797,,134,,117,,17,378,,39,339,466,,52,-23,414,-88,-71,,13726
188671,3000,Male,GM0051,Skarsterlân,2013JJ00,2013,13726,,150,,109,,41,420,,42,378,428,,36,1,392,-8,58,,13784
188916,3000,Male,GM0610,Sliedrecht,2012JJ00,2012,11895,,144,,122,,22,476,,40,436,432,,45,-12,387,44,68,,11963
188917,3000,Male,GM0610,Sliedrecht,2013JJ00,2013,11963,,169,,122,,47,460,,59,401,411,,63,-10,348,49,96,,12059
188918,3000,Male,GM0610,Sliedrecht,2014JJ00,2014,12059,,162,,106,,56,463,,77,386,393,,50,-4,343,70,128,,12187
188919,3000,Male,GM0610,Sliedrecht,2015JJ00,2015,12187,,141,,106,,35,553,,83,470,482,,134,-54,348,71,106,,12293
188920,3000,Male,GM0610,Sliedrecht,2016JJ00,2016,12293,,159,,136,,23,545,,47,498,537,,61,-20,476,8,35,,12328
188921,3000,Male,GM0610,Sliedrecht,2017JJ00,2017,12328,,181,,133,,48,496,,40,456,546,,57,-8,489,-50,-3,,12325
188922,3000,Male,GM0610,Sliedrecht,2018JJ00,2018,12325,,143,,128,,15,556,,57,499,552,,53,-18,499,4,19,,12344
188923,3000,Male,GM0610,Sliedrecht,2019JJ00,2019,12344,,158,,105,,53,561,,58,503,479,,35,5,444,82,133,,12477
188924,3000,Male,GM0610,Sliedrecht,2020JJ00,2020,12477,,131,,171,,-40,736,,60,676,521,,43,-16,478,215,175,,12652
188925,3000,Male,GM0610,Sliedrecht,2021JJ00,2021,12652,,167,,160,,7,677,,47,630,522,,31,-5,491,155,163,,12815
188926,3000,Male,GM0610,Sliedrecht,2022JJ00,2022,12815,,156,,140,,16,610,,138,472,473,,43,-1,430,137,153,,12968
188927,3000,Male,GM0610,Sliedrecht,2023JJ00,2023,12968,,166,,135,,31,590,,52,538,567,,66,-16,501,23,53,,13021
188998,3000,Male,GM0040,Slochteren,2012JJ00,2012,7910,,69,,66,,3,335,,30,305,315,,17,-3,298,20,24,,7934
188999,3000,Male,GM0040,Slochteren,2013JJ00,2013,7934,,78,,62,,16,263,,15,248,301,,25,-3,276,-38,-22,,7912
189000,3000,Male,GM0040,Slochteren,2014JJ00,2014,7912,,71,,57,,14,313,,20,293,319,,17,2,302,-6,7,,7919
189001,3000,Male,GM0040,Slochteren,2015JJ00,2015,7919,,81,,59,,22,423,,25,398,370,,30,-11,340,53,75,,7994
189002,3000,Male,GM0040,Slochteren,2016JJ00,2016,7994,,79,,67,,12,460,,22,438,419,,16,-1,403,41,52,,8046
189003,3000,Male,GM0040,Slochteren,2017JJ00,2017,7515,,56,,72,,-16,391,,19,372,376,,4,3,372,15,-2,,7513
189162,3000,Male,GM1714,Sluis,2012JJ00,2012,11728,,88,,136,,-48,431,,200,231,391,,120,-29,271,40,-7,,11721
189163,3000,Male,GM1714,Sluis,2013JJ00,2013,11721,,107,,136,,-29,411,,169,242,354,,113,-27,241,57,24,,11745
189164,3000,Male,GM1714,Sluis,2014JJ00,2014,11745,,107,,152,,-45,387,,167,220,394,,147,-34,247,-7,-46,,11699
189165,3000,Male,GM1714,Sluis,2015JJ00,2015,11699,,89,,147,,-58,402,,161,241,381,,113,-12,268,21,-36,,11663
189166,3000,Male,GM1714,Sluis,2016JJ00,2016,11663,,72,,142,,-70,470,,203,267,397,,132,-16,265,73,6,,11669
189167,3000,Male,GM1714,Sluis,2017JJ00,2017,11669,,96,,154,,-58,413,,164,249,419,,140,-25,279,-6,-63,,11606
189168,3000,Male,GM1714,Sluis,2018JJ00,2018,11606,,69,,138,,-69,432,,163,269,400,,144,-9,256,32,-34,,11572
189169,3000,Male,GM1714,Sluis,2019JJ00,2019,11572,,85,,144,,-59,415,,185,230,417,,141,-16,276,-2,-60,,11512
189170,3000,Male,GM1714,Sluis,2020JJ00,2020,11512,,88,,163,,-75,466,,183,283,418,,138,-16,280,48,-30,,11482
189171,3000,Male,GM1714,Sluis,2021JJ00,2021,11482,,94,,151,,-57,463,,179,284,407,,155,-29,252,56,-4,,11478
189172,3000,Male,GM1714,Sluis,2022JJ00,2022,11478,,86,,154,,-68,547,,268,279,438,,179,-34,259,109,40,,11518
189173,3000,Male,GM1714,Sluis,2023JJ00,2023,11518,,88,,174,,-86,481,,247,234,474,,174,-32,300,7,-79,,11439
189408,3000,Male,GM0090,Smallingerland,2012JJ00,2012,27571,,283,,235,,48,1106,,204,902,1127,,125,-29,1002,-21,30,,27601
189409,3000,Male,GM0090,Smallingerland,2013JJ00,2013,27601,,297,,249,,48,1105,,228,877,1157,,78,-4,1079,-52,-5,,27596
189410,3000,Male,GM0090,Smallingerland,2014JJ00,2014,27596,,301,,253,,48,1443,,399,1044,1399,,124,-36,1275,44,94,,27690
189411,3000,Male,GM0090,Smallingerland,2015JJ00,2015,27690,,268,,240,,28,1271,,264,1007,1435,,92,-10,1343,-164,-138,,27552
189412,3000,Male,GM0090,Smallingerland,2016JJ00,2016,27552,,278,,264,,14,1443,,204,1239,1295,,91,-21,1204,148,160,,27712
189413,3000,Male,GM0090,Smallingerland,2017JJ00,2017,27712,,278,,275,,3,1367,,138,1229,1285,,85,-26,1200,82,83,,27795
189414,3000,Male,GM0090,Smallingerland,2018JJ00,2018,27795,,262,,251,,11,1339,,137,1202,1267,,93,-19,1174,72,81,,27876
189415,3000,Male,GM0090,Smallingerland,2019JJ00,2019,27876,,264,,265,,-1,1345,,261,1084,1206,,84,-14,1122,139,142,,28018
189416,3000,Male,GM0090,Smallingerland,2020JJ00,2020,28018,,293,,291,,2,1237,,160,1077,1280,,77,-33,1203,-43,-40,,27978
189417,3000,Male,GM0090,Smallingerland,2021JJ00,2021,27978,,294,,273,,21,1237,,57,1180,1346,,142,-94,1204,-109,-91,,27887
189418,3000,Male,GM0090,Smallingerland,2022JJ00,2022,27887,,219,,279,,-60,1370,,189,1181,1229,,81,-14,1148,141,76,,27963
189419,3000,Male,GM0090,Smallingerland,2023JJ00,2023,27963,,263,,269,,-6,1658,,253,1405,1234,,113,-21,1121,424,419,,28382
189736,3000,Male,GM0342,Soest,2012JJ00,2012,22209,,204,,180,,24,901,,111,790,939,,102,-19,837,-38,-15,,22194
189737,3000,Male,GM0342,Soest,2013JJ00,2013,22194,,186,,190,,-4,946,,112,834,979,,138,-25,841,-33,-36,,22158
189738,3000,Male,GM0342,Soest,2014JJ00,2014,22158,,224,,209,,15,1011,,102,909,995,,124,-5,871,16,32,,22190
189739,3000,Male,GM0342,Soest,2015JJ00,2015,22190,,195,,202,,-7,1143,,102,1041,1088,,117,-29,971,55,46,,22236
189740,3000,Male,GM0342,Soest,2016JJ00,2016,22236,,205,,220,,-15,1326,,117,1209,1136,,100,-11,1036,190,177,,22413
189741,3000,Male,GM0342,Soest,2017JJ00,2017,22413,,208,,231,,-23,1293,,136,1157,1236,,140,-12,1096,57,33,,22446
189742,3000,Male,GM0342,Soest,2018JJ00,2018,22446,,215,,207,,8,1316,,177,1139,1218,,129,-9,1089,98,106,,22552
189743,3000,Male,GM0342,Soest,2019JJ00,2019,22552,,202,,209,,-7,1514,,198,1316,1289,,138,-21,1151,225,220,,22772
189744,3000,Male,GM0342,Soest,2020JJ00,2020,22772,,224,,234,,-10,1499,,147,1352,1301,,114,-2,1187,198,189,,22961
189745,3000,Male,GM0342,Soest,2021JJ00,2021,22961,,229,,245,,-16,1460,,163,1297,1363,,119,-10,1244,97,84,,23045
189746,3000,Male,GM0342,Soest,2022JJ00,2022,23045,,213,,235,,-22,1389,,209,1180,1227,,104,-2,1123,162,142,,23187
189747,3000,Male,GM0342,Soest,2023JJ00,2023,23187,,201,,236,,-35,1440,,206,1234,1286,,147,-7,1139,154,120,,23307
189818,3000,Male,GM0847,Someren,2012JJ00,2012,9457,,72,,78,,-6,305,,101,204,295,,48,-2,247,10,6,,9463
189819,3000,Male,GM0847,Someren,2013JJ00,2013,9463,,90,,72,,18,356,,78,278,341,,78,-20,263,15,33,,9496
189820,3000,Male,GM0847,Someren,2014JJ00,2014,9496,,100,,74,,26,349,,103,246,351,,99,-18,252,-2,25,,9521
189821,3000,Male,GM0847,Someren,2015JJ00,2015,9521,,107,,85,,22,456,,152,304,350,,94,-33,256,106,127,,9648
189822,3000,Male,GM0847,Someren,2016JJ00,2016,9648,,104,,76,,28,448,,126,322,411,,118,-31,293,37,66,,9714
189823,3000,Male,GM0847,Someren,2017JJ00,2017,9714,,99,,79,,20,481,,136,345,451,,149,-54,302,30,50,,9764
189824,3000,Male,GM0847,Someren,2018JJ00,2018,9764,,101,,69,,32,494,,167,327,419,,111,-18,308,75,106,,9870
189825,3000,Male,GM0847,Someren,2019JJ00,2019,9870,,98,,83,,15,405,,121,284,422,,115,-40,307,-17,-2,,9868
189826,3000,Male,GM0847,Someren,2020JJ00,2020,9868,,97,,102,,-5,473,,121,352,420,,90,-22,330,53,49,,9917
189827,3000,Male,GM0847,Someren,2021JJ00,2021,9917,,97,,98,,-1,529,,114,415,403,,105,-16,298,126,125,,10042
189828,3000,Male,GM0847,Someren,2022JJ00,2022,10042,,122,,102,,20,523,,150,373,377,,95,-34,282,146,166,,10208
189829,3000,Male,GM0847,Someren,2023JJ00,2023,10208,,116,,79,,37,422,,97,325,420,,92,-28,328,2,39,,10247
189982,3000,Male,GM0848,Son en Breugel,2012JJ00,2012,7816,,69,,76,,-7,427,,32,395,263,,21,-3,242,164,159,,7975
189983,3000,Male,GM0848,Son en Breugel,2013JJ00,2013,7975,,81,,68,,13,328,,36,292,294,,40,-2,254,34,46,,8021
189984,3000,Male,GM0848,Son en Breugel,2014JJ00,2014,8021,,72,,65,,7,363,,46,317,319,,33,-8,286,44,51,,8072
189985,3000,Male,GM0848,Son en Breugel,2015JJ00,2015,8072,,85,,64,,21,344,,38,306,325,,36,-3,289,19,40,,8112
189986,3000,Male,GM0848,Son en Breugel,2016JJ00,2016,8112,,81,,95,,-14,461,,42,419,356,,38,0,318,105,92,,8204
189987,3000,Male,GM0848,Son en Breugel,2017JJ00,2017,8204,,77,,77,,0,452,,32,420,363,,28,-4,335,89,89,,8293
189988,3000,Male,GM0848,Son en Breugel,2018JJ00,2018,8293,,63,,84,,-21,461,,50,411,408,,40,-5,368,53,32,,8325
189989,3000,Male,GM0848,Son en Breugel,2019JJ00,2019,8325,,82,,96,,-14,565,,79,486,341,,38,-9,303,224,210,,8535
189990,3000,Male,GM0848,Son en Breugel,2020JJ00,2020,8535,,96,,111,,-15,506,,39,467,394,,36,-12,358,112,97,,8632
189991,3000,Male,GM0848,Son en Breugel,2021JJ00,2021,8632,,84,,79,,5,525,,55,470,416,,32,-6,384,109,115,,8747
189992,3000,Male,GM0848,Son en Breugel,2022JJ00,2022,8747,,93,,93,,0,511,,85,426,369,,44,-5,325,142,142,,8889
189993,3000,Male,GM0848,Son en Breugel,2023JJ00,2023,8889,,98,,104,,-6,399,,59,340,407,,60,-12,347,-8,-16,,8873
190228,3000,Male,GM0612,Spijkenisse,2012JJ00,2012,35368,,373,,255,,118,1348,,122,1226,1423,,271,-140,1152,-75,39,,35407
190229,3000,Male,GM0612,Spijkenisse,2013JJ00,2013,35407,,348,,257,,91,1347,,135,1212,1327,,196,-69,1131,20,117,,35524
190230,3000,Male,GM0612,Spijkenisse,2014JJ00,2014,35524,,379,,245,,134,1308,,155,1153,1344,,158,-15,1186,-36,86,,35610
190638,3000,Male,GM0037,Stadskanaal,2012JJ00,2012,16292,,160,,186,,-26,678,,92,586,693,,33,14,660,-15,-41,,16251
190639,3000,Male,GM0037,Stadskanaal,2013JJ00,2013,16251,,142,,192,,-50,714,,215,499,727,,45,7,682,-13,-66,,16185
190640,3000,Male,GM0037,Stadskanaal,2014JJ00,2014,16185,,164,,173,,-9,849,,362,487,834,,54,-3,780,15,-3,,16182
190641,3000,Male,GM0037,Stadskanaal,2015JJ00,2015,16182,,151,,187,,-36,1156,,529,627,1109,,65,-8,1044,47,-1,,16181
190642,3000,Male,GM0037,Stadskanaal,2016JJ00,2016,16181,,164,,192,,-28,983,,249,734,1126,,53,-20,1073,-143,-178,,16003
190643,3000,Male,GM0037,Stadskanaal,2017JJ00,2017,16003,,131,,192,,-61,921,,106,815,889,,106,-72,783,32,-31,,15972
190644,3000,Male,GM0037,Stadskanaal,2018JJ00,2018,15972,,121,,196,,-75,737,,74,663,907,,102,-50,805,-170,-242,,15730
190645,3000,Male,GM0037,Stadskanaal,2019JJ00,2019,15730,,134,,218,,-84,711,,55,656,711,,70,-33,641,0,-87,,15643
190646,3000,Male,GM0037,Stadskanaal,2020JJ00,2020,15643,,126,,214,,-88,813,,48,765,708,,37,-15,671,105,16,,15659
190647,3000,Male,GM0037,Stadskanaal,2021JJ00,2021,15659,,121,,216,,-95,1037,,33,1004,868,,23,0,845,169,78,,15737
190648,3000,Male,GM0037,Stadskanaal,2022JJ00,2022,15737,,145,,235,,-90,1080,,174,906,882,,44,-6,838,198,107,,15844
190649,3000,Male,GM0037,Stadskanaal,2023JJ00,2023,15844,,103,,220,,-117,985,,127,858,865,,86,-26,779,120,3,,15847
190884,3000,Male,GM0180,Staphorst,2012JJ00,2012,8324,,119,,52,,67,213,,21,192,266,,17,0,249,-53,15,,8339
190885,3000,Male,GM0180,Staphorst,2013JJ00,2013,8339,,116,,51,,65,227,,25,202,252,,28,-7,224,-25,39,,8378
190886,3000,Male,GM0180,Staphorst,2014JJ00,2014,8378,,135,,55,,80,217,,28,189,260,,25,-5,235,-43,36,,8414
190887,3000,Male,GM0180,Staphorst,2015JJ00,2015,8414,,136,,62,,74,227,,17,210,235,,23,-11,212,-8,66,,8480
190888,3000,Male,GM0180,Staphorst,2016JJ00,2016,8480,,119,,57,,62,274,,17,257,267,,24,0,243,7,69,,8549
190889,3000,Male,GM0180,Staphorst,2017JJ00,2017,8549,,123,,70,,53,311,,21,290,289,,20,-5,269,22,75,,8624
190890,3000,Male,GM0180,Staphorst,2018JJ00,2018,8624,,130,,70,,60,340,,38,302,283,,25,-3,258,57,119,,8743
190891,3000,Male,GM0180,Staphorst,2019JJ00,2019,8743,,135,,64,,71,281,,34,247,318,,24,-7,294,-37,34,,8777
190892,3000,Male,GM0180,Staphorst,2020JJ00,2020,8777,,134,,60,,74,294,,35,259,288,,17,-7,271,6,80,,8857
190893,3000,Male,GM0180,Staphorst,2021JJ00,2021,8857,,129,,60,,69,271,,22,249,338,,22,-4,316,-67,4,,8861
190894,3000,Male,GM0180,Staphorst,2022JJ00,2022,8861,,111,,59,,52,389,,110,279,300,,35,-3,265,89,141,,9002
190895,3000,Male,GM0180,Staphorst,2023JJ00,2023,9002,,110,,62,,48,395,,120,275,371,,51,-18,320,24,72,,9074
191130,3000,Male,GM0532,Stede Broec,2012JJ00,2012,10860,,103,,73,,30,430,,65,365,480,,51,-18,429,-50,-21,,10839
191131,3000,Male,GM0532,Stede Broec,2013JJ00,2013,10839,,116,,87,,29,412,,54,358,460,,46,-6,414,-48,-18,,10821
191132,3000,Male,GM0532,Stede Broec,2014JJ00,2014,10821,,113,,60,,53,468,,73,395,488,,61,-1,427,-20,35,,10856
191133,3000,Male,GM0532,Stede Broec,2015JJ00,2015,10856,,118,,92,,26,458,,74,384,514,,56,-8,458,-56,-30,,10826
191134,3000,Male,GM0532,Stede Broec,2016JJ00,2016,10826,,117,,83,,34,530,,71,459,554,,53,-3,501,-24,11,,10837
191135,3000,Male,GM0532,Stede Broec,2017JJ00,2017,10837,,115,,96,,19,568,,58,510,528,,53,-10,475,40,58,,10895
191136,3000,Male,GM0532,Stede Broec,2018JJ00,2018,10895,,113,,106,,7,531,,57,474,522,,43,-3,479,9,17,,10912
191137,3000,Male,GM0532,Stede Broec,2019JJ00,2019,10912,,114,,101,,13,529,,85,444,527,,58,-9,469,2,14,,10926
191138,3000,Male,GM0532,Stede Broec,2020JJ00,2020,10926,,101,,105,,-4,559,,93,466,521,,65,-15,456,38,33,,10959
191139,3000,Male,GM0532,Stede Broec,2021JJ00,2021,10959,,112,,115,,-3,560,,86,474,456,,50,-2,406,104,104,,11063
191140,3000,Male,GM0532,Stede Broec,2022JJ00,2022,11063,,94,,89,,5,624,,143,481,547,,89,-8,458,77,83,,11146
191141,3000,Male,GM0532,Stede Broec,2023JJ00,2023,11146,,103,,112,,-9,585,,81,504,541,,97,-19,444,44,36,,11182
191294,3000,Male,GM0851,Steenbergen,2012JJ00,2012,11745,,102,,104,,-2,397,,79,318,394,,64,-14,330,3,0,,11745
191295,3000,Male,GM0851,Steenbergen,2013JJ00,2013,11745,,105,,117,,-12,428,,115,313,422,,57,-1,365,6,-6,,11739
191296,3000,Male,GM0851,Steenbergen,2014JJ00,2014,11739,,102,,127,,-25,663,,295,368,484,,81,-2,403,179,154,,11893
191297,3000,Male,GM0851,Steenbergen,2015JJ00,2015,11893,,107,,116,,-9,602,,214,388,665,,242,-161,423,-63,-70,,11823
191298,3000,Male,GM0851,Steenbergen,2016JJ00,2016,11823,,119,,109,,10,1016,,617,399,643,,213,-131,430,373,382,,12205
191299,3000,Male,GM0851,Steenbergen,2017JJ00,2017,12205,,98,,120,,-22,1516,,1045,471,989,,475,-329,514,527,506,,12711
191300,3000,Male,GM0851,Steenbergen,2018JJ00,2018,12711,,99,,121,,-22,1405,,878,527,1249,,758,-408,491,156,134,,12845
191301,3000,Male,GM0851,Steenbergen,2019JJ00,2019,12845,,130,,136,,-6,916,,391,525,1301,,815,-456,486,-385,-391,,12454
191302,3000,Male,GM0851,Steenbergen,2020JJ00,2020,12454,,100,,124,,-24,740,,229,511,760,,262,-83,498,-20,-47,,12407
191303,3000,Male,GM0851,Steenbergen,2021JJ00,2021,12407,,127,,136,,-9,819,,237,582,868,,325,-147,543,-49,-59,,12348
191304,3000,Male,GM0851,Steenbergen,2022JJ00,2022,12348,,96,,141,,-45,740,,230,510,613,,191,-53,422,127,81,,12429
191305,3000,Male,GM0851,Steenbergen,2023JJ00,2023,12429,,100,,129,,-29,650,,178,472,691,,237,-119,454,-41,-70,,12359
191622,3000,Male,GM1708,Steenwijkerland,2012JJ00,2012,21708,,221,,196,,25,651,,75,576,646,,71,-16,575,5,29,,21737
191623,3000,Male,GM1708,Steenwijkerland,2013JJ00,2013,21737,,197,,180,,17,617,,48,569,712,,76,-28,636,-95,-76,,21661
191624,3000,Male,GM1708,Steenwijkerland,2014JJ00,2014,21661,,225,,203,,22,649,,90,559,767,,59,4,708,-118,-94,,21567
191625,3000,Male,GM1708,Steenwijkerland,2015JJ00,2015,21567,,225,,200,,25,745,,74,671,669,,54,-17,615,76,102,,21669
191626,3000,Male,GM1708,Steenwijkerland,2016JJ00,2016,21669,,222,,202,,20,876,,78,798,779,,69,-5,710,97,118,,21787
191627,3000,Male,GM1708,Steenwijkerland,2017JJ00,2017,21787,,241,,195,,46,972,,80,892,789,,72,-11,717,183,229,,22016
191628,3000,Male,GM1708,Steenwijkerland,2018JJ00,2018,22016,,217,,213,,4,993,,123,870,879,,42,7,837,114,122,,22138
191629,3000,Male,GM1708,Steenwijkerland,2019JJ00,2019,22138,,218,,238,,-20,1002,,99,903,886,,72,-12,814,116,95,,22233
191630,3000,Male,GM1708,Steenwijkerland,2020JJ00,2020,22233,,208,,247,,-39,1063,,93,970,934,,65,-13,869,129,91,,22324
191631,3000,Male,GM1708,Steenwijkerland,2021JJ00,2021,22324,,202,,240,,-38,1077,,97,980,851,,69,-6,782,226,186,,22510
191632,3000,Male,GM1708,Steenwijkerland,2022JJ00,2022,22510,,241,,262,,-21,1158,,268,890,831,,101,-10,730,327,306,,22816
191633,3000,Male,GM1708,Steenwijkerland,2023JJ00,2023,22816,,187,,217,,-30,1036,,225,811,962,,132,-20,830,74,45,,22861
191786,3000,Male,GM0971,Stein (L.),2012JJ00,2012,12738,,75,,131,,-56,395,,46,349,452,,43,-3,409,-57,-112,,12626
191787,3000,Male,GM0971,Stein (L.),2013JJ00,2013,12626,,83,,101,,-18,383,,44,339,379,,36,-2,343,4,-14,,12612
191788,3000,Male,GM0971,Stein (L.),2014JJ00,2014,12612,,76,,116,,-40,397,,29,368,463,,49,-5,414,-66,-103,,12509
191789,3000,Male,GM0971,Stein (L.),2015JJ00,2015,12509,,81,,130,,-49,457,,46,411,451,,48,5,403,6,-41,,12468
191790,3000,Male,GM0971,Stein (L.),2016JJ00,2016,12468,,85,,122,,-37,486,,46,440,492,,49,6,443,-6,-43,,12425
191791,3000,Male,GM0971,Stein (L.),2017JJ00,2017,12425,,98,,148,,-50,513,,54,459,502,,49,-1,453,11,-40,,12385
191792,3000,Male,GM0971,Stein (L.),2018JJ00,2018,12385,,88,,140,,-52,512,,42,470,474,,50,4,424,38,-15,,12370
191793,3000,Male,GM0971,Stein (L.),2019JJ00,2019,12370,,96,,121,,-25,514,,53,461,482,,41,-3,441,32,6,,12376
191794,3000,Male,GM0971,Stein (L.),2020JJ00,2020,12376,,100,,156,,-56,461,,27,434,477,,39,-5,438,-16,-71,,12305
191795,3000,Male,GM0971,Stein (L.),2021JJ00,2021,12305,,114,,177,,-63,484,,40,444,453,,52,-1,401,31,-31,,12274
191796,3000,Male,GM0971,Stein (L.),2022JJ00,2022,12274,,91,,160,,-69,513,,73,440,457,,72,1,385,56,-15,,12259
191797,3000,Male,GM0971,Stein (L.),2023JJ00,2023,12259,,77,,132,,-55,505,,51,454,486,,59,-1,427,19,-36,,12223
192032,3000,Male,GM1904,Stichtse Vecht,2012JJ00,2012,31027,,358,,241,,117,1348,,195,1153,1401,,159,-32,1242,-53,61,,31088
192033,3000,Male,GM1904,Stichtse Vecht,2013JJ00,2013,31088,,311,,228,,83,1379,,196,1183,1302,,189,-38,1113,77,161,,31249
192034,3000,Male,GM1904,Stichtse Vecht,2014JJ00,2014,31249,,326,,245,,81,1464,,220,1244,1503,,149,-16,1354,-39,38,,31287
192035,3000,Male,GM1904,Stichtse Vecht,2015JJ00,2015,31287,,291,,252,,39,1569,,187,1382,1618,,204,-33,1414,-49,-12,,31275
192036,3000,Male,GM1904,Stichtse Vecht,2016JJ00,2016,31275,,319,,257,,62,1821,,219,1602,1607,,155,-3,1452,214,274,,31549
192037,3000,Male,GM1904,Stichtse Vecht,2017JJ00,2017,31549,,329,,250,,79,1662,,214,1448,1733,,168,-32,1565,-71,7,,31556
192038,3000,Male,GM1904,Stichtse Vecht,2018JJ00,2018,31556,,303,,260,,43,1562,,214,1348,1698,,201,-48,1497,-136,-95,,31461
192039,3000,Male,GM1904,Stichtse Vecht,2019JJ00,2019,31461,,336,,254,,82,1857,,232,1625,1619,,149,-14,1470,238,320,,31781
192040,3000,Male,GM1904,Stichtse Vecht,2020JJ00,2020,31781,,304,,311,,-7,1740,,198,1542,1671,,140,-24,1531,69,64,,31845
192041,3000,Male,GM1904,Stichtse Vecht,2021JJ00,2021,31845,,362,,281,,81,1842,,229,1613,1762,,124,-21,1638,80,161,,32006
192042,3000,Male,GM1904,Stichtse Vecht,2022JJ00,2022,32006,,333,,305,,28,1858,,404,1454,1693,,196,-38,1497,165,198,,32204
192043,3000,Male,GM1904,Stichtse Vecht,2023JJ00,2023,32204,,335,,319,,16,1951,,282,1669,1892,,260,-43,1632,59,81,,32285
192524,3000,Male,GM0617,Strijen,2012JJ00,2012,4418,,37,,26,,11,149,,5,144,182,,13,-3,169,-33,-21,,4397
192525,3000,Male,GM0617,Strijen,2013JJ00,2013,4397,,29,,34,,-5,143,,5,138,196,,12,3,184,-53,-57,,4340
192526,3000,Male,GM0617,Strijen,2014JJ00,2014,4340,,29,,43,,-14,188,,9,179,185,,10,-2,175,3,-11,,4329
192527,3000,Male,GM0617,Strijen,2015JJ00,2015,4329,,37,,32,,5,192,,11,181,187,,10,-2,177,5,11,,4340
192528,3000,Male,GM0617,Strijen,2016JJ00,2016,4340,,27,,47,,-20,204,,7,197,178,,16,-1,162,26,6,,4346
192529,3000,Male,GM0617,Strijen,2017JJ00,2017,4346,,39,,50,,-11,235,,17,218,221,,11,8,210,14,3,,4349
192530,3000,Male,GM0617,Strijen,2018JJ00,2018,4349,,35,,46,,-11,225,,13,212,212,,8,3,204,13,-2,,4347
192606,3000,Male,GM1900,Súdwest-Fryslân,2012JJ00,2012,41288,,395,,380,,15,1107,,135,972,1171,,148,-26,1023,-64,-50,,41238
192607,3000,Male,GM1900,Súdwest-Fryslân,2013JJ00,2013,41238,,423,,404,,19,1154,,127,1027,1181,,119,-8,1062,-27,-12,,41226
192608,3000,Male,GM1900,Súdwest-Fryslân,2014JJ00,2014,42076,,385,,362,,23,1174,,116,1058,1190,,130,-27,1060,-16,10,,42086
192609,3000,Male,GM1900,Súdwest-Fryslân,2015JJ00,2015,42086,,418,,402,,16,1244,,136,1108,1255,,125,-9,1130,-11,4,,42090
192610,3000,Male,GM1900,Súdwest-Fryslân,2016JJ00,2016,42090,,416,,380,,36,1414,,138,1276,1355,,114,-11,1241,59,93,,42183
192611,3000,Male,GM1900,Súdwest-Fryslân,2017JJ00,2017,42183,,415,,364,,51,1576,,170,1406,1543,,110,-17,1433,33,81,,42264
192612,3000,Male,GM1900,Súdwest-Fryslân,2018JJ00,2018,45025,,402,,456,,-54,1626,,213,1413,1489,,138,-22,1351,137,84,,45109
192613,3000,Male,GM1900,Súdwest-Fryslân,2019JJ00,2019,45109,,428,,434,,-6,1674,,201,1473,1486,,162,-38,1324,188,183,,45292
192614,3000,Male,GM1900,Súdwest-Fryslân,2020JJ00,2020,45292,,398,,491,,-93,1636,,151,1485,1540,,109,-22,1431,96,2,,45294
192615,3000,Male,GM1900,Súdwest-Fryslân,2021JJ00,2021,45294,,421,,483,,-62,1943,,158,1785,1671,,124,-29,1547,272,213,,45507
192616,3000,Male,GM1900,Súdwest-Fryslân,2022JJ00,2022,45507,,410,,515,,-105,2105,,455,1650,1675,,193,-27,1482,430,317,,45824
192617,3000,Male,GM1900,Súdwest-Fryslân,2023JJ00,2023,45824,,418,,499,,-81,1852,,233,1619,1927,,238,-41,1689,-75,-159,,45665
193098,3000,Male,GM0715,Terneuzen,2012JJ00,2012,27250,,241,,295,,-54,893,,358,535,871,,282,-53,589,22,-34,,27216
193099,3000,Male,GM0715,Terneuzen,2013JJ00,2013,27216,,238,,304,,-66,918,,346,572,888,,261,-37,627,30,-36,,27180
193100,3000,Male,GM0715,Terneuzen,2014JJ00,2014,27180,,231,,277,,-46,887,,336,551,938,,329,-57,609,-51,-98,,27082
193101,3000,Male,GM0715,Terneuzen,2015JJ00,2015,27082,,239,,333,,-94,989,,381,608,806,,271,-43,535,183,89,,27171
193102,3000,Male,GM0715,Terneuzen,2016JJ00,2016,27171,,234,,302,,-68,1181,,516,665,1141,,259,-41,882,40,-32,,27139
193103,3000,Male,GM0715,Terneuzen,2017JJ00,2017,27139,,209,,314,,-105,980,,403,577,975,,292,-71,683,5,-97,,27042
193104,3000,Male,GM0715,Terneuzen,2018JJ00,2018,27042,,231,,302,,-71,1138,,537,601,976,,292,-34,684,162,99,,27141
193105,3000,Male,GM0715,Terneuzen,2019JJ00,2019,27141,,209,,310,,-101,1081,,468,613,1060,,354,-75,706,21,-76,,27065
193106,3000,Male,GM0715,Terneuzen,2020JJ00,2020,27065,,218,,335,,-117,1084,,427,657,893,,262,-28,631,191,72,,27137
193107,3000,Male,GM0715,Terneuzen,2021JJ00,2021,27137,,216,,383,,-167,1183,,494,689,972,,318,-38,654,211,45,,27182
193108,3000,Male,GM0715,Terneuzen,2022JJ00,2022,27182,,217,,358,,-141,1490,,764,726,1110,,425,-80,685,380,237,,27419
193109,3000,Male,GM0715,Terneuzen,2023JJ00,2023,27419,,260,,334,,-74,1314,,595,719,1135,,390,-87,745,179,107,,27526
193180,3000,Male,GM0093,Terschelling,2012JJ00,2012,2512,,17,,31,,-14,196,,3,193,160,,9,-4,151,36,22,,2534
193181,3000,Male,GM0093,Terschelling,2013JJ00,2013,2534,,18,,18,,0,210,,2,208,208,,4,1,204,2,2,,2536
193182,3000,Male,GM0093,Terschelling,2014JJ00,2014,2536,,15,,17,,-2,227,,6,221,213,,12,-3,201,14,14,,2550
193183,3000,Male,GM0093,Terschelling,2015JJ00,2015,2550,,12,,18,,-6,213,,9,204,166,,10,-3,156,47,41,,2591
193184,3000,Male,GM0093,Terschelling,2016JJ00,2016,2591,,11,,37,,-26,207,,9,198,193,,6,-1,187,14,-12,,2579
193185,3000,Male,GM0093,Terschelling,2017JJ00,2017,2579,,21,,22,,-1,223,,27,196,210,,16,-3,194,13,13,,2592
193186,3000,Male,GM0093,Terschelling,2018JJ00,2018,2592,,6,,28,,-22,214,,26,188,233,,27,-15,206,-19,-41,,2551
193187,3000,Male,GM0093,Terschelling,2019JJ00,2019,2551,,17,,21,,-4,203,,27,176,225,,19,2,206,-22,-26,,2525
193188,3000,Male,GM0093,Terschelling,2020JJ00,2020,2525,,12,,22,,-10,204,,24,180,222,,19,-2,203,-18,-32,,2493
193189,3000,Male,GM0093,Terschelling,2021JJ00,2021,2493,,19,,30,,-11,252,,43,209,181,,17,-1,164,71,59,,2552
193190,3000,Male,GM0093,Terschelling,2022JJ00,2022,2552,,14,,30,,-16,197,,51,146,236,,50,-9,186,-39,-55,,2497
193191,3000,Male,GM0093,Terschelling,2023JJ00,2023,2497,,23,,18,,5,216,,34,182,237,,34,-8,203,-21,-15,,2482
193344,3000,Male,GM0448,Texel,2012JJ00,2012,6773,,62,,59,,3,231,,40,191,242,,36,-9,206,-11,-7,,6766
193345,3000,Male,GM0448,Texel,2013JJ00,2013,6766,,55,,64,,-9,233,,25,208,265,,38,-8,227,-32,-41,,6725
193346,3000,Male,GM0448,Texel,2014JJ00,2014,6725,,57,,52,,5,275,,30,245,242,,25,-1,217,33,37,,6762
193347,3000,Male,GM0448,Texel,2015JJ00,2015,6762,,46,,80,,-34,262,,35,227,249,,35,1,214,13,-21,,6741
193348,3000,Male,GM0448,Texel,2016JJ00,2016,6741,,74,,85,,-11,291,,33,258,289,,38,1,251,2,-9,,6732
193349,3000,Male,GM0448,Texel,2017JJ00,2017,6732,,44,,79,,-35,349,,53,296,296,,29,-8,267,53,19,,6751
193350,3000,Male,GM0448,Texel,2018JJ00,2018,6751,,56,,73,,-17,272,,44,228,282,,38,-1,244,-10,-25,,6726
193351,3000,Male,GM0448,Texel,2019JJ00,2019,6726,,49,,69,,-20,287,,40,247,252,,27,-2,225,35,14,,6740
193352,3000,Male,GM0448,Texel,2020JJ00,2020,6740,,59,,71,,-12,262,,44,218,227,,30,-8,197,35,23,,6763
193353,3000,Male,GM0448,Texel,2021JJ00,2021,6763,,53,,77,,-24,267,,50,217,240,,34,-1,206,27,2,,6765
193354,3000,Male,GM0448,Texel,2022JJ00,2022,6765,,61,,80,,-19,411,,199,212,245,,55,-2,190,166,147,,6912
193355,3000,Male,GM0448,Texel,2023JJ00,2023,6912,,48,,85,,-37,287,,107,180,335,,60,-16,275,-48,-84,,6828
193426,3000,Male,GM1525,Teylingen,2012JJ00,2012,17798,,168,,144,,24,761,,107,654,741,,102,2,639,20,46,,17844
193427,3000,Male,GM1525,Teylingen,2013JJ00,2013,17844,,148,,153,,-5,739,,83,656,770,,75,-1,695,-31,-33,,17811
193428,3000,Male,GM1525,Teylingen,2014JJ00,2014,17811,,172,,141,,31,751,,89,662,795,,71,-1,724,-44,-14,,17797
193429,3000,Male,GM1525,Teylingen,2015JJ00,2015,17797,,133,,139,,-6,1032,,107,925,876,,82,5,794,156,151,,17948
193430,3000,Male,GM1525,Teylingen,2016JJ00,2016,17948,,148,,156,,-8,1033,,108,925,961,,79,5,882,72,68,,18016
193431,3000,Male,GM1525,Teylingen,2017JJ00,2017,18016,,200,,145,,55,1257,,115,1142,1038,,65,-1,973,219,273,,18289
193432,3000,Male,GM1525,Teylingen,2018JJ00,2018,18289,,196,,142,,54,1013,,135,878,869,,97,1,772,144,194,,18483
193433,3000,Male,GM1525,Teylingen,2019JJ00,2019,18483,,188,,149,,39,970,,123,847,837,,82,-10,755,133,173,,18656
193434,3000,Male,GM1525,Teylingen,2020JJ00,2020,18656,,197,,162,,35,1031,,92,939,880,,73,-7,807,151,188,,18844
193435,3000,Male,GM1525,Teylingen,2021JJ00,2021,18844,,199,,174,,25,947,,92,855,904,,90,-16,814,43,66,,18910
193436,3000,Male,GM1525,Teylingen,2022JJ00,2022,18910,,201,,179,,22,1081,,164,917,853,,95,-3,758,228,250,,19160
193437,3000,Male,GM1525,Teylingen,2023JJ00,2023,19160,,200,,176,,24,954,,152,802,939,,109,-22,830,15,38,,19198
193508,3000,Male,GM0716,Tholen,2012JJ00,2012,12796,,141,,123,,18,298,,30,268,366,,44,-10,322,-68,-51,,12745
193509,3000,Male,GM0716,Tholen,2013JJ00,2013,12745,,142,,134,,8,301,,30,271,373,,34,-8,339,-72,-63,,12682
193510,3000,Male,GM0716,Tholen,2014JJ00,2014,12682,,144,,114,,30,345,,34,311,374,,43,-3,331,-29,1,,12683
193511,3000,Male,GM0716,Tholen,2015JJ00,2015,12683,,138,,112,,26,366,,52,314,387,,48,-10,339,-21,5,,12688
193512,3000,Male,GM0716,Tholen,2016JJ00,2016,12688,,142,,92,,50,424,,59,365,415,,39,-2,376,9,60,,12748
193513,3000,Male,GM0716,Tholen,2017JJ00,2017,12748,,154,,101,,53,429,,48,381,444,,53,-8,391,-15,39,,12787
193514,3000,Male,GM0716,Tholen,2018JJ00,2018,12787,,162,,110,,52,511,,58,453,466,,44,-5,422,45,96,,12883
193515,3000,Male,GM0716,Tholen,2019JJ00,2019,12883,,159,,98,,61,470,,66,404,526,,53,-4,473,-56,4,,12887
193516,3000,Male,GM0716,Tholen,2020JJ00,2020,12887,,156,,136,,20,584,,72,512,422,,32,-4,390,162,182,,13069
193517,3000,Male,GM0716,Tholen,2021JJ00,2021,13069,,167,,130,,37,572,,42,530,485,,42,-6,443,87,125,,13194
193518,3000,Male,GM0716,Tholen,2022JJ00,2022,13194,,169,,106,,63,606,,180,426,469,,73,-2,396,137,200,,13394
193519,3000,Male,GM0716,Tholen,2023JJ00,2023,13394,,141,,122,,19,526,,94,432,510,,96,-14,414,16,34,,13428
193672,3000,Male,GM0281,Tiel,2012JJ00,2012,20622,,233,,146,,87,763,,79,684,698,,93,-17,605,65,153,,20775
193673,3000,Male,GM0281,Tiel,2013JJ00,2013,20775,,218,,156,,62,727,,97,630,804,,121,-34,683,-77,-17,,20758
193674,3000,Male,GM0281,Tiel,2014JJ00,2014,20771,,229,,135,,94,698,,96,602,871,,77,14,794,-173,-79,,20692
193675,3000,Male,GM0281,Tiel,2015JJ00,2015,20692,,205,,163,,42,784,,103,681,862,,117,-12,745,-78,-36,,20656
193676,3000,Male,GM0281,Tiel,2016JJ00,2016,20656,,206,,178,,28,903,,120,783,941,,71,5,870,-38,-11,,20645
193677,3000,Male,GM0281,Tiel,2017JJ00,2017,20645,,197,,155,,42,955,,133,822,1005,,107,-16,898,-50,-10,,20635
193678,3000,Male,GM0281,Tiel,2018JJ00,2018,20635,,210,,167,,43,1282,,524,758,1043,,141,-44,902,239,279,,20914
193679,3000,Male,GM0281,Tiel,2019JJ00,2019,20914,,179,,160,,19,1215,,404,811,1141,,287,-97,854,74,93,,21007
193680,3000,Male,GM0281,Tiel,2020JJ00,2020,21007,,200,,195,,5,1364,,508,856,1442,,511,-140,931,-78,-73,,20934
193681,3000,Male,GM0281,Tiel,2021JJ00,2021,20934,,217,,240,,-23,1481,,532,949,1223,,384,-57,839,258,234,,21168
193682,3000,Male,GM0281,Tiel,2022JJ00,2022,21168,,199,,186,,13,1479,,642,837,1305,,413,-99,892,174,188,,21356
193683,3000,Male,GM0281,Tiel,2023JJ00,2023,21356,,195,,204,,-9,1341,,397,944,1499,,594,-350,905,-158,-165,,21191
194000,3000,Male,GM0855,Tilburg,2012JJ00,2012,103015,,1162,,780,,382,5210,,1334,3876,4921,,1103,-158,3818,289,667,,103682
194001,3000,Male,GM0855,Tilburg,2013JJ00,2013,103682,,1104,,790,,314,5611,,1454,4157,5015,,995,26,4020,596,914,,104596
194002,3000,Male,GM0855,Tilburg,2014JJ00,2014,104596,,1134,,823,,311,5899,,1535,4364,5621,,1501,-499,4120,278,583,,105179
194003,3000,Male,GM0855,Tilburg,2015JJ00,2015,105179,,1110,,834,,276,6137,,1726,4411,5575,,1419,-393,4156,562,829,,106008
194004,3000,Male,GM0855,Tilburg,2016JJ00,2016,106008,,1135,,891,,244,6472,,1946,4526,6288,,1550,-489,4738,184,420,,106428
194005,3000,Male,GM0855,Tilburg,2017JJ00,2017,106428,,1063,,922,,141,6780,,2087,4693,5837,,1145,-37,4692,943,1069,,107497
194006,3000,Male,GM0855,Tilburg,2018JJ00,2018,107461,,1049,,918,,131,6741,,2268,4473,6059,,1602,-453,4457,682,822,,108283
194007,3000,Male,GM0855,Tilburg,2019JJ00,2019,108283,,1030,,856,,174,6946,,2589,4357,5918,,1529,-285,4389,1028,1204,,109487
194008,3000,Male,GM0855,Tilburg,2020JJ00,2020,109487,,1014,,1139,,-125,6918,,2312,4606,6422,,1759,-527,4663,496,379,,109866
194009,3000,Male,GM0855,Tilburg,2021JJ00,2021,110690,,1189,,1060,,129,7041,,2425,4616,5966,,1508,-300,4458,1075,1197,,111887
194010,3000,Male,GM0855,Tilburg,2022JJ00,2022,111887,,1077,,1057,,20,7840,,3005,4835,6238,,1691,-343,4547,1602,1622,,113509
194011,3000,Male,GM0855,Tilburg,2023JJ00,2023,113509,,1050,,1064,,-14,7624,,2734,4890,6539,,2022,-535,4517,1085,1065,,114574
194082,3000,Male,GM0183,Tubbergen,2012JJ00,2012,10780,,112,,89,,23,226,,34,192,242,,22,-7,220,-16,7,,10787
194083,3000,Male,GM0183,Tubbergen,2013JJ00,2013,10787,,107,,83,,24,229,,19,210,235,,23,-4,212,-6,18,,10805
194084,3000,Male,GM0183,Tubbergen,2014JJ00,2014,10805,,91,,100,,-9,263,,39,224,274,,31,-12,243,-11,-22,,10783
194085,3000,Male,GM0183,Tubbergen,2015JJ00,2015,10783,,111,,83,,28,221,,20,201,261,,11,-1,250,-40,-12,,10771
194086,3000,Male,GM0183,Tubbergen,2016JJ00,2016,10771,,98,,85,,13,296,,19,277,283,,25,-4,258,13,26,,10797
194087,3000,Male,GM0183,Tubbergen,2017JJ00,2017,10797,,95,,80,,15,322,,18,304,329,,17,-2,312,-7,7,,10804
194088,3000,Male,GM0183,Tubbergen,2018JJ00,2018,10804,,102,,104,,-2,329,,31,298,263,,15,-4,248,66,64,,10868
194089,3000,Male,GM0183,Tubbergen,2019JJ00,2019,10868,,116,,95,,21,294,,35,259,310,,29,-7,281,-16,5,,10873
194090,3000,Male,GM0183,Tubbergen,2020JJ00,2020,10873,,95,,102,,-7,323,,19,304,295,,26,-7,269,28,21,,10894
194091,3000,Male,GM0183,Tubbergen,2021JJ00,2021,10894,,109,,102,,7,337,,37,300,268,,19,-9,249,69,76,,10970
194092,3000,Male,GM0183,Tubbergen,2022JJ00,2022,10970,,95,,121,,-26,302,,78,224,276,,40,-8,236,26,0,,10970
194093,3000,Male,GM0183,Tubbergen,2023JJ00,2023,10970,,117,,93,,24,314,,42,272,331,,42,-14,289,-17,10,,10980
194328,3000,Male,GM1700,Twenterand,2012JJ00,2012,17193,,207,,133,,74,360,,30,330,402,,18,0,384,-42,32,,17225
194329,3000,Male,GM1700,Twenterand,2013JJ00,2013,17225,,188,,127,,61,366,,27,339,461,,25,-1,436,-95,-31,,17194
194330,3000,Male,GM1700,Twenterand,2014JJ00,2014,17194,,180,,140,,40,380,,25,355,484,,42,-4,442,-104,-63,,17131
194331,3000,Male,GM1700,Twenterand,2015JJ00,2015,17131,,196,,131,,65,372,,31,341,442,,25,0,417,-70,-8,,17123
194332,3000,Male,GM1700,Twenterand,2016JJ00,2016,17123,,175,,159,,16,416,,31,385,409,,20,0,389,7,23,,17146
194333,3000,Male,GM1700,Twenterand,2017JJ00,2017,17146,,179,,137,,42,459,,25,434,460,,26,1,434,-1,43,,17189
194334,3000,Male,GM1700,Twenterand,2018JJ00,2018,17189,,164,,146,,18,453,,32,421,500,,18,-1,482,-47,-28,,17161
194335,3000,Male,GM1700,Twenterand,2019JJ00,2019,17161,,154,,145,,9,432,,31,401,481,,25,0,456,-49,-42,,17119
194336,3000,Male,GM1700,Twenterand,2020JJ00,2020,17119,,150,,167,,-17,455,,21,434,445,,22,-5,423,10,-7,,17112
194337,3000,Male,GM1700,Twenterand,2021JJ00,2021,17112,,157,,175,,-18,452,,22,430,441,,17,1,424,11,-6,,17106
194338,3000,Male,GM1700,Twenterand,2022JJ00,2022,17106,,164,,183,,-19,494,,101,393,424,,38,2,386,70,48,,17154
194339,3000,Male,GM1700,Twenterand,2023JJ00,2023,17154,,178,,156,,22,555,,72,483,457,,28,-5,429,98,120,,17274
194492,3000,Male,GM1730,Tynaarlo,2012JJ00,2012,15911,,150,,169,,-19,821,,37,784,779,,17,5,762,42,23,,15934
194493,3000,Male,GM1730,Tynaarlo,2013JJ00,2013,15934,,132,,164,,-32,883,,52,831,780,,16,9,764,103,71,,16005
194494,3000,Male,GM1730,Tynaarlo,2014JJ00,2014,16005,,150,,151,,-1,874,,48,826,842,,36,-1,806,32,31,,16036
194495,3000,Male,GM1730,Tynaarlo,2015JJ00,2015,16036,,138,,183,,-45,1004,,43,961,866,,43,0,823,138,94,,16130
194496,3000,Male,GM1730,Tynaarlo,2016JJ00,2016,16130,,149,,167,,-18,1125,,57,1068,839,,31,8,808,286,266,,16396
194497,3000,Male,GM1730,Tynaarlo,2017JJ00,2017,16396,,140,,219,,-79,1120,,42,1078,1026,,30,-5,996,94,17,,16413
194498,3000,Male,GM1730,Tynaarlo,2018JJ00,2018,16413,,157,,218,,-61,1174,,58,1116,973,,38,0,935,201,140,,16553
194499,3000,Male,GM1730,Tynaarlo,2019JJ00,2019,16553,,163,,174,,-11,1145,,48,1097,993,,43,0,950,152,141,,16694
194500,3000,Male,GM1730,Tynaarlo,2020JJ00,2020,16694,,141,,233,,-92,1117,,60,1057,970,,20,1,950,147,54,,16748
194501,3000,Male,GM1730,Tynaarlo,2021JJ00,2021,16748,,137,,209,,-72,1156,,50,1106,960,,39,-3,921,196,125,,16873
194502,3000,Male,GM1730,Tynaarlo,2022JJ00,2022,16873,,152,,212,,-60,1303,,114,1189,1089,,52,-3,1037,214,154,,17027
194503,3000,Male,GM1730,Tynaarlo,2023JJ00,2023,17027,,142,,205,,-63,1230,,54,1176,1049,,77,-15,972,181,119,,17146
194574,3000,Male,GM0737,Tytsjerksteradiel,2012JJ00,2012,16037,,176,,151,,25,640,,119,521,739,,90,12,649,-99,-74,,15963
194575,3000,Male,GM0737,Tytsjerksteradiel,2013JJ00,2013,15963,,149,,162,,-13,654,,64,590,657,,44,-6,613,-3,-14,,15949
194576,3000,Male,GM0737,Tytsjerksteradiel,2014JJ00,2014,15949,,145,,150,,-5,695,,71,624,694,,45,-11,649,1,-3,,15946
194577,3000,Male,GM0737,Tytsjerksteradiel,2015JJ00,2015,15946,,138,,157,,-19,703,,49,654,658,,35,10,623,45,27,,15973
194578,3000,Male,GM0737,Tytsjerksteradiel,2016JJ00,2016,15973,,132,,146,,-14,734,,64,670,732,,27,12,705,2,-12,,15961
194579,3000,Male,GM0737,Tytsjerksteradiel,2017JJ00,2017,15961,,136,,148,,-12,787,,49,738,819,,75,-39,744,-32,-42,,15919
194580,3000,Male,GM0737,Tytsjerksteradiel,2018JJ00,2018,15919,,145,,162,,-17,741,,51,690,741,,39,-21,702,0,-19,,15900
194581,3000,Male,GM0737,Tytsjerksteradiel,2019JJ00,2019,15900,,152,,159,,-7,769,,70,699,622,,31,-12,591,147,140,,16040
194582,3000,Male,GM0737,Tytsjerksteradiel,2020JJ00,2020,16040,,134,,170,,-36,737,,52,685,673,,34,2,639,64,29,,16069
194583,3000,Male,GM0737,Tytsjerksteradiel,2021JJ00,2021,16069,,191,,217,,-26,795,,33,762,723,,49,-22,674,72,44,,16113
194584,3000,Male,GM0737,Tytsjerksteradiel,2022JJ00,2022,16113,,133,,193,,-60,849,,126,723,721,,63,-11,658,128,70,,16183
194585,3000,Male,GM0737,Tytsjerksteradiel,2023JJ00,2023,16183,,159,,204,,-45,865,,80,785,736,,73,-34,663,129,81,,16264
194738,3000,Male,GM0282,Ubbergen,2012JJ00,2012,4624,,35,,49,,-14,287,,19,268,195,,21,0,174,92,77,,4701
194739,3000,Male,GM0282,Ubbergen,2013JJ00,2013,4701,,34,,52,,-18,254,,28,226,245,,25,-8,220,9,-7,,4694
194740,3000,Male,GM0282,Ubbergen,2014JJ00,2014,4694,,42,,58,,-16,246,,23,223,232,,23,0,209,14,-3,,4691
194820,3000,Male,GM0856,Uden,2012JJ00,2012,20243,,192,,146,,46,623,,92,531,616,,69,-6,547,7,52,,20295
194821,3000,Male,GM0856,Uden,2013JJ00,2013,20295,,176,,147,,29,599,,98,501,651,,106,-25,545,-52,-21,,20274
194822,3000,Male,GM0856,Uden,2014JJ00,2014,20274,,213,,156,,57,691,,103,588,677,,105,-6,572,14,72,,20346
194823,3000,Male,GM0856,Uden,2015JJ00,2015,20346,,231,,159,,72,768,,111,657,730,,124,-28,606,38,110,,20456
194824,3000,Male,GM0856,Uden,2016JJ00,2016,20456,,207,,177,,30,811,,127,684,779,,96,-18,683,32,61,,20517
194825,3000,Male,GM0856,Uden,2017JJ00,2017,20517,,200,,178,,22,871,,127,744,741,,82,2,659,130,146,,20663
194826,3000,Male,GM0856,Uden,2018JJ00,2018,20663,,194,,176,,18,908,,167,741,877,,123,-30,754,31,52,,20715
194827,3000,Male,GM0856,Uden,2019JJ00,2019,20715,,220,,196,,24,999,,194,805,829,,116,-30,713,170,196,,20911
194828,3000,Male,GM0856,Uden,2020JJ00,2020,20911,,212,,258,,-46,973,,176,797,853,,91,-7,762,120,75,,20986
194829,3000,Male,GM0856,Uden,2021JJ00,2021,20986,,239,,218,,21,886,,152,734,818,,153,-51,665,68,97,,21083
194984,3000,Male,GM0450,Uitgeest,2012JJ00,2012,6472,,67,,38,,29,274,,11,263,216,,19,-7,197,58,86,,6558
194985,3000,Male,GM0450,Uitgeest,2013JJ00,2013,6558,,76,,44,,32,260,,21,239,224,,17,-7,207,36,66,,6624
194986,3000,Male,GM0450,Uitgeest,2014JJ00,2014,6624,,87,,32,,55,236,,16,220,253,,8,2,245,-17,37,,6661
194987,3000,Male,GM0450,Uitgeest,2015JJ00,2015,6661,,74,,37,,37,267,,15,252,253,,13,-2,240,14,52,,6713
194988,3000,Male,GM0450,Uitgeest,2016JJ00,2016,6713,,77,,37,,40,309,,29,280,298,,15,0,283,11,48,,6761
194989,3000,Male,GM0450,Uitgeest,2017JJ00,2017,6761,,72,,50,,22,308,,25,283,291,,17,3,274,17,41,,6802
194990,3000,Male,GM0450,Uitgeest,2018JJ00,2018,6802,,69,,48,,21,274,,22,252,277,,23,-3,254,-3,18,,6820
194991,3000,Male,GM0450,Uitgeest,2019JJ00,2019,6820,,78,,32,,46,309,,20,289,286,,26,-7,260,23,71,,6891
194992,3000,Male,GM0450,Uitgeest,2020JJ00,2020,6891,,58,,59,,-1,297,,23,274,337,,16,0,321,-40,-42,,6849
194993,3000,Male,GM0450,Uitgeest,2021JJ00,2021,6849,,77,,62,,15,280,,26,254,340,,30,-1,310,-60,-44,,6805
194994,3000,Male,GM0450,Uitgeest,2022JJ00,2022,6805,,49,,45,,4,321,,28,293,387,,36,-5,351,-66,-64,,6741
194995,3000,Male,GM0450,Uitgeest,2023JJ00,2023,6741,,68,,63,,5,270,,28,242,315,,15,-3,300,-45,-40,,6701
195066,3000,Male,GM0451,Uithoorn,2012JJ00,2012,13973,,130,,115,,15,612,,97,515,629,,98,-27,531,-17,0,,13973
195067,3000,Male,GM0451,Uithoorn,2013JJ00,2013,13973,,128,,101,,27,588,,87,501,569,,93,-38,476,19,46,,14019
195068,3000,Male,GM0451,Uithoorn,2014JJ00,2014,14019,,124,,93,,31,770,,127,643,635,,103,-29,532,135,167,,14186
195069,3000,Male,GM0451,Uithoorn,2015JJ00,2015,14186,,149,,127,,22,946,,148,798,771,,136,-46,635,175,199,,14385
195070,3000,Male,GM0451,Uithoorn,2016JJ00,2016,14385,,149,,100,,49,780,,110,670,811,,132,-41,679,-31,18,,14403
195071,3000,Male,GM0451,Uithoorn,2017JJ00,2017,14403,,142,,122,,20,959,,132,827,855,,79,4,776,104,125,,14528
195072,3000,Male,GM0451,Uithoorn,2018JJ00,2018,14528,,149,,123,,26,821,,130,691,866,,106,-15,760,-45,-19,,14509
195073,3000,Male,GM0451,Uithoorn,2019JJ00,2019,14509,,119,,110,,9,930,,180,750,938,,169,-40,769,-8,4,,14513
195074,3000,Male,GM0451,Uithoorn,2020JJ00,2020,14513,,154,,116,,38,1182,,122,1060,890,,116,-20,774,292,330,,14843
195075,3000,Male,GM0451,Uithoorn,2021JJ00,2021,14843,,184,,118,,66,1202,,177,1025,860,,133,-14,727,342,407,,15250
195076,3000,Male,GM0451,Uithoorn,2022JJ00,2022,15250,,163,,119,,44,1063,,236,827,916,,148,-21,768,147,190,,15440
195077,3000,Male,GM0451,Uithoorn,2023JJ00,2023,15440,,145,,116,,29,1020,,212,808,931,,162,-26,769,89,116,,15556
195476,3000,Male,GM0184,Urk,2012JJ00,2012,9588,,200,,32,,168,97,,13,84,104,,15,-4,89,-7,161,,9749
195477,3000,Male,GM0184,Urk,2013JJ00,2013,9749,,187,,51,,136,109,,18,91,153,,17,-3,136,-44,92,,9841
195478,3000,Male,GM0184,Urk,2014JJ00,2014,9841,,196,,63,,133,119,,10,109,122,,10,0,112,-3,130,,9971
195479,3000,Male,GM0184,Urk,2015JJ00,2015,9971,,197,,51,,146,153,,18,135,185,,12,-1,173,-32,114,,10085
195480,3000,Male,GM0184,Urk,2016JJ00,2016,10085,,191,,48,,143,155,,16,139,191,,22,-4,169,-36,107,,10192
195481,3000,Male,GM0184,Urk,2017JJ00,2017,10192,,224,,40,,184,163,,27,136,170,,7,-2,163,-7,176,,10368
195482,3000,Male,GM0184,Urk,2018JJ00,2018,10368,,199,,55,,144,172,,25,147,172,,8,3,164,0,144,,10512
195483,3000,Male,GM0184,Urk,2019JJ00,2019,10520,,195,,45,,150,191,,48,143,197,,39,-10,158,-6,144,,10664
195484,3000,Male,GM0184,Urk,2020JJ00,2020,10664,,188,,74,,114,205,,53,152,219,,19,-1,200,-14,100,,10764
195485,3000,Male,GM0184,Urk,2021JJ00,2021,10764,,213,,64,,149,180,,35,145,213,,31,-5,182,-33,116,,10880
195486,3000,Male,GM0184,Urk,2022JJ00,2022,10880,,214,,52,,162,281,,142,139,255,,40,-12,215,26,192,,11072
195487,3000,Male,GM0184,Urk,2023JJ00,2023,11072,,191,,55,,136,139,,42,97,228,,23,-10,205,-89,45,,11117
195886,3000,Male,GM0344,Utrecht Municipality,2012JJ00,2012,153282,,2646,,856,,1790,11047,,2185,8862,9904,,2272,-342,7632,1143,2941,,156223
195887,3000,Male,GM0344,Utrecht Municipality,2013JJ00,2013,156223,,2521,,934,,1587,11487,,2257,9230,10010,,2294,-259,7716,1477,3082,,159305
195888,3000,Male,GM0344,Utrecht Municipality,2014JJ00,2014,159305,,2649,,838,,1811,12483,,2407,10076,11052,,2268,-118,8784,1431,3251,,162556
195889,3000,Male,GM0344,Utrecht Municipality,2015JJ00,2015,162556,,2522,,879,,1643,13212,,2708,10504,12052,,2318,-331,9734,1160,2803,,165359
195890,3000,Male,GM0344,Utrecht Municipality,2016JJ00,2016,165359,,2521,,882,,1639,13230,,3002,10228,12658,,2049,-212,10609,572,2228,,167587
195891,3000,Male,GM0344,Utrecht Municipality,2017JJ00,2017,167587,,2374,,900,,1474,13415,,3059,10356,12497,,2225,-276,10272,918,2387,,169974
195892,3000,Male,GM0344,Utrecht Municipality,2018JJ00,2018,169974,,2501,,920,,1581,13827,,3450,10377,12532,,2308,-149,10224,1295,2883,,172857
195893,3000,Male,GM0344,Utrecht Municipality,2019JJ00,2019,172857,,2431,,945,,1486,14418,,3970,10448,13350,,2729,-276,10621,1068,2538,,175395
195894,3000,Male,GM0344,Utrecht Municipality,2020JJ00,2020,175395,,2476,,1005,,1471,13552,,3197,10355,13857,,2458,-5,11399,-305,1159,,176554
195895,3000,Male,GM0344,Utrecht Municipality,2021JJ00,2021,176554,,2514,,1019,,1495,14178,,3717,10461,14774,,2303,-216,12471,-596,891,,177445
195896,3000,Male,GM0344,Utrecht Municipality,2022JJ00,2022,177445,,2181,,1011,,1170,15946,,4915,11031,14211,,2292,-56,11919,1735,2890,,180335
195897,3000,Male,GM0344,Utrecht Municipality,2023JJ00,2023,180335,,2097,,1102,,995,15969,,4318,11651,14489,,2558,-345,11931,1480,2464,,182799
195968,3000,Male,GM1581,Utrechtse Heuvelrug,2012JJ00,2012,23301,,182,,236,,-54,1369,,324,1045,1387,,94,-32,1293,-18,-72,,23229
195969,3000,Male,GM1581,Utrechtse Heuvelrug,2013JJ00,2013,23229,,179,,256,,-77,1542,,396,1146,1464,,95,-5,1369,78,5,,23234
195970,3000,Male,GM1581,Utrechtse Heuvelrug,2014JJ00,2014,23234,,174,,242,,-68,1922,,529,1393,1650,,123,-21,1527,272,205,,23439
195971,3000,Male,GM1581,Utrechtse Heuvelrug,2015JJ00,2015,23439,,205,,265,,-60,2285,,678,1607,2006,,114,-8,1892,279,222,,23661
195972,3000,Male,GM1581,Utrechtse Heuvelrug,2016JJ00,2016,23661,,199,,249,,-50,2430,,530,1900,2068,,105,-2,1963,362,309,,23970
195973,3000,Male,GM1581,Utrechtse Heuvelrug,2017JJ00,2017,23970,,215,,266,,-51,1908,,126,1782,1781,,112,-16,1669,127,75,,24045
195974,3000,Male,GM1581,Utrechtse Heuvelrug,2018JJ00,2018,24045,,227,,229,,-2,1813,,152,1661,1650,,99,-11,1551,163,161,,24206
195975,3000,Male,GM1581,Utrechtse Heuvelrug,2019JJ00,2019,24206,,189,,278,,-89,1825,,156,1669,1638,,120,-21,1518,187,95,,24301
195976,3000,Male,GM1581,Utrechtse Heuvelrug,2020JJ00,2020,24301,,200,,280,,-80,1907,,138,1769,1596,,121,-21,1475,311,233,,24534
195977,3000,Male,GM1581,Utrechtse Heuvelrug,2021JJ00,2021,24534,,242,,304,,-62,1759,,131,1628,1751,,130,-59,1621,8,-55,,24479
195978,3000,Male,GM1581,Utrechtse Heuvelrug,2022JJ00,2022,24479,,184,,297,,-113,1874,,243,1631,1571,,114,11,1457,303,189,,24668
195979,3000,Male,GM1581,Utrechtse Heuvelrug,2023JJ00,2023,24668,,182,,305,,-123,1891,,151,1740,1712,,165,-28,1547,179,55,,24723
196050,3000,Male,GM0981,Vaals,2012JJ00,2012,4805,,32,,49,,-17,348,,176,172,305,,139,-43,166,43,29,,4834
196051,3000,Male,GM0981,Vaals,2013JJ00,2013,4834,,27,,54,,-27,283,,136,147,312,,167,-24,145,-29,-55,,4779
196052,3000,Male,GM0981,Vaals,2014JJ00,2014,4779,,26,,54,,-28,326,,164,162,296,,157,-36,139,30,3,,4782
196053,3000,Male,GM0981,Vaals,2015JJ00,2015,4782,,27,,69,,-42,312,,159,153,283,,134,-20,149,29,-12,,4770
196054,3000,Male,GM0981,Vaals,2016JJ00,2016,4770,,33,,63,,-30,421,,224,197,286,,134,-21,152,135,105,,4875
196055,3000,Male,GM0981,Vaals,2017JJ00,2017,4875,,25,,53,,-28,493,,327,166,347,,200,-51,147,146,118,,4993
196056,3000,Male,GM0981,Vaals,2018JJ00,2018,4993,,39,,61,,-22,545,,393,152,314,,178,-39,136,231,210,,5203
196057,3000,Male,GM0981,Vaals,2019JJ00,2019,5203,,23,,59,,-36,409,,254,155,387,,233,-25,154,22,-19,,5184
196058,3000,Male,GM0981,Vaals,2020JJ00,2020,5184,,24,,70,,-46,396,,213,183,371,,227,-11,144,25,-21,,5163
196059,3000,Male,GM0981,Vaals,2021JJ00,2021,5163,,29,,70,,-41,437,,247,190,357,,215,-24,142,80,42,,5205
196060,3000,Male,GM0981,Vaals,2022JJ00,2022,5205,,16,,77,,-61,435,,284,151,401,,202,-2,199,34,-26,,5179
196061,3000,Male,GM0981,Vaals,2023JJ00,2023,5179,,30,,61,,-31,422,,233,189,407,,241,-27,166,15,-15,,5164
196296,3000,Male,GM0994,Valkenburg aan de Geul,2012JJ00,2012,8374,,60,,105,,-45,375,,47,328,371,,51,-2,320,4,-45,,8329
196297,3000,Male,GM0994,Valkenburg aan de Geul,2013JJ00,2013,8329,,39,,117,,-78,375,,51,324,392,,52,0,340,-17,-96,,8233
196298,3000,Male,GM0994,Valkenburg aan de Geul,2014JJ00,2014,8233,,60,,99,,-39,439,,51,388,421,,61,-15,360,18,-21,,8212
196299,3000,Male,GM0994,Valkenburg aan de Geul,2015JJ00,2015,8212,,48,,126,,-78,493,,54,439,457,,52,-14,405,36,-42,,8170
196300,3000,Male,GM0994,Valkenburg aan de Geul,2016JJ00,2016,8170,,52,,100,,-48,457,,41,416,477,,50,1,427,-20,-66,,8104
196301,3000,Male,GM0994,Valkenburg aan de Geul,2017JJ00,2017,8104,,54,,106,,-52,527,,70,457,445,,35,6,410,82,32,,8136
196302,3000,Male,GM0994,Valkenburg aan de Geul,2018JJ00,2018,8136,,51,,105,,-54,495,,70,425,460,,51,0,409,35,-20,,8116
196303,3000,Male,GM0994,Valkenburg aan de Geul,2019JJ00,2019,8116,,51,,112,,-61,500,,75,425,506,,57,-6,449,-6,-67,,8049
196304,3000,Male,GM0994,Valkenburg aan de Geul,2020JJ00,2020,8049,,61,,103,,-42,552,,75,477,493,,45,-2,448,59,17,,8066
196305,3000,Male,GM0994,Valkenburg aan de Geul,2021JJ00,2021,8066,,50,,122,,-72,514,,69,445,525,,60,-16,465,-11,-86,,7980
196306,3000,Male,GM0994,Valkenburg aan de Geul,2022JJ00,2022,7980,,63,,99,,-36,648,,183,465,493,,73,-8,420,155,114,,8094
196307,3000,Male,GM0994,Valkenburg aan de Geul,2023JJ00,2023,8094,,47,,118,,-71,558,,121,437,486,,82,-16,404,72,3,,8097
196542,3000,Male,GM0858,Valkenswaard,2012JJ00,2012,15150,,135,,147,,-12,526,,101,425,540,,107,-28,433,-14,-27,,15123
196543,3000,Male,GM0858,Valkenswaard,2013JJ00,2013,15123,,107,,159,,-52,469,,73,396,554,,77,0,477,-85,-136,,14987
196544,3000,Male,GM0858,Valkenswaard,2014JJ00,2014,14987,,122,,147,,-25,553,,124,429,615,,136,-19,479,-62,-85,,14902
196545,3000,Male,GM0858,Valkenswaard,2015JJ00,2015,14902,,131,,163,,-32,599,,102,497,514,,99,-13,415,85,53,,14955
196546,3000,Male,GM0858,Valkenswaard,2016JJ00,2016,14955,,126,,135,,-9,820,,146,674,673,,89,-21,584,147,137,,15092
196547,3000,Male,GM0858,Valkenswaard,2017JJ00,2017,15092,,136,,168,,-32,695,,106,589,587,,65,6,522,108,73,,15165
196548,3000,Male,GM0858,Valkenswaard,2018JJ00,2018,15165,,134,,184,,-50,725,,113,612,543,,91,-6,452,182,129,,15294
196549,3000,Male,GM0858,Valkenswaard,2019JJ00,2019,15294,,124,,168,,-44,750,,124,626,504,,68,-4,436,246,202,,15496
196550,3000,Male,GM0858,Valkenswaard,2020JJ00,2020,15496,,131,,207,,-76,688,,112,576,622,,91,-4,531,66,-13,,15483
196551,3000,Male,GM0858,Valkenswaard,2021JJ00,2021,15483,,131,,201,,-70,758,,126,632,667,,124,-17,543,91,22,,15505
196552,3000,Male,GM0858,Valkenswaard,2022JJ00,2022,15505,,144,,206,,-62,820,,217,603,646,,166,-26,480,174,113,,15618
196553,3000,Male,GM0858,Valkenswaard,2023JJ00,2023,15618,,160,,181,,-21,843,,162,681,694,,129,-23,565,149,127,,15745
196788,3000,Male,GM0047,Veendam,2012JJ00,2012,13808,,137,,160,,-23,527,,39,488,496,,33,3,463,31,10,,13818
196789,3000,Male,GM0047,Veendam,2013JJ00,2013,13818,,127,,144,,-17,508,,33,475,541,,57,-9,484,-33,-49,,13769
196790,3000,Male,GM0047,Veendam,2014JJ00,2014,13769,,110,,139,,-29,556,,50,506,554,,36,-5,518,2,-28,,13741
196791,3000,Male,GM0047,Veendam,2015JJ00,2015,13741,,123,,152,,-29,548,,31,517,619,,83,-26,536,-71,-100,,13641
196792,3000,Male,GM0047,Veendam,2016JJ00,2016,13641,,123,,172,,-49,658,,46,612,623,,60,-18,563,35,-14,,13627
196793,3000,Male,GM0047,Veendam,2017JJ00,2017,13627,,103,,146,,-43,728,,46,682,644,,22,11,622,84,40,,13667
196794,3000,Male,GM0047,Veendam,2018JJ00,2018,13667,,106,,134,,-28,702,,51,651,656,,36,1,620,46,18,,13685
196795,3000,Male,GM0047,Veendam,2019JJ00,2019,13685,,109,,147,,-38,719,,61,658,735,,49,-11,686,-16,-56,,13629
196796,3000,Male,GM0047,Veendam,2020JJ00,2020,13629,,129,,152,,-23,710,,51,659,617,,41,-4,576,93,71,,13700
196797,3000,Male,GM0047,Veendam,2021JJ00,2021,13700,,105,,166,,-61,743,,54,689,644,,52,-11,592,99,37,,13737
196798,3000,Male,GM0047,Veendam,2022JJ00,2022,13737,,119,,135,,-16,726,,94,632,584,,47,-6,537,142,126,,13863
196799,3000,Male,GM0047,Veendam,2023JJ00,2023,13863,,101,,156,,-55,623,,60,563,622,,66,-19,556,1,-55,,13808
196870,3000,Male,GM0345,Veenendaal,2012JJ00,2012,30857,,359,,238,,121,1024,,118,906,1048,,128,-10,920,-24,97,,30954
196871,3000,Male,GM0345,Veenendaal,2013JJ00,2013,30954,,386,,189,,197,959,,109,850,1059,,110,-31,949,-100,99,,31053
196872,3000,Male,GM0345,Veenendaal,2014JJ00,2014,31053,,371,,201,,170,963,,93,870,1016,,152,-28,864,-53,120,,31173
196873,3000,Male,GM0345,Veenendaal,2015JJ00,2015,31173,,384,,237,,147,1131,,151,980,1022,,117,-12,905,109,257,,31430
196874,3000,Male,GM0345,Veenendaal,2016JJ00,2016,31430,,391,,228,,163,1276,,114,1162,1161,,127,-26,1034,115,278,,31708
196875,3000,Male,GM0345,Veenendaal,2017JJ00,2017,31708,,403,,243,,160,1396,,134,1262,1224,,113,-18,1111,172,332,,32040
196876,3000,Male,GM0345,Veenendaal,2018JJ00,2018,32040,,376,,245,,131,1289,,150,1139,1107,,93,-10,1014,182,311,,32351
196877,3000,Male,GM0345,Veenendaal,2019JJ00,2019,32351,,429,,216,,213,1467,,158,1309,1171,,95,-16,1076,296,507,,32858
196878,3000,Male,GM0345,Veenendaal,2020JJ00,2020,32858,,413,,278,,135,1395,,164,1231,1258,,103,-29,1155,137,270,,33128
196879,3000,Male,GM0345,Veenendaal,2021JJ00,2021,33128,,424,,296,,128,1535,,135,1400,1258,,146,-31,1112,277,401,,33529
196880,3000,Male,GM0345,Veenendaal,2022JJ00,2022,33529,,403,,278,,125,1425,,241,1184,1098,,125,-15,973,327,452,,33981
196881,3000,Male,GM0345,Veenendaal,2023JJ00,2023,33981,,432,,266,,166,1666,,216,1450,1289,,148,-46,1141,377,540,,34521
196952,3000,Male,GM0717,Veere,2012JJ00,2012,10994,,98,,108,,-10,416,,57,359,448,,50,-5,398,-32,-41,,10953
196953,3000,Male,GM0717,Veere,2013JJ00,2013,10953,,112,,93,,19,395,,48,347,435,,29,-1,406,-40,-21,,10932
196954,3000,Male,GM0717,Veere,2014JJ00,2014,10932,,115,,96,,19,416,,43,373,376,,30,-4,346,40,59,,10991
196955,3000,Male,GM0717,Veere,2015JJ00,2015,10991,,101,,113,,-12,468,,42,426,430,,31,-8,399,38,26,,11017
196956,3000,Male,GM0717,Veere,2016JJ00,2016,11017,,125,,117,,8,510,,61,449,518,,41,-6,477,-8,1,,11018
196957,3000,Male,GM0717,Veere,2017JJ00,2017,11018,,97,,116,,-19,470,,54,416,518,,49,-7,469,-48,-68,,10950
196958,3000,Male,GM0717,Veere,2018JJ00,2018,10950,,104,,119,,-15,453,,43,410,497,,53,-7,444,-44,-57,,10893
196959,3000,Male,GM0717,Veere,2019JJ00,2019,10893,,102,,114,,-12,479,,65,414,442,,41,-8,401,37,24,,10917
196960,3000,Male,GM0717,Veere,2020JJ00,2020,10917,,101,,115,,-14,524,,59,465,486,,27,1,459,38,25,,10942
196961,3000,Male,GM0717,Veere,2021JJ00,2021,10942,,104,,118,,-14,430,,50,380,470,,46,-7,424,-40,-54,,10888
196962,3000,Male,GM0717,Veere,2022JJ00,2022,10888,,100,,131,,-31,535,,146,389,451,,57,-13,394,84,54,,10942
196963,3000,Male,GM0717,Veere,2023JJ00,2023,10942,,87,,140,,-53,469,,83,386,448,,53,-12,395,21,-31,,10911
197034,3000,Male,GM0860,Veghel,2012JJ00,2012,18878,,188,,121,,67,583,,116,467,709,,130,-40,579,-126,-57,,18821
197035,3000,Male,GM0860,Veghel,2013JJ00,2013,18821,,184,,134,,50,698,,133,565,746,,132,-33,614,-48,2,,18823
197036,3000,Male,GM0860,Veghel,2014JJ00,2014,18823,,210,,152,,58,795,,228,567,737,,169,-58,568,58,117,,18940
197037,3000,Male,GM0860,Veghel,2015JJ00,2015,18940,,196,,149,,47,935,,207,728,756,,136,-45,620,179,225,,19165
197038,3000,Male,GM0860,Veghel,2016JJ00,2016,19165,,187,,143,,44,826,,178,648,772,,148,-38,624,54,78,,19243
197116,3000,Male,GM0861,Veldhoven,2012JJ00,2012,21879,,234,,170,,64,978,,186,792,905,,149,-12,756,73,133,,22012
197117,3000,Male,GM0861,Veldhoven,2013JJ00,2013,22012,,218,,145,,73,947,,188,759,1025,,176,-26,849,-78,-5,,22007
197118,3000,Male,GM0861,Veldhoven,2014JJ00,2014,22007,,208,,177,,31,959,,146,813,983,,156,-13,827,-24,5,,22012
197119,3000,Male,GM0861,Veldhoven,2015JJ00,2015,22012,,209,,191,,18,1080,,153,927,1029,,218,-31,811,51,69,,22081
197120,3000,Male,GM0861,Veldhoven,2016JJ00,2016,22081,,190,,202,,-12,1322,,165,1157,1098,,178,-17,920,224,204,,22285
197121,3000,Male,GM0861,Veldhoven,2017JJ00,2017,22285,,219,,191,,28,1319,,173,1146,1199,,135,-15,1064,120,144,,22429
197122,3000,Male,GM0861,Veldhoven,2018JJ00,2018,22429,,203,,172,,31,1313,,224,1089,1120,,143,-30,977,193,223,,22652
197123,3000,Male,GM0861,Veldhoven,2019JJ00,2019,22652,,206,,194,,12,1300,,242,1058,1204,,164,-16,1040,96,108,,22760
197124,3000,Male,GM0861,Veldhoven,2020JJ00,2020,22760,,196,,197,,-1,1255,,192,1063,1230,,149,-28,1081,25,22,,22782
197125,3000,Male,GM0861,Veldhoven,2021JJ00,2021,22782,,201,,231,,-30,1448,,242,1206,1251,,166,-35,1085,197,170,,22952
197126,3000,Male,GM0861,Veldhoven,2022JJ00,2022,22952,,188,,209,,-21,1786,,382,1404,1354,,187,-30,1167,432,411,,23363
197127,3000,Male,GM0861,Veldhoven,2023JJ00,2023,23363,,196,,201,,-5,1676,,299,1377,1446,,209,-27,1237,230,219,,23582
197362,3000,Male,GM0453,Velsen,2012JJ00,2012,33290,,311,,307,,4,1231,,193,1038,1241,,190,-47,1051,-10,-7,,33283
197363,3000,Male,GM0453,Velsen,2013JJ00,2013,33283,,318,,331,,-13,1324,,199,1125,1257,,184,-41,1073,67,56,,33339
197364,3000,Male,GM0453,Velsen,2014JJ00,2014,33339,,272,,324,,-52,1413,,219,1194,1432,,224,-72,1208,-19,-72,,33267
197365,3000,Male,GM0453,Velsen,2015JJ00,2015,33267,,332,,312,,20,1619,,268,1351,1464,,214,-51,1250,155,177,,33444
197366,3000,Male,GM0453,Velsen,2016JJ00,2016,33444,,313,,323,,-10,1572,,225,1347,1467,,217,-67,1250,105,97,,33541
197367,3000,Male,GM0453,Velsen,2017JJ00,2017,33541,,306,,301,,5,1666,,211,1455,1547,,197,-43,1350,119,128,,33669
197368,3000,Male,GM0453,Velsen,2018JJ00,2018,33669,,290,,324,,-34,1646,,297,1349,1373,,222,-45,1151,273,243,,33912
197369,3000,Male,GM0453,Velsen,2019JJ00,2019,33912,,313,,341,,-28,1781,,284,1497,1577,,253,-80,1324,204,178,,34090
197370,3000,Male,GM0453,Velsen,2020JJ00,2020,34090,,326,,368,,-42,1662,,235,1427,1607,,211,-55,1396,55,9,,34099
197371,3000,Male,GM0453,Velsen,2021JJ00,2021,34099,,313,,381,,-68,1562,,198,1364,1656,,198,-39,1458,-94,-161,,33938
197372,3000,Male,GM0453,Velsen,2022JJ00,2022,33938,,314,,367,,-53,1790,,439,1351,1565,,221,-29,1344,225,169,,34107
197373,3000,Male,GM0453,Velsen,2023JJ00,2023,34107,,307,,395,,-88,2239,,426,1813,1856,,285,-73,1571,383,298,,34405
197526,3000,Male,GM0983,Venlo,2012JJ00,2012,49599,,489,,474,,15,1703,,610,1093,1609,,407,-87,1202,94,109,,49708
197527,3000,Male,GM0983,Venlo,2013JJ00,2013,49708,,498,,405,,93,1726,,655,1071,1638,,405,-82,1233,88,181,,49889
197528,3000,Male,GM0983,Venlo,2014JJ00,2014,49889,,475,,419,,56,1896,,802,1094,1868,,433,-69,1435,28,89,,49978
197529,3000,Male,GM0983,Venlo,2015JJ00,2015,49978,,428,,485,,-57,1857,,591,1266,1934,,593,-245,1341,-77,-136,,49842
197530,3000,Male,GM0983,Venlo,2016JJ00,2016,49842,,484,,454,,30,2235,,854,1381,1827,,397,-74,1430,408,439,,50281
197531,3000,Male,GM0983,Venlo,2017JJ00,2017,50281,,492,,495,,-3,2049,,704,1345,1974,,503,-143,1471,75,69,,50350
197532,3000,Male,GM0983,Venlo,2018JJ00,2018,50350,,486,,456,,30,1985,,760,1225,1741,,470,-134,1271,244,276,,50626
197533,3000,Male,GM0983,Venlo,2019JJ00,2019,50626,,449,,468,,-19,2053,,835,1218,1904,,581,-159,1323,149,126,,50752
197534,3000,Male,GM0983,Venlo,2020JJ00,2020,50752,,454,,555,,-101,2042,,797,1245,1807,,511,-92,1296,235,136,,50888
197535,3000,Male,GM0983,Venlo,2021JJ00,2021,50888,,466,,519,,-53,2003,,735,1268,1845,,535,-183,1310,158,98,,50986
197536,3000,Male,GM0983,Venlo,2022JJ00,2022,50986,,420,,515,,-95,2485,,1177,1308,1844,,637,-149,1207,641,545,,51531
197537,3000,Male,GM0983,Venlo,2023JJ00,2023,51531,,438,,519,,-81,2437,,1011,1426,1957,,640,-149,1317,480,398,,51929
197608,3000,Male,GM0984,Venray,2012JJ00,2012,21628,,221,,173,,48,793,,175,618,785,,157,-39,628,8,56,,21684
197609,3000,Male,GM0984,Venray,2013JJ00,2013,21684,,225,,162,,63,776,,180,596,751,,155,-29,596,25,89,,21773
197610,3000,Male,GM0984,Venray,2014JJ00,2014,21773,,206,,149,,57,859,,221,638,841,,160,-18,681,18,74,,21847
197611,3000,Male,GM0984,Venray,2015JJ00,2015,21847,,187,,181,,6,920,,247,673,875,,166,-28,709,45,47,,21894
197612,3000,Male,GM0984,Venray,2016JJ00,2016,21894,,235,,157,,78,1141,,298,843,979,,170,-44,809,162,240,,22134
197613,3000,Male,GM0984,Venray,2017JJ00,2017,22134,,211,,170,,41,1161,,296,865,1287,,215,-59,1072,-126,-86,,22048
197614,3000,Male,GM0984,Venray,2018JJ00,2018,22048,,176,,191,,-15,940,,256,684,941,,199,-34,742,-1,-15,,22033
197615,3000,Male,GM0984,Venray,2019JJ00,2019,22033,,199,,182,,17,1057,,304,753,907,,177,-39,730,150,169,,22202
197616,3000,Male,GM0984,Venray,2020JJ00,2020,22202,,177,,225,,-48,1041,,277,764,941,,155,-20,786,100,52,,22254
197617,3000,Male,GM0984,Venray,2021JJ00,2021,22254,,217,,239,,-22,1178,,310,868,1007,,198,-37,809,171,148,,22402
197618,3000,Male,GM0984,Venray,2022JJ00,2022,22402,,172,,213,,-41,1305,,473,832,944,,224,-45,720,361,322,,22724
197619,3000,Male,GM0984,Venray,2023JJ00,2023,22724,,180,,226,,-46,1283,,481,802,1170,,332,-95,838,113,63,,22787
197772,3000,Male,GM0620,Vianen,2012JJ00,2012,9679,,110,,79,,31,349,,29,320,381,,29,-1,352,-32,0,,9679
197773,3000,Male,GM0620,Vianen,2013JJ00,2013,9679,,102,,67,,35,314,,36,278,372,,52,-14,320,-58,-21,,9658
197774,3000,Male,GM0620,Vianen,2014JJ00,2014,9658,,101,,66,,35,381,,34,347,392,,33,-8,359,-11,24,,9682
197775,3000,Male,GM0620,Vianen,2015JJ00,2015,9682,,96,,79,,17,371,,31,340,458,,57,-12,401,-87,-68,,9614
197776,3000,Male,GM0620,Vianen,2016JJ00,2016,9614,,94,,78,,16,524,,29,495,456,,32,0,424,68,86,,9700
197777,3000,Male,GM0620,Vianen,2017JJ00,2017,9700,,96,,80,,16,593,,24,569,495,,36,-5,459,98,115,,9815
197778,3000,Male,GM0620,Vianen,2018JJ00,2018,9815,,109,,100,,9,642,,37,605,395,,26,3,369,247,256,,10071
198025,3000,Male,GM1961,Vijfheerenlanden,2019JJ00,2019,27566,,308,,242,,66,1516,,171,1345,986,,87,-21,899,530,597,,28163
198026,3000,Male,GM1961,Vijfheerenlanden,2020JJ00,2020,28163,,321,,294,,27,1511,,119,1392,1048,,75,-16,973,463,489,,28652
198027,3000,Male,GM1961,Vijfheerenlanden,2021JJ00,2021,28652,,430,,295,,135,1538,,107,1431,1142,,89,-6,1053,396,534,,29186
198028,3000,Male,GM1961,Vijfheerenlanden,2022JJ00,2022,29186,,362,,256,,106,1649,,220,1429,1096,,122,-8,974,553,660,,29846
198029,3000,Male,GM1961,Vijfheerenlanden,2023JJ00,2023,29846,,366,,297,,69,1804,,174,1630,1095,,123,-15,972,709,780,,30626
198182,3000,Male,GM0622,Vlaardingen,2012JJ00,2012,34710,,407,,364,,43,1513,,317,1196,1652,,323,-23,1329,-139,-98,,34612
198183,3000,Male,GM0622,Vlaardingen,2013JJ00,2013,34612,,343,,339,,4,1510,,311,1199,1522,,376,-113,1146,-12,-12,,34600
198184,3000,Male,GM0622,Vlaardingen,2014JJ00,2014,34600,,405,,371,,34,1806,,543,1263,1585,,350,-94,1235,221,259,,34859
198185,3000,Male,GM0622,Vlaardingen,2015JJ00,2015,34859,,392,,333,,59,1723,,373,1350,1651,,423,-129,1228,72,130,,34989
198186,3000,Male,GM0622,Vlaardingen,2016JJ00,2016,34989,,427,,390,,37,1813,,370,1443,1690,,375,-143,1315,123,158,,35147
198187,3000,Male,GM0622,Vlaardingen,2017JJ00,2017,35147,,419,,391,,28,1697,,323,1374,1783,,285,-58,1498,-86,-56,,35091
198188,3000,Male,GM0622,Vlaardingen,2018JJ00,2018,35091,,402,,393,,9,1933,,427,1506,1756,,279,-48,1477,177,187,,35278
198189,3000,Male,GM0622,Vlaardingen,2019JJ00,2019,35278,,416,,400,,16,2179,,547,1632,1769,,301,-102,1468,410,429,,35707
198190,3000,Male,GM0622,Vlaardingen,2020JJ00,2020,35707,,399,,403,,-4,2111,,482,1629,1883,,352,-83,1531,228,223,,35930
198191,3000,Male,GM0622,Vlaardingen,2021JJ00,2021,35930,,384,,440,,-56,2228,,510,1718,2046,,361,-64,1685,182,131,,36061
198192,3000,Male,GM0622,Vlaardingen,2022JJ00,2022,36061,,425,,396,,29,2298,,649,1649,1862,,314,-17,1548,436,465,,36526
198193,3000,Male,GM0622,Vlaardingen,2023JJ00,2023,36526,,407,,401,,6,2641,,693,1948,2020,,425,-56,1595,621,625,,37151
198264,3000,Male,GM0048,Vlagtwedde,2012JJ00,2012,8111,,66,,91,,-25,576,,36,540,634,,70,-25,564,-58,-83,,8028
198265,3000,Male,GM0048,Vlagtwedde,2013JJ00,2013,8028,,56,,104,,-48,436,,41,395,506,,71,-28,435,-70,-118,,7910
198266,3000,Male,GM0048,Vlagtwedde,2014JJ00,2014,7910,,57,,86,,-29,1017,,662,355,795,,121,-62,674,222,194,,8104
198267,3000,Male,GM0048,Vlagtwedde,2015JJ00,2015,8104,,69,,90,,-21,2467,,2090,377,2285,,112,-72,2173,182,178,,8282
198268,3000,Male,GM0048,Vlagtwedde,2016JJ00,2016,8282,,67,,101,,-34,2880,,2492,388,3194,,71,-47,3123,-314,-343,,7939
198269,3000,Male,GM0048,Vlagtwedde,2017JJ00,2017,7939,,64,,90,,-26,1411,,926,485,1414,,54,-24,1360,-3,-27,,7912
198592,3000,Male,GM0096,Vlieland,2012JJ00,2012,553,,3,,3,,0,62,,8,54,67,,10,-6,57,-5,-5,,548
198593,3000,Male,GM0096,Vlieland,2013JJ00,2013,548,,3,,5,,-2,66,,7,59,69,,8,-1,61,-3,-5,,543
198594,3000,Male,GM0096,Vlieland,2014JJ00,2014,543,,3,,5,,-2,75,,12,63,73,,9,-3,64,2,0,,543
198595,3000,Male,GM0096,Vlieland,2015JJ00,2015,543,,5,,7,,-2,56,,7,49,72,,10,-6,62,-16,-18,,525
198596,3000,Male,GM0096,Vlieland,2016JJ00,2016,525,,7,,10,,-3,73,,11,62,61,,2,0,59,12,8,,533
198597,3000,Male,GM0096,Vlieland,2017JJ00,2017,533,,3,,7,,-4,104,,29,75,69,,11,-2,58,35,30,,563
198598,3000,Male,GM0096,Vlieland,2018JJ00,2018,563,,2,,4,,-2,101,,45,56,81,,26,-1,55,20,18,,581
198599,3000,Male,GM0096,Vlieland,2019JJ00,2019,581,,1,,9,,-8,119,,49,70,107,,42,-18,65,12,2,,583
198600,3000,Male,GM0096,Vlieland,2020JJ00,2020,583,,9,,7,,2,92,,29,63,81,,28,-3,53,11,13,,596
198601,3000,Male,GM0096,Vlieland,2021JJ00,2021,596,,1,,6,,-5,108,,54,54,111,,60,-32,51,-3,-7,,589
198602,3000,Male,GM0096,Vlieland,2022JJ00,2022,589,,3,,6,,-3,133,,77,56,64,,22,-1,42,69,65,,654
198603,3000,Male,GM0096,Vlieland,2023JJ00,2023,654,,7,,5,,2,100,,53,47,113,,46,-25,67,-13,-10,,644
198756,3000,Male,GM0718,Vlissingen,2012JJ00,2012,22154,,231,,244,,-13,1302,,421,881,1310,,451,-264,859,-8,-23,,22131
198757,3000,Male,GM0718,Vlissingen,2013JJ00,2013,22131,,213,,239,,-26,1191,,352,839,1160,,304,-141,856,31,7,,22138
198758,3000,Male,GM0718,Vlissingen,2014JJ00,2014,22138,,195,,201,,-6,1245,,350,895,1200,,336,-108,864,45,36,,22174
198759,3000,Male,GM0718,Vlissingen,2015JJ00,2015,22174,,212,,261,,-49,1221,,330,891,1246,,304,-107,942,-25,-77,,22097
198760,3000,Male,GM0718,Vlissingen,2016JJ00,2016,22097,,186,,261,,-75,1298,,294,1004,1262,,302,-109,960,36,-37,,22060
198761,3000,Male,GM0718,Vlissingen,2017JJ00,2017,22060,,179,,224,,-45,1361,,391,970,1280,,299,-96,981,81,33,,22093
198762,3000,Male,GM0718,Vlissingen,2018JJ00,2018,22093,,186,,240,,-54,1420,,421,999,1372,,348,-128,1024,48,-5,,22088
198763,3000,Male,GM0718,Vlissingen,2019JJ00,2019,22088,,188,,219,,-31,1409,,497,912,1365,,350,-148,1015,44,15,,22103
198764,3000,Male,GM0718,Vlissingen,2020JJ00,2020,22103,,179,,267,,-88,1458,,441,1017,1370,,284,-85,1086,88,11,,22114
198765,3000,Male,GM0718,Vlissingen,2021JJ00,2021,22114,,193,,323,,-130,1473,,438,1035,1256,,314,-119,942,217,91,,22205
198766,3000,Male,GM0718,Vlissingen,2022JJ00,2022,22205,,202,,299,,-97,1847,,594,1253,1419,,360,-102,1059,428,331,,22536
198767,3000,Male,GM0718,Vlissingen,2023JJ00,2023,22536,,170,,283,,-113,1920,,530,1390,1632,,426,-178,1206,288,173,,22709
198838,3000,Male,GM0623,Vlist,2012JJ00,2012,4863,,52,,52,,0,157,,12,145,155,,13,-2,142,2,1,,4864
198839,3000,Male,GM0623,Vlist,2013JJ00,2013,4864,,37,,42,,-5,145,,9,136,165,,1,4,164,-20,-24,,4840
198840,3000,Male,GM0623,Vlist,2014JJ00,2014,4840,,43,,35,,8,193,,17,176,164,,16,-1,148,29,29,,4869
199002,3000,Male,GM0986,Voerendaal,2012JJ00,2012,6314,,38,,52,,-14,257,,29,228,266,,8,4,258,-9,-23,,6291
199003,3000,Male,GM0986,Voerendaal,2013JJ00,2013,6291,,52,,64,,-12,220,,21,199,303,,23,-5,280,-83,-95,,6196
199004,3000,Male,GM0986,Voerendaal,2014JJ00,2014,6196,,51,,64,,-13,252,,12,240,292,,26,-4,266,-40,-53,,6143
199005,3000,Male,GM0986,Voerendaal,2015JJ00,2015,6143,,54,,58,,-4,267,,8,259,236,,23,0,213,31,27,,6170
199006,3000,Male,GM0986,Voerendaal,2016JJ00,2016,6170,,57,,63,,-6,269,,21,248,288,,20,-2,268,-19,-27,,6143
199007,3000,Male,GM0986,Voerendaal,2017JJ00,2017,6143,,43,,67,,-24,306,,23,283,340,,25,-2,315,-34,-57,,6086
199008,3000,Male,GM0986,Voerendaal,2018JJ00,2018,6086,,59,,56,,3,321,,33,288,271,,11,0,260,50,53,,6139
199009,3000,Male,GM0986,Voerendaal,2019JJ00,2019,6139,,58,,59,,-1,297,,25,272,298,,12,4,286,-1,-2,,6137
199010,3000,Male,GM0986,Voerendaal,2020JJ00,2020,6137,,48,,79,,-31,300,,19,281,288,,17,-3,271,12,-20,,6117
199011,3000,Male,GM0986,Voerendaal,2021JJ00,2021,6117,,62,,63,,-1,295,,18,277,317,,17,3,300,-22,-24,,6093
199012,3000,Male,GM0986,Voerendaal,2022JJ00,2022,6093,,54,,63,,-9,281,,37,244,275,,14,0,261,6,-4,,6089
199013,3000,Male,GM0986,Voerendaal,2023JJ00,2023,6089,,55,,72,,-17,285,,42,243,274,,25,0,249,11,-6,,6083
199423,3000,Male,GM1992,Voorne aan Zee,2023JJ00,2023,36582,,295,,386,,-91,1767,,328,1439,1453,,203,-43,1250,314,220,,36802
199494,3000,Male,GM0626,Voorschoten,2012JJ00,2012,11731,,119,,92,,27,659,,75,584,508,,88,-2,420,151,179,,11910
199495,3000,Male,GM0626,Voorschoten,2013JJ00,2013,11910,,125,,102,,23,652,,105,547,547,,115,-18,432,105,132,,12042
199496,3000,Male,GM0626,Voorschoten,2014JJ00,2014,12042,,121,,100,,21,671,,88,583,610,,111,0,499,61,82,,12124
199497,3000,Male,GM0626,Voorschoten,2015JJ00,2015,12124,,117,,101,,16,647,,98,549,679,,132,-15,547,-32,-18,,12106
199498,3000,Male,GM0626,Voorschoten,2016JJ00,2016,12106,,129,,131,,-2,795,,91,704,724,,113,-10,611,71,68,,12174
199499,3000,Male,GM0626,Voorschoten,2017JJ00,2017,12174,,110,,101,,9,748,,103,645,666,,131,-21,535,82,91,,12265
199500,3000,Male,GM0626,Voorschoten,2018JJ00,2018,12265,,119,,130,,-11,695,,127,568,667,,96,-4,571,28,17,,12282
199501,3000,Male,GM0626,Voorschoten,2019JJ00,2019,12282,,123,,106,,17,701,,163,538,674,,94,-14,580,27,46,,12328
199502,3000,Male,GM0626,Voorschoten,2020JJ00,2020,12328,,108,,122,,-14,715,,113,602,638,,101,-16,537,77,62,,12390
199503,3000,Male,GM0626,Voorschoten,2021JJ00,2021,12390,,127,,122,,5,718,,135,583,695,,110,-15,585,23,28,,12418
199504,3000,Male,GM0626,Voorschoten,2022JJ00,2022,12418,,115,,137,,-22,919,,214,705,816,,132,-12,684,103,82,,12500
199505,3000,Male,GM0626,Voorschoten,2023JJ00,2023,12500,,94,,125,,-31,876,,147,729,866,,118,-9,748,10,-24,,12476
199576,3000,Male,GM0285,Voorst,2012JJ00,2012,11843,,111,,108,,3,476,,22,454,441,,33,-12,408,35,39,,11882
199577,3000,Male,GM0285,Voorst,2013JJ00,2013,11882,,111,,117,,-6,461,,18,443,463,,24,4,439,-2,-7,,11875
199578,3000,Male,GM0285,Voorst,2014JJ00,2014,11875,,127,,95,,32,505,,27,478,440,,33,-9,407,65,95,,11970
199579,3000,Male,GM0285,Voorst,2015JJ00,2015,11970,,97,,118,,-21,530,,28,502,498,,33,-11,465,32,11,,11981
199580,3000,Male,GM0285,Voorst,2016JJ00,2016,11981,,117,,116,,1,610,,32,578,494,,24,2,470,116,115,,12096
199581,3000,Male,GM0285,Voorst,2017JJ00,2017,12096,,97,,114,,-17,646,,32,614,576,,30,-5,546,70,52,,12148
199582,3000,Male,GM0285,Voorst,2018JJ00,2018,12148,,108,,133,,-25,598,,20,578,537,,32,-4,505,61,36,,12184
199583,3000,Male,GM0285,Voorst,2019JJ00,2019,12184,,104,,121,,-17,603,,34,569,484,,27,0,457,119,103,,12287
199584,3000,Male,GM0285,Voorst,2020JJ00,2020,12287,,116,,137,,-21,665,,40,625,522,,18,4,504,143,121,,12408
199585,3000,Male,GM0285,Voorst,2021JJ00,2021,12408,,112,,135,,-23,606,,28,578,497,,29,-6,468,109,87,,12495
199586,3000,Male,GM0285,Voorst,2022JJ00,2022,12495,,123,,140,,-17,535,,68,467,423,,38,-10,385,112,95,,12590
199587,3000,Male,GM0285,Voorst,2023JJ00,2023,12590,,109,,128,,-19,623,,72,551,481,,41,-3,440,142,122,,12712
200150,3000,Male,GM0865,Vught,2012JJ00,2012,12728,,124,,141,,-17,992,,68,924,1043,,89,-8,954,-51,-69,,12659
200151,3000,Male,GM0865,Vught,2013JJ00,2013,12659,,137,,132,,5,967,,70,897,911,,-19,54,930,56,60,,12719
200152,3000,Male,GM0865,Vught,2014JJ00,2014,12719,,132,,127,,5,1005,,59,946,913,,43,2,870,92,98,,12817
200153,3000,Male,GM0865,Vught,2015JJ00,2015,12817,,108,,148,,-40,1063,,61,1002,992,,20,32,972,71,32,,12849
200154,3000,Male,GM0865,Vught,2016JJ00,2016,12849,,125,,129,,-4,1039,,87,952,892,,-19,51,911,147,146,,12995
200155,3000,Male,GM0865,Vught,2017JJ00,2017,12995,,157,,137,,20,1147,,70,1077,1012,,-1,46,1013,135,156,,13151
200156,3000,Male,GM0865,Vught,2018JJ00,2018,13151,,159,,132,,27,1047,,73,974,1058,,2,41,1056,-11,16,,13167
200157,3000,Male,GM0865,Vught,2019JJ00,2019,13167,,144,,145,,-1,1089,,108,981,973,,13,36,960,116,114,,13281
200158,3000,Male,GM0865,Vught,2020JJ00,2020,13281,,125,,183,,-58,1171,,125,1046,1070,,25,12,1045,101,46,,13327
200159,3000,Male,GM0865,Vught,2021JJ00,2021,15755,,158,,158,,0,1186,,114,1072,1117,,45,9,1072,69,71,,15826
200160,3000,Male,GM0865,Vught,2022JJ00,2022,15826,,152,,173,,-21,1181,,162,1019,969,,62,9,907,212,191,,16017
200161,3000,Male,GM0865,Vught,2023JJ00,2023,16017,,149,,175,,-26,1197,,151,1046,1043,,55,11,988,154,128,,16145
200320,3000,Male,GM1949,Waadhoeke,2018JJ00,2018,23450,,205,,223,,-18,1144,,212,932,1222,,93,-22,1129,-78,-91,,23359
200321,3000,Male,GM1949,Waadhoeke,2019JJ00,2019,23359,,214,,218,,-4,1179,,222,957,1111,,83,-19,1028,68,64,,23423
200322,3000,Male,GM1949,Waadhoeke,2020JJ00,2020,23423,,211,,226,,-15,1109,,114,995,1081,,110,-39,971,28,13,,23436
200323,3000,Male,GM1949,Waadhoeke,2021JJ00,2021,23436,,210,,292,,-82,1259,,93,1166,1116,,90,-22,1026,143,60,,23496
200324,3000,Male,GM1949,Waadhoeke,2022JJ00,2022,23496,,253,,252,,1,1252,,250,1002,1031,,111,-34,920,221,221,,23717
200325,3000,Male,GM1949,Waadhoeke,2023JJ00,2023,23717,,183,,231,,-48,1219,,220,999,1118,,143,-41,975,101,58,,23775
200396,3000,Male,GM0866,Waalre,2012JJ00,2012,8143,,73,,76,,-3,439,,36,403,314,,29,3,285,125,122,,8265
200397,3000,Male,GM0866,Waalre,2013JJ00,2013,8265,,75,,72,,3,407,,48,359,401,,49,-1,352,6,9,,8274
200398,3000,Male,GM0866,Waalre,2014JJ00,2014,8274,,73,,78,,-5,446,,31,415,389,,44,3,345,57,52,,8326
200399,3000,Male,GM0866,Waalre,2015JJ00,2015,8326,,68,,73,,-5,509,,46,463,435,,56,-4,379,74,69,,8395
200400,3000,Male,GM0866,Waalre,2016JJ00,2016,8395,,83,,92,,-9,412,,51,361,479,,67,-3,412,-67,-76,,8319
200401,3000,Male,GM0866,Waalre,2017JJ00,2017,8319,,83,,67,,16,503,,46,457,422,,48,-5,374,81,96,,8415
200402,3000,Male,GM0866,Waalre,2018JJ00,2018,8415,,89,,69,,20,558,,68,490,450,,44,3,406,108,128,,8543
200403,3000,Male,GM0866,Waalre,2019JJ00,2019,8543,,92,,77,,15,583,,78,505,461,,42,-1,419,122,138,,8681
200404,3000,Male,GM0866,Waalre,2020JJ00,2020,8681,,83,,90,,-7,530,,69,461,470,,55,-7,415,60,51,,8732
200405,3000,Male,GM0866,Waalre,2021JJ00,2021,8732,,64,,85,,-21,540,,71,469,519,,69,-5,450,21,-1,,8731
200406,3000,Male,GM0866,Waalre,2022JJ00,2022,8731,,73,,96,,-23,671,,143,528,434,,57,1,377,237,214,,8945
200407,3000,Male,GM0866,Waalre,2023JJ00,2023,8945,,67,,83,,-16,552,,78,474,541,,76,-7,465,11,-5,,8940
200478,3000,Male,GM0867,Waalwijk,2012JJ00,2012,23105,,231,,185,,46,891,,210,681,937,,156,-55,781,-46,3,,23108
200479,3000,Male,GM0867,Waalwijk,2013JJ00,2013,23108,,234,,203,,31,934,,195,739,918,,131,-23,787,16,50,,23158
200480,3000,Male,GM0867,Waalwijk,2014JJ00,2014,23158,,256,,206,,50,986,,202,784,915,,136,-58,779,71,118,,23276
200481,3000,Male,GM0867,Waalwijk,2015JJ00,2015,23276,,227,,199,,28,1051,,221,830,919,,113,-17,806,132,163,,23439
200482,3000,Male,GM0867,Waalwijk,2016JJ00,2016,23439,,233,,201,,32,1184,,270,914,1041,,165,-68,876,143,177,,23616
200483,3000,Male,GM0867,Waalwijk,2017JJ00,2017,23616,,231,,224,,7,1296,,305,991,1126,,195,-80,931,170,172,,23788
200484,3000,Male,GM0867,Waalwijk,2018JJ00,2018,23788,,217,,261,,-44,1418,,368,1050,1118,,185,-75,933,300,254,,24042
200485,3000,Male,GM0867,Waalwijk,2019JJ00,2019,24042,,239,,218,,21,1425,,360,1065,1248,,224,-79,1024,177,197,,24239
200486,3000,Male,GM0867,Waalwijk,2020JJ00,2020,24239,,252,,306,,-54,1460,,435,1025,1301,,242,-65,1059,159,104,,24343
200487,3000,Male,GM0867,Waalwijk,2021JJ00,2021,24343,,252,,226,,26,1733,,637,1096,1405,,380,-65,1025,328,353,,24696
200488,3000,Male,GM0867,Waalwijk,2022JJ00,2022,24696,,234,,221,,13,1786,,661,1125,1506,,464,-85,1042,280,294,,24990
200489,3000,Male,GM0867,Waalwijk,2023JJ00,2023,24990,,236,,229,,7,1627,,589,1038,1419,,353,-31,1066,208,215,,25205
200806,3000,Male,GM0627,Waddinxveen,2012JJ00,2012,12601,,113,,95,,18,437,,46,391,516,,63,-20,453,-79,-61,,12540
200807,3000,Male,GM0627,Waddinxveen,2013JJ00,2013,12540,,152,,79,,73,549,,53,496,460,,46,-5,414,89,163,,12703
200808,3000,Male,GM0627,Waddinxveen,2014JJ00,2014,12703,,134,,107,,27,532,,61,471,506,,62,-12,444,26,54,,12757
200809,3000,Male,GM0627,Waddinxveen,2015JJ00,2015,12757,,150,,106,,44,662,,81,581,499,,43,-13,456,163,208,,12965
200810,3000,Male,GM0627,Waddinxveen,2016JJ00,2016,12965,,149,,81,,68,736,,80,656,577,,82,-22,495,159,227,,13192
200811,3000,Male,GM0627,Waddinxveen,2017JJ00,2017,13192,,158,,86,,72,1033,,81,952,591,,73,-20,518,442,513,,13705
200812,3000,Male,GM0627,Waddinxveen,2018JJ00,2018,13705,,185,,110,,75,850,,69,781,574,,65,-18,509,276,353,,14058
200813,3000,Male,GM0627,Waddinxveen,2019JJ00,2019,14058,,187,,110,,77,1043,,74,969,677,,72,-22,605,366,442,,14500
200814,3000,Male,GM0627,Waddinxveen,2020JJ00,2020,14500,,226,,106,,120,1132,,87,1045,638,,48,-5,590,494,617,,15117
200815,3000,Male,GM0627,Waddinxveen,2021JJ00,2021,15117,,252,,121,,131,994,,87,907,693,,78,-8,615,301,432,,15549
200816,3000,Male,GM0627,Waddinxveen,2022JJ00,2022,15549,,224,,109,,115,1230,,178,1052,697,,90,-12,607,533,648,,16197
200817,3000,Male,GM0627,Waddinxveen,2023JJ00,2023,16197,,239,,118,,121,1335,,140,1195,760,,120,-16,640,575,696,,16893
200970,3000,Male,GM0289,Wageningen,2012JJ00,2012,17766,,169,,139,,30,1807,,604,1203,1590,,560,-163,1030,217,256,,18022
200971,3000,Male,GM0289,Wageningen,2013JJ00,2013,18022,,130,,184,,-54,2053,,664,1389,2005,,973,-479,1032,48,-4,,18018
200972,3000,Male,GM0289,Wageningen,2014JJ00,2014,18018,,167,,146,,21,2016,,671,1345,1852,,670,-100,1182,164,181,,18199
200973,3000,Male,GM0289,Wageningen,2015JJ00,2015,18199,,158,,172,,-14,2047,,753,1294,2015,,726,-211,1289,32,26,,18225
200974,3000,Male,GM0289,Wageningen,2016JJ00,2016,18225,,160,,178,,-18,2273,,846,1427,2013,,715,-169,1298,260,244,,18469
200975,3000,Male,GM0289,Wageningen,2017JJ00,2017,18469,,149,,153,,-4,2048,,791,1257,2035,,746,-222,1289,13,-6,,18463
200976,3000,Male,GM0289,Wageningen,2018JJ00,2018,18463,,156,,190,,-34,2261,,846,1415,2025,,678,-106,1347,236,205,,18668
200977,3000,Male,GM0289,Wageningen,2019JJ00,2019,18668,,150,,174,,-24,2724,,971,1753,2260,,635,-88,1625,464,438,,19106
200978,3000,Male,GM0289,Wageningen,2020JJ00,2020,19106,,139,,196,,-57,2249,,712,1537,2169,,581,-78,1588,80,23,,19129
200979,3000,Male,GM0289,Wageningen,2021JJ00,2021,19129,,121,,197,,-76,2270,,883,1387,2153,,526,-80,1627,117,40,,19169
200980,3000,Male,GM0289,Wageningen,2022JJ00,2022,19169,,154,,198,,-44,2526,,1028,1498,2062,,510,-55,1552,464,423,,19592
200981,3000,Male,GM0289,Wageningen,2023JJ00,2023,19592,,111,,175,,-64,3264,,1047,2217,2391,,638,-73,1753,873,810,,20402
201872,3000,Male,GM0629,Wassenaar,2012JJ00,2012,12199,,76,,140,,-64,841,,323,518,841,,370,-6,471,0,-62,,12137
201873,3000,Male,GM0629,Wassenaar,2013JJ00,2013,12137,,65,,124,,-59,896,,346,550,831,,350,4,481,65,6,,12143
201874,3000,Male,GM0629,Wassenaar,2014JJ00,2014,12143,,84,,131,,-47,1119,,443,676,1064,,378,-17,686,55,7,,12150
201875,3000,Male,GM0629,Wassenaar,2015JJ00,2015,12150,,87,,128,,-41,985,,301,684,860,,340,17,520,125,84,,12234
201876,3000,Male,GM0629,Wassenaar,2016JJ00,2016,12234,,83,,137,,-54,1007,,284,723,873,,337,23,536,134,79,,12313
201877,3000,Male,GM0629,Wassenaar,2017JJ00,2017,12313,,99,,144,,-45,970,,279,691,909,,339,20,570,61,18,,12331
201878,3000,Male,GM0629,Wassenaar,2018JJ00,2018,12331,,71,,139,,-68,954,,273,681,818,,311,20,507,136,74,,12405
201879,3000,Male,GM0629,Wassenaar,2019JJ00,2019,12405,,71,,162,,-91,1017,,275,742,886,,339,10,547,131,38,,12443
201880,3000,Male,GM0629,Wassenaar,2020JJ00,2020,12443,,83,,178,,-95,1645,,293,1352,1046,,240,21,806,599,502,,12945
201881,3000,Male,GM0629,Wassenaar,2021JJ00,2021,12945,,79,,156,,-77,1476,,325,1151,1415,,219,44,1196,61,-15,,12930
201882,3000,Male,GM0629,Wassenaar,2022JJ00,2022,12930,,78,,180,,-102,1325,,367,958,1251,,359,-43,892,74,-31,,12899
201883,3000,Male,GM0629,Wassenaar,2023JJ00,2023,12899,,91,,174,,-83,1754,,302,1452,1526,,313,-26,1213,228,144,,13043
202036,3000,Male,GM0852,Waterland,2012JJ00,2012,8480,,63,,71,,-8,302,,25,277,267,,21,4,246,35,26,,8506
202037,3000,Male,GM0852,Waterland,2013JJ00,2013,8506,,62,,70,,-8,287,,33,254,292,,32,-7,260,-5,-12,,8494
202038,3000,Male,GM0852,Waterland,2014JJ00,2014,8494,,80,,56,,24,264,,24,240,322,,22,5,300,-58,-32,,8462
202039,3000,Male,GM0852,Waterland,2015JJ00,2015,8462,,60,,77,,-17,373,,40,333,293,,24,-3,269,80,62,,8524
202040,3000,Male,GM0852,Waterland,2016JJ00,2016,8524,,61,,66,,-5,333,,35,298,329,,35,-5,294,4,1,,8525
202041,3000,Male,GM0852,Waterland,2017JJ00,2017,8525,,72,,69,,3,311,,32,279,347,,27,0,320,-36,-33,,8492
202042,3000,Male,GM0852,Waterland,2018JJ00,2018,8492,,81,,73,,8,386,,41,345,361,,33,-2,328,25,33,,8525
202043,3000,Male,GM0852,Waterland,2019JJ00,2019,8525,,57,,83,,-26,364,,35,329,311,,31,-6,280,53,30,,8555
202044,3000,Male,GM0852,Waterland,2020JJ00,2020,8555,,61,,85,,-24,320,,46,274,342,,24,-7,318,-22,-47,,8508
202045,3000,Male,GM0852,Waterland,2021JJ00,2021,8508,,74,,102,,-28,366,,20,346,347,,10,5,337,19,-8,,8500
202046,3000,Male,GM0852,Waterland,2022JJ00,2022,8500,,58,,72,,-14,467,,130,337,366,,61,-20,305,101,87,,8587
202047,3000,Male,GM0852,Waterland,2023JJ00,2023,8587,,73,,83,,-10,372,,61,311,393,,51,-2,342,-21,-29,,8558
202364,3000,Male,GM0988,Weert,2012JJ00,2012,24343,,231,,206,,25,741,,165,576,800,,211,-87,589,-59,-38,,24305
202365,3000,Male,GM0988,Weert,2013JJ00,2013,24305,,189,,253,,-64,765,,180,585,673,,142,-22,531,92,29,,24334
202366,3000,Male,GM0988,Weert,2014JJ00,2014,24334,,209,,219,,-10,847,,221,626,732,,159,-34,573,115,103,,24437
202367,3000,Male,GM0988,Weert,2015JJ00,2015,24437,,230,,231,,-1,878,,189,689,815,,217,-43,598,63,60,,24497
202368,3000,Male,GM0988,Weert,2016JJ00,2016,24497,,241,,227,,14,1591,,337,1254,1250,,184,-43,1066,341,343,,24840
202369,3000,Male,GM0988,Weert,2017JJ00,2017,24840,,222,,219,,3,1297,,255,1042,1146,,150,-11,996,151,154,,24994
202370,3000,Male,GM0988,Weert,2018JJ00,2018,24994,,197,,230,,-33,1162,,294,868,1166,,179,-31,987,-4,-38,,24956
202371,3000,Male,GM0988,Weert,2019JJ00,2019,24956,,229,,296,,-67,1393,,481,912,1195,,274,-101,921,198,130,,25086
202372,3000,Male,GM0988,Weert,2020JJ00,2020,25086,,179,,321,,-142,1400,,314,1086,1332,,277,-107,1055,68,-81,,25005
202373,3000,Male,GM0988,Weert,2021JJ00,2021,25005,,230,,312,,-82,1290,,409,881,1014,,284,-127,730,276,191,,25196
202374,3000,Male,GM0988,Weert,2022JJ00,2022,25196,,217,,291,,-74,1496,,675,821,1165,,409,-182,756,331,256,,25452
202375,3000,Male,GM0988,Weert,2023JJ00,2023,25452,,212,,273,,-61,1533,,589,944,1365,,634,-328,731,168,100,,25552
202446,3000,Male,GM0457,Weesp,2012JJ00,2012,8728,,95,,58,,37,474,,74,400,450,,84,-20,366,24,62,,8790
202447,3000,Male,GM0457,Weesp,2013JJ00,2013,8790,,68,,76,,-8,457,,52,405,470,,63,-10,407,-13,-20,,8770
202448,3000,Male,GM0457,Weesp,2014JJ00,2014,8770,,98,,80,,18,529,,77,452,480,,76,-10,404,49,68,,8838
202449,3000,Male,GM0457,Weesp,2015JJ00,2015,8838,,91,,80,,11,589,,62,527,480,,65,-18,415,109,121,,8959
202450,3000,Male,GM0457,Weesp,2016JJ00,2016,8959,,105,,97,,8,583,,76,507,493,,81,-18,412,90,103,,9062
202451,3000,Male,GM0457,Weesp,2017JJ00,2017,9062,,101,,82,,19,767,,94,673,561,,53,-14,508,206,222,,9284
202452,3000,Male,GM0457,Weesp,2018JJ00,2018,9284,,124,,80,,44,653,,91,562,566,,66,-9,500,87,131,,9415
202453,3000,Male,GM0457,Weesp,2019JJ00,2019,9415,,114,,95,,19,781,,93,688,605,,72,-14,533,176,196,,9611
202454,3000,Male,GM0457,Weesp,2020JJ00,2020,9611,,117,,105,,12,935,,77,858,604,,53,2,551,331,343,,9954
202455,3000,Male,GM0457,Weesp,2021JJ00,2021,9954,,139,,103,,36,813,,100,713,693,,83,-16,610,120,155,,10109
202456,3000,Male,GM0457,Weesp,2022JJ00,2022,10109,,,,,,,,,,,,,,,,,,,
202856,3000,Male,GM0870,Werkendam,2012JJ00,2012,13187,,144,,100,,44,299,,28,271,377,,23,2,354,-78,-35,,13152
202857,3000,Male,GM0870,Werkendam,2013JJ00,2013,13152,,153,,90,,63,320,,39,281,367,,30,1,337,-47,16,,13168
202858,3000,Male,GM0870,Werkendam,2014JJ00,2014,13168,,130,,104,,26,424,,40,384,379,,23,5,356,45,71,,13239
202859,3000,Male,GM0870,Werkendam,2015JJ00,2015,13239,,130,,102,,28,421,,37,384,406,,26,-3,380,15,43,,13282
202860,3000,Male,GM0870,Werkendam,2016JJ00,2016,13282,,160,,90,,70,531,,44,487,421,,25,1,396,110,179,,13461
202861,3000,Male,GM0870,Werkendam,2017JJ00,2017,13461,,147,,114,,33,502,,61,441,463,,39,-10,424,39,71,,13532
202862,3000,Male,GM0870,Werkendam,2018JJ00,2018,13532,,153,,96,,57,602,,58,544,468,,28,-2,440,134,187,,13719
203191,3000,Male,GM1960,West Betuwe,2019JJ00,2019,25322,,258,,174,,84,1106,,158,948,926,,85,-13,841,180,261,,25583
203192,3000,Male,GM1960,West Betuwe,2020JJ00,2020,25583,,285,,238,,47,1227,,164,1063,1034,,101,-11,933,193,242,,25825
203193,3000,Male,GM1960,West Betuwe,2021JJ00,2021,25825,,280,,251,,29,1265,,110,1155,1057,,89,-10,968,208,235,,26060
203194,3000,Male,GM1960,West Betuwe,2022JJ00,2022,26060,,294,,217,,77,1299,,310,989,1011,,147,-43,864,288,367,,26427
203195,3000,Male,GM1960,West Betuwe,2023JJ00,2023,26427,,276,,212,,64,1203,,159,1044,1143,,168,-39,975,60,127,,26554
203266,3000,Male,GM0668,West Maas en Waal,2012JJ00,2012,9129,,73,,86,,-13,360,,35,325,321,,14,6,307,39,26,,9155
203267,3000,Male,GM0668,West Maas en Waal,2013JJ00,2013,9155,,75,,75,,0,351,,30,321,361,,24,6,337,-10,-11,,9144
203268,3000,Male,GM0668,West Maas en Waal,2014JJ00,2014,9144,,88,,90,,-2,415,,53,362,321,,18,4,303,94,93,,9237
203269,3000,Male,GM0668,West Maas en Waal,2015JJ00,2015,9237,,85,,94,,-9,416,,35,381,338,,28,-5,310,78,69,,9306
203270,3000,Male,GM0668,West Maas en Waal,2016JJ00,2016,9306,,80,,67,,13,458,,33,425,395,,18,1,377,63,77,,9383
203271,3000,Male,GM0668,West Maas en Waal,2017JJ00,2017,9383,,90,,78,,12,445,,36,409,386,,25,-6,361,59,72,,9455
203272,3000,Male,GM0668,West Maas en Waal,2018JJ00,2018,9455,,75,,85,,-10,514,,60,454,407,,27,-2,380,107,99,,9554
203273,3000,Male,GM0668,West Maas en Waal,2019JJ00,2019,9554,,78,,86,,-8,528,,50,478,373,,22,-6,351,155,145,,9699
203274,3000,Male,GM0668,West Maas en Waal,2020JJ00,2020,9699,,99,,106,,-7,561,,39,522,441,,42,-20,399,120,111,,9810
203275,3000,Male,GM0668,West Maas en Waal,2021JJ00,2021,9810,,121,,99,,22,472,,52,420,448,,26,-1,422,24,45,,9855
203276,3000,Male,GM0668,West Maas en Waal,2022JJ00,2022,9855,,101,,84,,17,596,,117,479,422,,57,-17,365,174,191,,10046
203277,3000,Male,GM0668,West Maas en Waal,2023JJ00,2023,10046,,89,,108,,-19,564,,72,492,398,,42,-4,356,166,146,,10192
203847,3000,Male,GM1969,Westerkwartier,2019JJ00,2019,31691,,322,,273,,49,1324,,95,1229,1255,,72,-11,1183,69,119,,31810
203848,3000,Male,GM1969,Westerkwartier,2020JJ00,2020,31810,,320,,301,,19,1400,,61,1339,1195,,43,8,1152,205,224,,32034
203849,3000,Male,GM1969,Westerkwartier,2021JJ00,2021,32034,,338,,338,,0,1324,,57,1267,1043,,56,-12,987,281,283,,32317
203850,3000,Male,GM1969,Westerkwartier,2022JJ00,2022,32317,,320,,315,,5,1463,,325,1138,1145,,115,-33,1030,318,323,,32640
203851,3000,Male,GM1969,Westerkwartier,2023JJ00,2023,32640,,305,,331,,-26,1262,,238,1024,1320,,209,-101,1111,-58,-81,,32559
204004,3000,Male,GM1701,Westerveld,2012JJ00,2012,9555,,72,,107,,-35,421,,36,385,422,,15,7,407,-1,-35,,9520
204005,3000,Male,GM1701,Westerveld,2013JJ00,2013,9520,,59,,114,,-55,446,,35,411,468,,37,-10,431,-22,-76,,9444
204006,3000,Male,GM1701,Westerveld,2014JJ00,2014,9444,,74,,118,,-44,647,,158,489,510,,40,2,470,137,98,,9542
204007,3000,Male,GM1701,Westerveld,2015JJ00,2015,9542,,72,,112,,-40,616,,159,457,679,,22,6,657,-63,-102,,9440
204008,3000,Male,GM1701,Westerveld,2016JJ00,2016,9440,,54,,102,,-48,803,,133,670,701,,25,4,676,102,58,,9498
204009,3000,Male,GM1701,Westerveld,2017JJ00,2017,9498,,63,,133,,-70,664,,53,611,576,,21,3,555,88,17,,9515
204010,3000,Male,GM1701,Westerveld,2018JJ00,2018,9515,,67,,122,,-55,681,,49,632,513,,22,5,491,168,113,,9628
204011,3000,Male,GM1701,Westerveld,2019JJ00,2019,9628,,59,,121,,-62,610,,50,560,506,,36,-1,470,104,42,,9670
204012,3000,Male,GM1701,Westerveld,2020JJ00,2020,9670,,81,,131,,-50,658,,37,621,524,,16,7,508,134,86,,9756
204013,3000,Male,GM1701,Westerveld,2021JJ00,2021,9756,,78,,126,,-48,624,,36,588,473,,25,-3,448,151,100,,9856
204014,3000,Male,GM1701,Westerveld,2022JJ00,2022,9856,,79,,139,,-60,502,,51,451,487,,44,-1,443,15,-45,,9811
204015,3000,Male,GM1701,Westerveld,2023JJ00,2023,9811,,66,,111,,-45,686,,84,602,537,,32,-2,505,149,105,,9916
204086,3000,Male,GM0293,Westervoort,2012JJ00,2012,7574,,69,,54,,15,380,,36,344,442,,30,-2,412,-62,-47,,7527
204087,3000,Male,GM0293,Westervoort,2013JJ00,2013,7527,,51,,57,,-6,399,,19,380,468,,39,-10,429,-69,-74,,7453
204088,3000,Male,GM0293,Westervoort,2014JJ00,2014,7453,,51,,51,,0,327,,24,303,442,,30,-2,412,-115,-115,,7338
204089,3000,Male,GM0293,Westervoort,2015JJ00,2015,7338,,69,,73,,-4,387,,36,351,407,,36,-10,371,-20,-25,,7313
204090,3000,Male,GM0293,Westervoort,2016JJ00,2016,7313,,75,,62,,13,461,,30,431,462,,29,-7,433,-1,14,,7327
204091,3000,Male,GM0293,Westervoort,2017JJ00,2017,7327,,83,,69,,14,483,,25,458,461,,38,-2,423,22,35,,7362
204092,3000,Male,GM0293,Westervoort,2018JJ00,2018,7362,,81,,53,,28,442,,40,402,481,,49,-21,432,-39,-11,,7351
204093,3000,Male,GM0293,Westervoort,2019JJ00,2019,7351,,73,,49,,24,415,,30,385,416,,21,3,395,-1,24,,7375
204094,3000,Male,GM0293,Westervoort,2020JJ00,2020,7375,,67,,63,,4,441,,28,413,412,,9,6,403,29,34,,7409
204095,3000,Male,GM0293,Westervoort,2021JJ00,2021,7409,,83,,79,,4,394,,25,369,453,,37,-8,416,-59,-55,,7354
204096,3000,Male,GM0293,Westervoort,2022JJ00,2022,7354,,81,,58,,23,463,,73,390,407,,38,-1,369,56,79,,7433
204097,3000,Male,GM0293,Westervoort,2023JJ00,2023,7433,,57,,73,,-16,426,,46,380,407,,37,-2,370,19,3,,7436
204174,3000,Male,GM1950,Westerwolde,2018JJ00,2018,12368,,104,,153,,-49,4754,,4104,650,4474,,23,13,4451,280,237,,12605
204175,3000,Male,GM1950,Westerwolde,2019JJ00,2019,12605,,101,,152,,-51,4710,,3853,857,4436,,112,-73,4324,274,250,,12855
204176,3000,Male,GM1950,Westerwolde,2020JJ00,2020,12855,,104,,146,,-42,4438,,3326,1112,4129,,113,-44,4016,309,286,,13141
204177,3000,Male,GM1950,Westerwolde,2021JJ00,2021,13141,,110,,195,,-85,7616,,6856,760,7373,,51,-27,7322,243,197,,13338
204178,3000,Male,GM1950,Westerwolde,2022JJ00,2022,13338,,102,,171,,-69,8331,,7680,651,8293,,103,-54,8190,38,5,,13343
204179,3000,Male,GM1950,Westerwolde,2023JJ00,2023,13343,,93,,174,,-81,9788,,9195,593,9757,,75,-17,9682,31,0,,13343
204332,3000,Male,GM1783,Westland,2012JJ00,2012,50801,,496,,365,,131,2210,,1068,1142,2078,,936,-305,1142,132,263,,51064
204333,3000,Male,GM1783,Westland,2013JJ00,2013,51064,,484,,385,,99,2506,,1240,1266,2254,,1111,-217,1143,252,346,,51410
204334,3000,Male,GM1783,Westland,2014JJ00,2014,51410,,527,,346,,181,2717,,1484,1233,2367,,1152,-212,1215,350,527,,51937
204335,3000,Male,GM1783,Westland,2015JJ00,2015,51937,,519,,403,,116,2975,,1518,1457,2741,,1429,-443,1312,234,351,,52288
204336,3000,Male,GM1783,Westland,2016JJ00,2016,52288,,549,,416,,133,3220,,1578,1642,2946,,1543,-441,1403,274,411,,52699
204337,3000,Male,GM1783,Westland,2017JJ00,2017,52699,,525,,386,,139,3555,,1689,1866,2684,,1282,-410,1402,871,1013,,53712
204338,3000,Male,GM1783,Westland,2018JJ00,2018,53712,,554,,379,,175,3402,,1533,1869,3075,,1639,-322,1436,327,504,,54216
204339,3000,Male,GM1783,Westland,2019JJ00,2019,54216,,600,,395,,205,3549,,1593,1956,2805,,1348,-277,1457,744,948,,55164
204340,3000,Male,GM1783,Westland,2020JJ00,2020,55164,,591,,489,,102,2999,,1110,1889,2672,,1172,-128,1500,327,431,,55595
204341,3000,Male,GM1783,Westland,2021JJ00,2021,55595,,640,,458,,182,2906,,1106,1800,2567,,894,-231,1673,339,522,,56117
204342,3000,Male,GM1783,Westland,2022JJ00,2022,56117,,617,,474,,143,3485,,1721,1764,2583,,1000,-357,1583,902,1046,,57163
204343,3000,Male,GM1783,Westland,2023JJ00,2023,57163,,578,,440,,138,3313,,1399,1914,2824,,1136,-425,1688,489,621,,57784
204496,3000,Male,GM0098,Weststellingwerf,2012JJ00,2012,12920,,115,,130,,-15,361,,25,336,419,,36,-9,383,-58,-72,,12848
204497,3000,Male,GM0098,Weststellingwerf,2013JJ00,2013,12848,,108,,156,,-48,390,,27,363,411,,27,-6,384,-21,-70,,12778
204498,3000,Male,GM0098,Weststellingwerf,2014JJ00,2014,12778,,121,,134,,-13,416,,27,389,412,,43,-15,369,4,-10,,12768
204499,3000,Male,GM0098,Weststellingwerf,2015JJ00,2015,12768,,119,,150,,-31,453,,34,419,429,,41,2,388,24,-5,,12763
204500,3000,Male,GM0098,Weststellingwerf,2016JJ00,2016,12763,,98,,144,,-46,549,,46,503,500,,57,-15,443,49,2,,12765
204501,3000,Male,GM0098,Weststellingwerf,2017JJ00,2017,12765,,121,,131,,-10,543,,40,503,498,,35,-6,463,45,35,,12800
204502,3000,Male,GM0098,Weststellingwerf,2018JJ00,2018,12800,,106,,147,,-41,555,,49,506,448,,27,-3,421,107,65,,12865
204503,3000,Male,GM0098,Weststellingwerf,2019JJ00,2019,12865,,120,,136,,-16,544,,57,487,463,,42,-8,421,81,65,,12930
204504,3000,Male,GM0098,Weststellingwerf,2020JJ00,2020,12930,,121,,158,,-37,650,,54,596,465,,33,-10,432,185,147,,13077
204505,3000,Male,GM0098,Weststellingwerf,2021JJ00,2021,13077,,133,,147,,-14,595,,49,546,482,,27,-10,455,113,100,,13177
204506,3000,Male,GM0098,Weststellingwerf,2022JJ00,2022,13177,,131,,181,,-50,596,,89,507,472,,57,-9,415,124,75,,13252
204507,3000,Male,GM0098,Weststellingwerf,2023JJ00,2023,13252,,123,,164,,-41,552,,70,482,486,,44,-9,442,66,27,,13279
204578,3000,Male,GM0614,Westvoorne,2012JJ00,2012,6903,,41,,76,,-35,327,,57,270,319,,69,-22,250,8,-27,,6876
204579,3000,Male,GM0614,Westvoorne,2013JJ00,2013,6876,,34,,90,,-56,370,,50,320,289,,50,-9,239,81,27,,6903
204580,3000,Male,GM0614,Westvoorne,2014JJ00,2014,6903,,48,,71,,-23,372,,44,328,287,,45,-6,242,85,62,,6965
204581,3000,Male,GM0614,Westvoorne,2015JJ00,2015,6965,,53,,80,,-27,377,,36,341,286,,36,-11,250,91,65,,7030
204582,3000,Male,GM0614,Westvoorne,2016JJ00,2016,7030,,42,,84,,-42,405,,40,365,327,,48,-9,279,78,36,,7066
204583,3000,Male,GM0614,Westvoorne,2017JJ00,2017,7066,,53,,61,,-8,460,,33,427,327,,24,0,303,133,123,,7189
204584,3000,Male,GM0614,Westvoorne,2018JJ00,2018,7189,,38,,77,,-39,471,,48,423,364,,34,-6,330,107,69,,7258
204585,3000,Male,GM0614,Westvoorne,2019JJ00,2019,7258,,40,,73,,-33,442,,39,403,329,,39,-7,290,113,80,,7338
204586,3000,Male,GM0614,Westvoorne,2020JJ00,2020,7338,,50,,88,,-38,450,,49,401,336,,32,-12,304,114,75,,7413
204587,3000,Male,GM0614,Westvoorne,2021JJ00,2021,7413,,59,,107,,-48,385,,53,332,326,,31,-5,295,59,11,,7424
204588,3000,Male,GM0614,Westvoorne,2022JJ00,2022,7424,,48,,101,,-53,380,,85,295,309,,30,6,279,71,-1,,7423
204824,3000,Male,GM0189,Wierden,2012JJ00,2012,11927,,116,,92,,24,291,,25,266,346,,29,0,317,-55,-31,,11896
204825,3000,Male,GM0189,Wierden,2013JJ00,2013,11896,,150,,94,,56,345,,36,309,339,,16,-3,323,6,62,,11958
204826,3000,Male,GM0189,Wierden,2014JJ00,2014,11958,,119,,88,,31,330,,19,311,397,,37,-8,360,-67,-35,,11923
204827,3000,Male,GM0189,Wierden,2015JJ00,2015,11923,,120,,102,,18,384,,26,358,371,,42,-13,329,13,31,,11954
204828,3000,Male,GM0189,Wierden,2016JJ00,2016,11954,,128,,101,,27,495,,35,460,384,,34,1,350,111,138,,12092
204829,3000,Male,GM0189,Wierden,2017JJ00,2017,12092,,114,,92,,22,467,,44,423,470,,32,-10,438,-3,19,,12111
204830,3000,Male,GM0189,Wierden,2018JJ00,2018,12111,,117,,113,,4,445,,33,412,405,,24,0,381,40,44,,12155
204831,3000,Male,GM0189,Wierden,2019JJ00,2019,12155,,122,,103,,19,475,,32,443,433,,37,-7,396,42,61,,12216
204832,3000,Male,GM0189,Wierden,2020JJ00,2020,12216,,132,,114,,18,463,,42,421,393,,19,-2,374,70,89,,12305
204833,3000,Male,GM0189,Wierden,2021JJ00,2021,12305,,121,,117,,4,452,,21,431,407,,18,-4,389,45,49,,12354
204834,3000,Male,GM0189,Wierden,2022JJ00,2022,12354,,116,,143,,-27,455,,102,353,358,,36,0,322,97,71,,12425
204835,3000,Male,GM0189,Wierden,2023JJ00,2023,12425,,124,,111,,13,449,,39,410,401,,26,-2,375,48,60,,12485
205152,3000,Male,GM0296,Wijchen,2012JJ00,2012,20096,,173,,156,,17,747,,67,680,630,,67,-4,563,117,136,,20232
205153,3000,Male,GM0296,Wijchen,2013JJ00,2013,20232,,212,,150,,62,676,,59,617,667,,67,-2,600,9,72,,20304
205154,3000,Male,GM0296,Wijchen,2014JJ00,2014,20304,,182,,127,,55,653,,66,587,796,,73,-20,723,-143,-85,,20219
205155,3000,Male,GM0296,Wijchen,2015JJ00,2015,20219,,179,,167,,12,711,,73,638,752,,39,-16,713,-41,-28,,20191
205156,3000,Male,GM0296,Wijchen,2016JJ00,2016,20191,,182,,155,,27,793,,72,721,792,,61,-3,731,1,29,,20220
205157,3000,Male,GM0296,Wijchen,2017JJ00,2017,20220,,173,,177,,-4,796,,63,733,783,,66,-4,717,13,10,,20230
205158,3000,Male,GM0296,Wijchen,2018JJ00,2018,20230,,161,,176,,-15,810,,61,749,761,,56,-12,705,49,34,,20264
205159,3000,Male,GM0296,Wijchen,2019JJ00,2019,20264,,169,,170,,-1,808,,107,701,737,,75,-9,662,71,70,,20334
205160,3000,Male,GM0296,Wijchen,2020JJ00,2020,20334,,162,,210,,-48,803,,77,726,742,,57,-10,685,61,16,,20350
205161,3000,Male,GM0296,Wijchen,2021JJ00,2021,20350,,164,,205,,-41,796,,77,719,735,,60,-8,675,61,19,,20369
205162,3000,Male,GM0296,Wijchen,2022JJ00,2022,20369,,175,,186,,-11,807,,154,653,716,,74,-8,642,91,82,,20451
205163,3000,Male,GM0296,Wijchen,2023JJ00,2023,20451,,194,,208,,-14,778,,103,675,739,,80,-17,659,39,27,,20478
205234,3000,Male,GM1696,Wijdemeren,2012JJ00,2012,11413,,84,,119,,-35,532,,61,471,556,,54,-10,502,-24,-59,,11354
205235,3000,Male,GM1696,Wijdemeren,2013JJ00,2013,11354,,79,,118,,-39,500,,46,454,470,,36,-1,434,30,-9,,11345
205236,3000,Male,GM1696,Wijdemeren,2014JJ00,2014,11345,,90,,98,,-8,532,,44,488,559,,59,-5,500,-27,-34,,11311
205237,3000,Male,GM1696,Wijdemeren,2015JJ00,2015,11311,,83,,118,,-35,652,,60,592,602,,56,-5,546,50,15,,11326
205238,3000,Male,GM1696,Wijdemeren,2016JJ00,2016,11326,,94,,123,,-29,764,,50,714,644,,60,-6,584,120,92,,11418
205239,3000,Male,GM1696,Wijdemeren,2017JJ00,2017,11418,,97,,127,,-30,784,,65,719,650,,46,-5,604,134,106,,11524
205240,3000,Male,GM1696,Wijdemeren,2018JJ00,2018,11524,,94,,115,,-21,784,,75,709,542,,53,-10,489,242,220,,11744
205241,3000,Male,GM1696,Wijdemeren,2019JJ00,2019,11744,,119,,133,,-14,861,,89,772,636,,41,2,595,225,210,,11954
205242,3000,Male,GM1696,Wijdemeren,2020JJ00,2020,11954,,100,,127,,-27,744,,61,683,646,,45,-5,601,98,71,,12025
205243,3000,Male,GM1696,Wijdemeren,2021JJ00,2021,12025,,133,,141,,-8,642,,44,598,616,,31,-3,585,26,18,,12043
205244,3000,Male,GM1696,Wijdemeren,2022JJ00,2022,12043,,96,,136,,-40,727,,122,605,655,,73,-7,582,72,32,,12075
205245,3000,Male,GM1696,Wijdemeren,2023JJ00,2023,12075,,96,,138,,-42,698,,78,620,659,,49,4,610,39,0,,12075
205644,3000,Male,GM0352,Wijk bij Duurstede,2012JJ00,2012,11395,,99,,66,,33,359,,24,335,403,,41,-6,362,-44,-11,,11384
205645,3000,Male,GM0352,Wijk bij Duurstede,2013JJ00,2013,11384,,101,,80,,21,379,,24,355,419,,33,-4,386,-40,-19,,11365
205646,3000,Male,GM0352,Wijk bij Duurstede,2014JJ00,2014,11365,,115,,73,,42,414,,28,386,390,,36,-7,354,24,67,,11432
205647,3000,Male,GM0352,Wijk bij Duurstede,2015JJ00,2015,11432,,105,,75,,30,466,,34,432,418,,22,3,396,48,78,,11510
205648,3000,Male,GM0352,Wijk bij Duurstede,2016JJ00,2016,11510,,116,,85,,31,519,,45,474,483,,28,-6,455,36,68,,11578
205649,3000,Male,GM0352,Wijk bij Duurstede,2017JJ00,2017,11578,,131,,83,,48,520,,30,490,476,,28,-1,448,44,93,,11671
205650,3000,Male,GM0352,Wijk bij Duurstede,2018JJ00,2018,11671,,99,,96,,3,475,,41,434,422,,21,2,401,53,54,,11725
205651,3000,Male,GM0352,Wijk bij Duurstede,2019JJ00,2019,11725,,108,,85,,23,476,,39,437,453,,42,-8,411,23,48,,11773
205652,3000,Male,GM0352,Wijk bij Duurstede,2020JJ00,2020,11773,,107,,84,,23,476,,45,431,475,,19,1,456,1,26,,11799
205653,3000,Male,GM0352,Wijk bij Duurstede,2021JJ00,2021,11799,,120,,96,,24,445,,22,423,458,,49,-9,409,-13,10,,11809
205654,3000,Male,GM0352,Wijk bij Duurstede,2022JJ00,2022,11809,,110,,90,,20,441,,60,381,430,,46,-6,384,11,32,,11841
205655,3000,Male,GM0352,Wijk bij Duurstede,2023JJ00,2023,11841,,102,,99,,3,426,,52,374,461,,40,-8,421,-35,-32,,11809
206628,3000,Male,GM0053,Winsum,2012JJ00,2012,6956,,65,,66,,-1,217,,18,199,262,,17,-1,245,-45,-46,,6910
206629,3000,Male,GM0053,Winsum,2013JJ00,2013,6910,,59,,62,,-3,271,,8,263,305,,20,-8,285,-34,-37,,6873
206630,3000,Male,GM0053,Winsum,2014JJ00,2014,6873,,61,,74,,-13,255,,20,235,290,,22,-9,268,-35,-47,,6826
206631,3000,Male,GM0053,Winsum,2015JJ00,2015,6826,,56,,67,,-11,240,,21,219,301,,23,-4,278,-61,-71,,6755
206632,3000,Male,GM0053,Winsum,2016JJ00,2016,6755,,48,,71,,-23,295,,13,282,322,,21,-3,301,-27,-51,,6704
206633,3000,Male,GM0053,Winsum,2017JJ00,2017,6704,,62,,57,,5,319,,15,304,301,,12,0,289,18,23,,6727
206634,3000,Male,GM0053,Winsum,2018JJ00,2018,6727,,57,,67,,-10,307,,17,290,353,,21,-4,332,-46,-58,,6669
206710,3000,Male,GM0294,Winterswijk,2012JJ00,2012,14385,,130,,146,,-16,622,,251,371,575,,96,-45,479,47,31,,14416
206711,3000,Male,GM0294,Winterswijk,2013JJ00,2013,14416,,136,,131,,5,638,,302,336,661,,75,-39,586,-23,-19,,14397
206712,3000,Male,GM0294,Winterswijk,2014JJ00,2014,14397,,137,,146,,-9,928,,523,405,831,,66,-25,765,97,92,,14489
206713,3000,Male,GM0294,Winterswijk,2015JJ00,2015,14489,,101,,149,,-48,905,,493,412,896,,71,-23,825,9,-41,,14448
206714,3000,Male,GM0294,Winterswijk,2016JJ00,2016,14448,,135,,138,,-3,924,,302,622,893,,69,-11,824,31,25,,14473
206715,3000,Male,GM0294,Winterswijk,2017JJ00,2017,14473,,129,,148,,-19,789,,112,677,732,,80,-31,652,57,35,,14508
206716,3000,Male,GM0294,Winterswijk,2018JJ00,2018,14508,,129,,160,,-31,639,,145,494,673,,88,-34,585,-34,-66,,14442
206717,3000,Male,GM0294,Winterswijk,2019JJ00,2019,14442,,129,,145,,-16,633,,143,490,637,,137,-78,500,-4,-22,,14420
206718,3000,Male,GM0294,Winterswijk,2020JJ00,2020,14420,,129,,153,,-24,663,,75,588,570,,76,-28,494,93,68,,14488
206719,3000,Male,GM0294,Winterswijk,2021JJ00,2021,14488,,120,,170,,-50,788,,56,732,631,,54,-11,577,157,100,,14588
206720,3000,Male,GM0294,Winterswijk,2022JJ00,2022,14588,,110,,177,,-67,772,,130,642,667,,69,-15,598,105,38,,14626
206721,3000,Male,GM0294,Winterswijk,2023JJ00,2023,14626,,132,,185,,-53,729,,106,623,658,,99,-23,559,71,18,,14644
207120,3000,Male,GM0873,Woensdrecht,2012JJ00,2012,10862,,116,,116,,0,411,,128,283,415,,78,-8,337,-4,-4,,10858
207121,3000,Male,GM0873,Woensdrecht,2013JJ00,2013,10858,,81,,109,,-28,431,,124,307,416,,74,-12,342,15,-13,,10845
207122,3000,Male,GM0873,Woensdrecht,2014JJ00,2014,10845,,80,,117,,-37,484,,163,321,454,,99,-18,355,30,-9,,10836
207123,3000,Male,GM0873,Woensdrecht,2015JJ00,2015,10836,,81,,107,,-26,514,,176,338,476,,88,-20,388,38,12,,10848
207124,3000,Male,GM0873,Woensdrecht,2016JJ00,2016,10848,,89,,92,,-3,663,,224,439,546,,130,-19,416,117,115,,10963
207125,3000,Male,GM0873,Woensdrecht,2017JJ00,2017,10963,,93,,110,,-17,527,,182,345,533,,128,-29,405,-6,-25,,10938
207126,3000,Male,GM0873,Woensdrecht,2018JJ00,2018,10938,,91,,95,,-4,561,,206,355,505,,107,-9,398,56,50,,10988
207127,3000,Male,GM0873,Woensdrecht,2019JJ00,2019,10988,,90,,113,,-23,551,,200,351,535,,119,-8,416,16,-6,,10982
207128,3000,Male,GM0873,Woensdrecht,2020JJ00,2020,10982,,93,,117,,-24,612,,211,401,489,,88,-11,401,123,97,,11079
207129,3000,Male,GM0873,Woensdrecht,2021JJ00,2021,11079,,81,,141,,-60,569,,173,396,511,,177,-45,334,58,-3,,11076
207130,3000,Male,GM0873,Woensdrecht,2022JJ00,2022,11076,,72,,117,,-45,554,,186,368,470,,137,-26,333,84,39,,11115
207131,3000,Male,GM0873,Woensdrecht,2023JJ00,2023,11115,,84,,119,,-35,541,,152,389,490,,148,-22,342,51,14,,11129
207202,3000,Male,GM0632,Woerden,2012JJ00,2012,24730,,290,,171,,119,746,,64,682,683,,102,-36,581,63,181,,24911
207203,3000,Male,GM0632,Woerden,2013JJ00,2013,24911,,257,,155,,102,704,,70,634,743,,91,-11,652,-39,62,,24973
207204,3000,Male,GM0632,Woerden,2014JJ00,2014,24973,,269,,172,,97,798,,76,722,879,,87,-22,792,-81,15,,24988
207205,3000,Male,GM0632,Woerden,2015JJ00,2015,24988,,322,,181,,141,957,,98,859,811,,78,-1,733,146,288,,25276
207206,3000,Male,GM0632,Woerden,2016JJ00,2016,25276,,261,,181,,80,1041,,112,929,910,,81,-4,829,131,206,,25482
207207,3000,Male,GM0632,Woerden,2017JJ00,2017,25482,,273,,181,,92,958,,110,848,951,,109,-16,842,7,105,,25587
207208,3000,Male,GM0632,Woerden,2018JJ00,2018,25587,,289,,189,,100,1000,,121,879,880,,67,6,813,120,216,,25803
207209,3000,Male,GM0632,Woerden,2019JJ00,2019,25803,,257,,194,,63,929,,123,806,949,,96,-20,853,-20,43,,25846
207210,3000,Male,GM0632,Woerden,2020JJ00,2020,25846,,298,,219,,79,1119,,131,988,968,,55,5,913,151,231,,26077
207211,3000,Male,GM0632,Woerden,2021JJ00,2021,26077,,297,,226,,71,1035,,110,925,1000,,72,3,928,35,107,,26184
207212,3000,Male,GM0632,Woerden,2022JJ00,2022,26184,,221,,262,,-41,1125,,186,939,977,,88,8,889,148,111,,26295
207213,3000,Male,GM0632,Woerden,2023JJ00,2023,26295,,261,,233,,28,1222,,141,1081,996,,120,-10,876,226,253,,26548
207366,3000,Male,GM1690,De Wolden,2012JJ00,2012,11899,,103,,110,,-7,475,,32,443,455,,21,1,434,20,15,,11914
207367,3000,Male,GM1690,De Wolden,2013JJ00,2013,11914,,87,,132,,-45,377,,21,356,448,,26,-5,422,-71,-115,,11799
207368,3000,Male,GM1690,De Wolden,2014JJ00,2014,11799,,88,,105,,-17,462,,20,442,382,,20,-2,362,80,66,,11865
207369,3000,Male,GM1690,De Wolden,2015JJ00,2015,11865,,96,,122,,-26,483,,26,457,437,,25,2,412,46,21,,11886
207370,3000,Male,GM1690,De Wolden,2016JJ00,2016,11886,,106,,136,,-30,533,,28,505,536,,22,0,514,-3,-33,,11853
207371,3000,Male,GM1690,De Wolden,2017JJ00,2017,11853,,104,,120,,-16,661,,16,645,543,,23,5,520,118,104,,11957
207372,3000,Male,GM1690,De Wolden,2018JJ00,2018,11957,,113,,145,,-32,621,,40,581,515,,25,-4,490,106,74,,12031
207373,3000,Male,GM1690,De Wolden,2019JJ00,2019,12031,,103,,108,,-5,623,,42,581,478,,15,1,463,145,140,,12171
207374,3000,Male,GM1690,De Wolden,2020JJ00,2020,12171,,106,,148,,-42,609,,56,553,542,,30,-8,512,67,26,,12197
207375,3000,Male,GM1690,De Wolden,2021JJ00,2021,12197,,123,,145,,-22,597,,51,546,508,,51,-6,457,89,69,,12266
207376,3000,Male,GM1690,De Wolden,2022JJ00,2022,12266,,95,,148,,-53,634,,99,535,474,,37,-1,437,160,106,,12372
207377,3000,Male,GM1690,De Wolden,2023JJ00,2023,12372,,90,,138,,-48,558,,63,495,525,,50,-16,475,33,-14,,12358
207776,3000,Male,GM0880,Wormerland,2012JJ00,2012,7893,,56,,76,,-20,328,,34,294,339,,31,-10,308,-11,-32,,7861
207777,3000,Male,GM0880,Wormerland,2013JJ00,2013,7861,,50,,61,,-11,298,,27,271,285,,30,-1,255,13,1,,7862
207778,3000,Male,GM0880,Wormerland,2014JJ00,2014,7862,,65,,58,,7,294,,25,269,323,,42,-7,281,-29,-22,,7840
207779,3000,Male,GM0880,Wormerland,2015JJ00,2015,7840,,66,,74,,-8,332,,34,298,375,,47,-13,328,-43,-50,,7790
207780,3000,Male,GM0880,Wormerland,2016JJ00,2016,7790,,61,,74,,-13,462,,30,432,408,,26,-2,382,54,43,,7833
207781,3000,Male,GM0880,Wormerland,2017JJ00,2017,7833,,65,,82,,-17,430,,29,401,324,,31,-6,293,106,89,,7922
207782,3000,Male,GM0880,Wormerland,2018JJ00,2018,7922,,68,,64,,4,469,,27,442,299,,13,6,286,170,175,,8097
207783,3000,Male,GM0880,Wormerland,2019JJ00,2019,8097,,70,,68,,2,345,,39,306,381,,28,-5,353,-36,-34,,8063
207784,3000,Male,GM0880,Wormerland,2020JJ00,2020,8063,,73,,80,,-7,396,,30,366,373,,21,-8,352,23,17,,8080
207785,3000,Male,GM0880,Wormerland,2021JJ00,2021,8080,,64,,102,,-38,398,,22,376,360,,26,-13,334,38,-1,,8079
207786,3000,Male,GM0880,Wormerland,2022JJ00,2022,8079,,70,,87,,-17,486,,65,421,375,,35,-5,340,111,93,,8172
207787,3000,Male,GM0880,Wormerland,2023JJ00,2023,8172,,67,,78,,-11,403,,68,335,372,,41,-10,331,31,18,,8190
208022,3000,Male,GM0351,Woudenberg,2012JJ00,2012,6024,,81,,46,,35,287,,16,271,183,,18,-6,165,104,139,,6163
208023,3000,Male,GM0351,Woudenberg,2013JJ00,2013,6163,,81,,47,,34,200,,19,181,173,,15,4,158,27,62,,6225
208024,3000,Male,GM0351,Woudenberg,2014JJ00,2014,6225,,72,,53,,19,241,,20,221,221,,18,-5,203,20,25,,6250
208025,3000,Male,GM0351,Woudenberg,2015JJ00,2015,6250,,68,,48,,20,260,,11,249,242,,15,-8,227,18,38,,6288
208026,3000,Male,GM0351,Woudenberg,2016JJ00,2016,6288,,81,,60,,21,323,,18,305,257,,9,2,248,66,86,,6374
208027,3000,Male,GM0351,Woudenberg,2017JJ00,2017,6374,,91,,53,,38,383,,19,364,260,,22,-4,238,123,162,,6536
208028,3000,Male,GM0351,Woudenberg,2018JJ00,2018,6536,,83,,75,,8,323,,19,304,253,,16,1,237,70,78,,6614
208029,3000,Male,GM0351,Woudenberg,2019JJ00,2019,6614,,78,,48,,30,311,,16,295,266,,16,-4,250,45,75,,6689
208030,3000,Male,GM0351,Woudenberg,2020JJ00,2020,6689,,86,,55,,31,372,,7,365,282,,13,0,269,90,119,,6808
208031,3000,Male,GM0351,Woudenberg,2021JJ00,2021,6808,,87,,65,,22,359,,22,337,273,,13,-1,260,86,109,,6917
208032,3000,Male,GM0351,Woudenberg,2022JJ00,2022,6917,,84,,49,,35,477,,88,389,270,,19,2,251,207,238,,7155
208033,3000,Male,GM0351,Woudenberg,2023JJ00,2023,7155,,74,,50,,24,416,,42,374,297,,34,-8,263,119,142,,7297
208104,3000,Male,GM0874,Woudrichem,2012JJ00,2012,7213,,72,,62,,10,239,,17,222,231,,4,8,227,8,18,,7231
208105,3000,Male,GM0874,Woudrichem,2013JJ00,2013,7231,,64,,61,,3,202,,23,179,227,,25,-1,202,-25,-21,,7210
208106,3000,Male,GM0874,Woudrichem,2014JJ00,2014,7210,,78,,59,,19,238,,19,219,265,,16,-1,249,-27,-8,,7202
208107,3000,Male,GM0874,Woudrichem,2015JJ00,2015,7202,,72,,41,,31,293,,21,272,265,,11,1,254,28,60,,7262
208108,3000,Male,GM0874,Woudrichem,2016JJ00,2016,7262,,68,,67,,1,305,,25,280,284,,27,-2,257,21,22,,7284
208109,3000,Male,GM0874,Woudrichem,2017JJ00,2017,7284,,78,,81,,-3,337,,24,313,290,,14,1,276,47,45,,7329
208110,3000,Male,GM0874,Woudrichem,2018JJ00,2018,7329,,68,,71,,-3,327,,20,307,271,,18,-5,253,56,47,,7376
208842,3000,Male,GM0479,Zaanstad,2012JJ00,2012,73312,,823,,594,,229,2979,,609,2370,2517,,682,-228,1835,462,690,,74002
208843,3000,Male,GM0479,Zaanstad,2013JJ00,2013,74002,,819,,628,,191,2910,,588,2322,2654,,731,-213,1923,256,453,,74455
208844,3000,Male,GM0479,Zaanstad,2014JJ00,2014,74455,,865,,591,,274,2910,,635,2275,2858,,661,-201,2197,52,323,,74778
208845,3000,Male,GM0479,Zaanstad,2015JJ00,2015,74778,,811,,697,,114,3366,,687,2679,2921,,601,-135,2320,445,566,,75344
208846,3000,Male,GM0479,Zaanstad,2016JJ00,2016,75344,,907,,696,,211,3633,,688,2945,3169,,668,-115,2501,464,670,,76014
208847,3000,Male,GM0479,Zaanstad,2017JJ00,2017,76014,,836,,664,,172,3788,,778,3010,3363,,563,-86,2800,425,598,,76612
208848,3000,Male,GM0479,Zaanstad,2018JJ00,2018,76612,,830,,621,,209,3977,,930,3047,3597,,588,-63,3009,380,583,,77195
208849,3000,Male,GM0479,Zaanstad,2019JJ00,2019,77195,,826,,619,,207,4038,,963,3075,3880,,698,-185,3182,158,368,,77563
208850,3000,Male,GM0479,Zaanstad,2020JJ00,2020,77563,,813,,742,,71,4035,,884,3151,3895,,579,-94,3316,140,202,,77765
208851,3000,Male,GM0479,Zaanstad,2021JJ00,2021,77765,,840,,737,,103,4016,,896,3120,4027,,649,-138,3378,-11,93,,77858
208852,3000,Male,GM0479,Zaanstad,2022JJ00,2022,77858,,792,,742,,50,5551,,1531,4020,4111,,695,-111,3416,1440,1490,,79348
208853,3000,Male,GM0479,Zaanstad,2023JJ00,2023,79348,,810,,700,,110,5243,,1393,3850,4540,,958,-261,3582,703,814,,80162
208924,3000,Male,GM0297,Zaltbommel,2012JJ00,2012,13400,,162,,94,,68,446,,93,353,411,,48,-6,363,35,102,,13502
208925,3000,Male,GM0297,Zaltbommel,2013JJ00,2013,13502,,175,,90,,85,441,,67,374,398,,48,-1,350,43,128,,13630
208926,3000,Male,GM0297,Zaltbommel,2014JJ00,2014,13630,,179,,107,,72,491,,87,404,471,,88,-25,383,20,93,,13723
208927,3000,Male,GM0297,Zaltbommel,2015JJ00,2015,13723,,165,,98,,67,524,,96,428,494,,69,-16,425,30,95,,13818
208928,3000,Male,GM0297,Zaltbommel,2016JJ00,2016,13818,,163,,100,,63,555,,124,431,527,,94,-19,433,28,91,,13909
208929,3000,Male,GM0297,Zaltbommel,2017JJ00,2017,13909,,166,,112,,54,718,,190,528,580,,114,-26,466,138,191,,14100
208930,3000,Male,GM0297,Zaltbommel,2018JJ00,2018,14100,,162,,104,,58,850,,306,544,674,,153,-37,521,176,235,,14335
208931,3000,Male,GM0297,Zaltbommel,2019JJ00,2019,14335,,190,,106,,84,885,,279,606,724,,207,-70,517,161,245,,14580
208932,3000,Male,GM0297,Zaltbommel,2020JJ00,2020,14580,,185,,139,,46,958,,271,687,749,,196,-66,553,209,253,,14833
208933,3000,Male,GM0297,Zaltbommel,2021JJ00,2021,14833,,174,,130,,44,898,,264,634,724,,210,-75,514,174,218,,15051
208934,3000,Male,GM0297,Zaltbommel,2022JJ00,2022,15051,,187,,140,,47,888,,335,553,797,,256,-113,541,91,139,,15190
208935,3000,Male,GM0297,Zaltbommel,2023JJ00,2023,15190,,172,,126,,46,816,,360,456,870,,310,-132,560,-54,-7,,15183
209088,3000,Male,GM0473,Zandvoort,2012JJ00,2012,8002,,58,,98,,-40,420,,86,334,428,,70,-14,358,-8,-48,,7954
209089,3000,Male,GM0473,Zandvoort,2013JJ00,2013,7954,,58,,110,,-52,466,,86,380,405,,78,-26,327,61,13,,7967
209090,3000,Male,GM0473,Zandvoort,2014JJ00,2014,7967,,64,,87,,-23,547,,97,450,439,,80,-21,359,108,84,,8051
209091,3000,Male,GM0473,Zandvoort,2015JJ00,2015,8051,,73,,114,,-41,558,,81,477,471,,71,-12,400,87,44,,8095
209092,3000,Male,GM0473,Zandvoort,2016JJ00,2016,8095,,64,,117,,-53,592,,83,509,464,,110,-32,354,128,77,,8172
209093,3000,Male,GM0473,Zandvoort,2017JJ00,2017,8172,,55,,79,,-24,557,,98,459,510,,86,-13,424,47,22,,8194
209094,3000,Male,GM0473,Zandvoort,2018JJ00,2018,8194,,59,,110,,-51,528,,95,433,458,,70,-14,388,70,20,,8214
209095,3000,Male,GM0473,Zandvoort,2019JJ00,2019,8214,,66,,126,,-60,529,,110,419,437,,64,-13,373,92,34,,8248
209096,3000,Male,GM0473,Zandvoort,2020JJ00,2020,8248,,63,,113,,-50,592,,93,499,508,,85,-31,423,84,33,,8281
209097,3000,Male,GM0473,Zandvoort,2021JJ00,2021,8281,,70,,100,,-30,572,,86,486,505,,72,-9,433,67,35,,8316
209098,3000,Male,GM0473,Zandvoort,2022JJ00,2022,8316,,59,,116,,-57,734,,174,560,469,,74,-12,395,265,208,,8524
209099,3000,Male,GM0473,Zandvoort,2023JJ00,2023,8524,,57,,109,,-52,579,,122,457,578,,123,-41,455,1,-52,,8472
209170,3000,Male,GM0707,Zederik,2012JJ00,2012,6680,,80,,41,,39,200,,11,189,172,,9,2,163,28,62,,6742
209171,3000,Male,GM0707,Zederik,2013JJ00,2013,6742,,97,,40,,57,202,,10,192,173,,14,1,159,29,87,,6829
209172,3000,Male,GM0707,Zederik,2014JJ00,2014,6829,,90,,46,,44,226,,14,212,223,,7,1,216,3,46,,6875
209173,3000,Male,GM0707,Zederik,2015JJ00,2015,6875,,77,,64,,13,257,,13,244,273,,18,-6,255,-16,-3,,6872
209174,3000,Male,GM0707,Zederik,2016JJ00,2016,6872,,97,,60,,37,276,,11,265,248,,14,-2,234,28,63,,6935
209175,3000,Male,GM0707,Zederik,2017JJ00,2017,6935,,94,,58,,36,340,,12,328,285,,16,-1,269,55,90,,7025
209176,3000,Male,GM0707,Zederik,2018JJ00,2018,7025,,101,,56,,45,252,,14,238,276,,10,1,266,-24,20,,7045
209334,3000,Male,GM0478,Zeevang,2012JJ00,2012,3167,,21,,15,,6,123,,20,103,136,,34,-6,102,-13,-8,,3159
209335,3000,Male,GM0478,Zeevang,2013JJ00,2013,3159,,15,,25,,-10,153,,46,107,132,,17,2,115,21,12,,3171
209336,3000,Male,GM0478,Zeevang,2014JJ00,2014,3171,,21,,26,,-5,201,,110,91,214,,100,-5,114,-13,-18,,3153
209337,3000,Male,GM0478,Zeevang,2015JJ00,2015,3153,,24,,28,,-4,155,,33,122,200,,76,-8,124,-45,-55,,3098
209416,3000,Male,GM0050,Zeewolde,2012JJ00,2012,10800,,127,,56,,71,376,,53,323,469,,49,-9,420,-93,-23,,10777
209417,3000,Male,GM0050,Zeewolde,2013JJ00,2013,10777,,112,,56,,56,601,,300,301,493,,97,-20,396,108,165,,10942
209418,3000,Male,GM0050,Zeewolde,2014JJ00,2014,10942,,124,,49,,75,954,,578,376,961,,473,-15,488,-7,257,,11199
209419,3000,Male,GM0050,Zeewolde,2015JJ00,2015,11199,,125,,49,,76,1401,,979,422,1310,,799,-7,511,91,162,,11361
209420,3000,Male,GM0050,Zeewolde,2016JJ00,2016,11361,,119,,46,,73,1734,,944,790,1617,,752,-164,865,117,188,,11549
209421,3000,Male,GM0050,Zeewolde,2017JJ00,2017,11549,,104,,45,,59,1474,,728,746,1636,,780,-71,856,-162,-100,,11449
209422,3000,Male,GM0050,Zeewolde,2018JJ00,2018,11449,,122,,54,,68,1256,,669,587,1377,,677,-54,700,-121,-57,,11392
209423,3000,Male,GM0050,Zeewolde,2019JJ00,2019,11392,,108,,55,,53,1527,,1001,526,1394,,832,-30,562,133,182,,11574
209424,3000,Male,GM0050,Zeewolde,2020JJ00,2020,11574,,136,,66,,70,1194,,519,675,1175,,609,-26,566,19,88,,11662
209425,3000,Male,GM0050,Zeewolde,2021JJ00,2021,11662,,122,,83,,39,1401,,776,625,1199,,655,-15,544,202,238,,11900
209426,3000,Male,GM0050,Zeewolde,2022JJ00,2022,11900,,127,,58,,69,1258,,739,519,1219,,710,-13,509,39,103,,12003
209427,3000,Male,GM0050,Zeewolde,2023JJ00,2023,12003,,108,,78,,30,1290,,595,695,1206,,597,-14,609,84,110,,12113
209580,3000,Male,GM0355,Zeist,2012JJ00,2012,29509,,347,,290,,57,1985,,296,1689,1877,,187,-29,1690,108,169,,29678
209581,3000,Male,GM0355,Zeist,2013JJ00,2013,29678,,319,,271,,48,1931,,240,1691,2013,,168,-33,1845,-82,-43,,29635
209582,3000,Male,GM0355,Zeist,2014JJ00,2014,29635,,340,,278,,62,2505,,433,2072,2318,,216,-54,2102,187,250,,29885
209583,3000,Male,GM0355,Zeist,2015JJ00,2015,29885,,334,,311,,23,2603,,423,2180,2311,,201,-44,2110,292,318,,30203
209584,3000,Male,GM0355,Zeist,2016JJ00,2016,30203,,311,,268,,43,2723,,404,2319,2441,,202,-37,2239,282,324,,30527
209585,3000,Male,GM0355,Zeist,2017JJ00,2017,30527,,332,,302,,30,2646,,346,2300,2454,,292,-140,2162,192,221,,30748
209586,3000,Male,GM0355,Zeist,2018JJ00,2018,30748,,321,,321,,0,2531,,312,2219,2182,,226,-54,1956,349,344,,31092
209587,3000,Male,GM0355,Zeist,2019JJ00,2019,31092,,329,,323,,6,2510,,330,2180,2027,,222,-57,1805,483,485,,31577
209588,3000,Male,GM0355,Zeist,2020JJ00,2020,31577,,320,,370,,-50,2370,,238,2132,2151,,168,-7,1983,219,166,,31743
209589,3000,Male,GM0355,Zeist,2021JJ00,2021,31743,,329,,348,,-19,2734,,251,2483,2254,,194,-47,2060,480,464,,32207
209590,3000,Male,GM0355,Zeist,2022JJ00,2022,32207,,333,,374,,-41,3105,,439,2666,2712,,230,-42,2482,393,354,,32561
209591,3000,Male,GM0355,Zeist,2023JJ00,2023,32561,,278,,341,,-63,2700,,311,2389,2584,,249,-55,2335,116,55,,32616
209744,3000,Male,GM0299,Zevenaar,2012JJ00,2012,15962,,145,,140,,5,584,,53,531,605,,57,-9,548,-21,-16,,15946
209745,3000,Male,GM0299,Zevenaar,2013JJ00,2013,15946,,138,,155,,-17,568,,49,519,667,,69,-10,598,-99,-118,,15828
209746,3000,Male,GM0299,Zevenaar,2014JJ00,2014,15828,,158,,135,,23,603,,54,549,660,,65,3,595,-57,-33,,15795
209747,3000,Male,GM0299,Zevenaar,2015JJ00,2015,15795,,133,,151,,-18,657,,62,595,644,,47,-5,597,13,-6,,15789
209748,3000,Male,GM0299,Zevenaar,2016JJ00,2016,15789,,152,,173,,-21,776,,67,709,653,,44,1,609,123,101,,15890
209749,3000,Male,GM0299,Zevenaar,2017JJ00,2017,15890,,142,,150,,-8,879,,74,805,771,,62,-11,709,108,103,,15993
209750,3000,Male,GM0299,Zevenaar,2018JJ00,2018,21346,,184,,209,,-25,1059,,97,962,955,,80,-20,875,104,79,,21425
209751,3000,Male,GM0299,Zevenaar,2019JJ00,2019,21425,,161,,201,,-40,1061,,114,947,884,,96,-21,788,177,135,,21560
209752,3000,Male,GM0299,Zevenaar,2020JJ00,2020,21560,,197,,259,,-62,1145,,107,1038,920,,81,-18,839,225,160,,21720
209753,3000,Male,GM0299,Zevenaar,2021JJ00,2021,21720,,220,,231,,-11,1201,,104,1097,859,,99,-23,760,342,331,,22051
209754,3000,Male,GM0299,Zevenaar,2022JJ00,2022,22051,,179,,203,,-24,1135,,160,975,894,,108,-24,786,241,213,,22264
209755,3000,Male,GM0299,Zevenaar,2023JJ00,2023,22264,,200,,246,,-46,950,,121,829,884,,91,-19,793,66,18,,22282
210236,3000,Male,GM0476,Zijpe,2012JJ00,2012,5851,,41,,47,,-6,245,,43,202,286,,57,-30,229,-41,-51,,5800
210400,3000,Male,GM0637,Zoetermeer,2012JJ00,2012,59954,,703,,392,,311,2363,,262,2101,2341,,356,-24,1985,22,330,,60284
210401,3000,Male,GM0637,Zoetermeer,2013JJ00,2013,60284,,653,,389,,264,2219,,296,1923,2367,,402,-32,1965,-148,115,,60399
210402,3000,Male,GM0637,Zoetermeer,2014JJ00,2014,60399,,670,,407,,263,2320,,308,2012,2432,,340,-18,2092,-112,155,,60554
210403,3000,Male,GM0637,Zoetermeer,2015JJ00,2015,60554,,708,,441,,267,2509,,341,2168,2718,,359,-62,2359,-209,52,,60606
210404,3000,Male,GM0637,Zoetermeer,2016JJ00,2016,60606,,681,,430,,251,2997,,391,2606,2919,,388,-37,2531,78,317,,60923
210405,3000,Male,GM0637,Zoetermeer,2017JJ00,2017,60923,,638,,428,,210,2546,,341,2205,2856,,323,-38,2533,-310,-98,,60825
210406,3000,Male,GM0637,Zoetermeer,2018JJ00,2018,60825,,632,,447,,185,2666,,403,2263,2695,,267,-6,2428,-29,158,,60983
210407,3000,Male,GM0637,Zoetermeer,2019JJ00,2019,60983,,657,,433,,224,2686,,405,2281,2703,,235,0,2468,-17,209,,61192
210408,3000,Male,GM0637,Zoetermeer,2020JJ00,2020,61192,,620,,484,,136,2616,,281,2335,2724,,177,-1,2547,-108,18,,61210
210409,3000,Male,GM0637,Zoetermeer,2021JJ00,2021,61210,,651,,484,,167,2820,,295,2525,2779,,244,5,2535,41,210,,61420
210410,3000,Male,GM0637,Zoetermeer,2022JJ00,2022,61420,,629,,515,,114,3435,,508,2927,2895,,280,-27,2615,540,652,,62072
210411,3000,Male,GM0637,Zoetermeer,2023JJ00,2023,62072,,642,,496,,146,3594,,485,3109,2952,,298,-8,2654,642,793,,62865
210482,3000,Male,GM0638,Zoeterwoude,2012JJ00,2012,4042,,28,,32,,-4,142,,14,128,161,,10,-3,151,-19,-24,,4018
210483,3000,Male,GM0638,Zoeterwoude,2013JJ00,2013,4018,,33,,38,,-5,146,,9,137,146,,4,0,142,0,-5,,4013
210484,3000,Male,GM0638,Zoeterwoude,2014JJ00,2014,4013,,32,,32,,0,189,,9,180,164,,12,0,152,25,24,,4037
210485,3000,Male,GM0638,Zoeterwoude,2015JJ00,2015,4037,,28,,33,,-5,182,,17,165,174,,8,2,166,8,3,,4040
210486,3000,Male,GM0638,Zoeterwoude,2016JJ00,2016,4040,,30,,39,,-9,293,,18,275,178,,12,-2,166,115,106,,4146
210487,3000,Male,GM0638,Zoeterwoude,2017JJ00,2017,4146,,38,,46,,-8,258,,15,243,216,,13,0,203,42,34,,4180
210488,3000,Male,GM0638,Zoeterwoude,2018JJ00,2018,4180,,36,,38,,-2,209,,12,197,182,,16,-3,166,27,23,,4203
210489,3000,Male,GM0638,Zoeterwoude,2019JJ00,2019,4203,,49,,34,,15,290,,23,267,201,,18,-1,183,89,103,,4306
210490,3000,Male,GM0638,Zoeterwoude,2020JJ00,2020,4306,,41,,31,,10,339,,17,322,220,,7,3,213,119,128,,4434
210491,3000,Male,GM0638,Zoeterwoude,2021JJ00,2021,4434,,58,,41,,17,424,,23,401,217,,10,1,207,207,224,,4658
210492,3000,Male,GM0638,Zoeterwoude,2022JJ00,2022,4658,,45,,47,,-2,250,,43,207,189,,21,-3,168,61,58,,4716
210493,3000,Male,GM0638,Zoeterwoude,2023JJ00,2023,4716,,50,,46,,4,342,,27,315,228,,25,0,203,114,118,,4834
211056,3000,Male,GM0056,Zuidhorn,2012JJ00,2012,9306,,99,,83,,16,346,,29,317,351,,18,-2,333,-5,11,,9317
211057,3000,Male,GM0056,Zuidhorn,2013JJ00,2013,9317,,109,,73,,36,373,,17,356,349,,20,-6,329,24,60,,9377
211058,3000,Male,GM0056,Zuidhorn,2014JJ00,2014,9377,,98,,80,,18,386,,14,372,453,,21,-3,432,-67,-49,,9328
211059,3000,Male,GM0056,Zuidhorn,2015JJ00,2015,9328,,88,,75,,13,428,,19,409,405,,26,-2,379,23,36,,9364
211060,3000,Male,GM0056,Zuidhorn,2016JJ00,2016,9364,,106,,73,,33,468,,23,445,438,,23,3,415,30,63,,9427
211061,3000,Male,GM0056,Zuidhorn,2017JJ00,2017,9427,,89,,78,,11,497,,24,473,477,,34,-5,443,20,31,,9458
211062,3000,Male,GM0056,Zuidhorn,2018JJ00,2018,9458,,106,,67,,39,474,,28,446,426,,23,-3,403,48,85,,9543
211302,3000,Male,GM1892,Zuidplas,2012JJ00,2012,20178,,217,,141,,76,656,,68,588,669,,55,-7,614,-13,62,,20240
211303,3000,Male,GM1892,Zuidplas,2013JJ00,2013,20240,,227,,139,,88,673,,88,585,731,,81,0,650,-58,33,,20273
211304,3000,Male,GM1892,Zuidplas,2014JJ00,2014,20273,,224,,133,,91,667,,77,590,823,,85,-6,738,-156,-65,,20208
211305,3000,Male,GM1892,Zuidplas,2015JJ00,2015,20208,,210,,153,,57,887,,97,790,846,,114,-18,732,41,98,,20306
211306,3000,Male,GM1892,Zuidplas,2016JJ00,2016,20306,,221,,129,,92,1039,,92,947,857,,82,-17,775,182,276,,20582
211307,3000,Male,GM1892,Zuidplas,2017JJ00,2017,20582,,240,,135,,105,1143,,97,1046,1072,,117,-39,955,71,174,,20756
211308,3000,Male,GM1892,Zuidplas,2018JJ00,2018,20756,,251,,155,,96,1261,,88,1173,909,,87,-21,822,352,448,,21204
211309,3000,Male,GM1892,Zuidplas,2019JJ00,2019,21204,,260,,152,,108,1420,,108,1312,952,,70,4,882,468,577,,21781
211310,3000,Male,GM1892,Zuidplas,2020JJ00,2020,21781,,262,,179,,83,1480,,87,1393,1023,,59,-8,964,457,540,,22321
211311,3000,Male,GM1892,Zuidplas,2021JJ00,2021,22321,,307,,179,,128,1271,,65,1206,970,,58,5,912,301,429,,22750
211312,3000,Male,GM1892,Zuidplas,2022JJ00,2022,22750,,248,,168,,80,1453,,166,1287,919,,76,-3,843,534,619,,23369
211313,3000,Male,GM1892,Zuidplas,2023JJ00,2023,23369,,266,,174,,92,1375,,165,1210,1015,,116,-7,899,360,451,,23820
211712,3000,Male,GM0879,Zundert,2012JJ00,2012,10864,,102,,88,,14,529,,266,263,513,,251,-83,262,16,30,,10894
211713,3000,Male,GM0879,Zundert,2013JJ00,2013,10894,,112,,102,,10,777,,494,283,692,,398,-6,294,85,94,,10988
211714,3000,Male,GM0879,Zundert,2014JJ00,2014,10988,,88,,96,,-8,725,,467,258,741,,400,5,341,-16,-25,,10963
211715,3000,Male,GM0879,Zundert,2015JJ00,2015,10963,,95,,114,,-19,825,,470,355,750,,434,3,316,75,58,,11021
211716,3000,Male,GM0879,Zundert,2016JJ00,2016,11021,,96,,113,,-17,867,,459,408,749,,406,-7,343,118,100,,11121
211717,3000,Male,GM0879,Zundert,2017JJ00,2017,11121,,85,,124,,-39,825,,423,402,901,,463,5,438,-76,-118,,11003
211718,3000,Male,GM0879,Zundert,2018JJ00,2018,11003,,93,,112,,-19,900,,424,476,840,,464,-14,376,60,40,,11043
211719,3000,Male,GM0879,Zundert,2019JJ00,2019,11043,,94,,126,,-32,776,,378,398,651,,357,-4,294,125,96,,11139
211720,3000,Male,GM0879,Zundert,2020JJ00,2020,11139,,117,,130,,-13,760,,334,426,640,,309,-10,331,120,108,,11247
211721,3000,Male,GM0879,Zundert,2021JJ00,2021,11247,,115,,112,,3,716,,342,374,562,,282,-13,280,154,158,,11405
211722,3000,Male,GM0879,Zundert,2022JJ00,2022,11405,,92,,140,,-48,781,,382,399,638,,318,-9,320,143,94,,11499
211723,3000,Male,GM0879,Zundert,2023JJ00,2023,11499,,109,,154,,-45,756,,368,388,693,,366,-11,327,63,19,,11518
211794,3000,Male,GM0301,Zutphen,2012JJ00,2012,23024,,241,,198,,43,1148,,122,1026,1145,,125,-24,1020,3,42,,23066
211795,3000,Male,GM0301,Zutphen,2013JJ00,2013,23066,,212,,196,,16,1053,,94,959,1096,,85,8,1011,-43,-26,,23040
211796,3000,Male,GM0301,Zutphen,2014JJ00,2014,23040,,183,,198,,-15,1120,,94,1026,1211,,105,-14,1106,-91,-105,,22935
211797,3000,Male,GM0301,Zutphen,2015JJ00,2015,22935,,185,,207,,-22,1197,,80,1117,1119,,63,14,1056,78,58,,22993
211798,3000,Male,GM0301,Zutphen,2016JJ00,2016,22993,,175,,201,,-26,1575,,252,1323,1319,,32,40,1287,256,230,,23223
211799,3000,Male,GM0301,Zutphen,2017JJ00,2017,23223,,196,,219,,-23,1618,,171,1447,1523,,104,-17,1419,95,72,,23295
211800,3000,Male,GM0301,Zutphen,2018JJ00,2018,23295,,185,,226,,-41,1606,,166,1440,1495,,104,-20,1391,111,70,,23365
211801,3000,Male,GM0301,Zutphen,2019JJ00,2019,23365,,209,,236,,-27,1648,,200,1448,1483,,113,-40,1370,165,133,,23498
211802,3000,Male,GM0301,Zutphen,2020JJ00,2020,23498,,189,,231,,-42,1649,,113,1536,1509,,74,-16,1435,140,97,,23595
211803,3000,Male,GM0301,Zutphen,2021JJ00,2021,23595,,197,,251,,-54,1800,,109,1691,1627,,106,-32,1521,173,117,,23712
211804,3000,Male,GM0301,Zutphen,2022JJ00,2022,23712,,196,,296,,-100,1645,,176,1469,1472,,114,-33,1358,173,76,,23788
211805,3000,Male,GM0301,Zutphen,2023JJ00,2023,23788,,198,,256,,-58,1835,,130,1705,1564,,146,-38,1418,271,207,,23995
212122,3000,Male,GM1896,Zwartewaterland,2012JJ00,2012,11176,,160,,78,,82,266,,43,223,312,,32,-6,280,-46,35,,11211
212123,3000,Male,GM1896,Zwartewaterland,2013JJ00,2013,11211,,157,,58,,99,276,,46,230,344,,38,-9,306,-68,32,,11243
212124,3000,Male,GM1896,Zwartewaterland,2014JJ00,2014,11243,,139,,76,,63,299,,56,243,324,,27,-5,297,-25,38,,11281
212125,3000,Male,GM1896,Zwartewaterland,2015JJ00,2015,11281,,142,,58,,84,331,,50,281,362,,46,-20,316,-31,55,,11336
212126,3000,Male,GM1896,Zwartewaterland,2016JJ00,2016,11336,,132,,76,,56,351,,41,310,383,,43,-7,340,-32,24,,11360
212127,3000,Male,GM1896,Zwartewaterland,2017JJ00,2017,11360,,137,,69,,68,389,,54,335,386,,30,-7,356,3,71,,11431
212128,3000,Male,GM1896,Zwartewaterland,2018JJ00,2018,11431,,148,,72,,76,349,,35,314,407,,32,-2,375,-58,18,,11449
212129,3000,Male,GM1896,Zwartewaterland,2019JJ00,2019,11449,,143,,90,,53,401,,58,343,379,,45,-11,334,22,75,,11524
212130,3000,Male,GM1896,Zwartewaterland,2020JJ00,2020,11524,,152,,106,,46,381,,63,318,353,,34,-1,319,28,74,,11598
212131,3000,Male,GM1896,Zwartewaterland,2021JJ00,2021,11598,,150,,90,,60,386,,58,328,357,,35,-10,322,29,90,,11688
212132,3000,Male,GM1896,Zwartewaterland,2022JJ00,2022,11688,,143,,96,,47,521,,148,373,405,,57,-9,348,116,164,,11852
212133,3000,Male,GM1896,Zwartewaterland,2023JJ00,2023,11852,,148,,85,,63,375,,86,289,404,,53,-17,351,-29,34,,11886
212368,3000,Male,GM0642,Zwijndrecht,2012JJ00,2012,21642,,244,,205,,39,848,,60,788,883,,88,-6,795,-35,3,,21645
212369,3000,Male,GM0642,Zwijndrecht,2013JJ00,2013,21645,,247,,215,,32,894,,90,804,930,,97,-29,833,-36,-2,,21643
212370,3000,Male,GM0642,Zwijndrecht,2014JJ00,2014,21643,,266,,200,,66,878,,82,796,953,,124,-19,829,-75,-11,,21632
212371,3000,Male,GM0642,Zwijndrecht,2015JJ00,2015,21632,,237,,201,,36,949,,85,864,997,,116,-33,881,-48,-9,,21623
212372,3000,Male,GM0642,Zwijndrecht,2016JJ00,2016,21623,,214,,222,,-8,1101,,76,1025,1155,,102,-17,1053,-54,-64,,21559
212373,3000,Male,GM0642,Zwijndrecht,2017JJ00,2017,21559,,244,,190,,54,1186,,97,1089,1157,,111,-29,1046,29,84,,21643
212374,3000,Male,GM0642,Zwijndrecht,2018JJ00,2018,21643,,238,,226,,12,1135,,118,1017,1134,,90,-17,1044,1,13,,21656
212375,3000,Male,GM0642,Zwijndrecht,2019JJ00,2019,21656,,236,,218,,18,1097,,107,990,1078,,87,-18,991,19,38,,21694
212376,3000,Male,GM0642,Zwijndrecht,2020JJ00,2020,21694,,221,,275,,-54,1139,,124,1015,1025,,65,3,960,114,60,,21754
212377,3000,Male,GM0642,Zwijndrecht,2021JJ00,2021,21754,,231,,255,,-24,1252,,115,1137,1234,,94,-12,1140,18,-6,,21748
212378,3000,Male,GM0642,Zwijndrecht,2022JJ00,2022,21748,,240,,247,,-7,1245,,245,1000,1095,,114,-35,981,150,143,,21891
212379,3000,Male,GM0642,Zwijndrecht,2023JJ00,2023,21891,,207,,238,,-31,1200,,131,1069,1200,,138,-27,1062,0,-31,,21860
212450,3000,Male,GM0193,Zwolle,2012JJ00,2012,59280,,892,,412,,480,2779,,305,2474,2623,,352,-66,2271,156,636,,59916
212451,3000,Male,GM0193,Zwolle,2013JJ00,2013,59916,,825,,431,,394,2747,,333,2414,2672,,343,-41,2329,75,471,,60387
212452,3000,Male,GM0193,Zwolle,2014JJ00,2014,60387,,816,,438,,378,2857,,299,2558,2856,,404,-98,2452,1,372,,60759
212453,3000,Male,GM0193,Zwolle,2015JJ00,2015,60759,,748,,459,,289,3120,,311,2809,2831,,286,-9,2545,289,583,,61342
212454,3000,Male,GM0193,Zwolle,2016JJ00,2016,61342,,781,,412,,369,3286,,368,2918,3267,,360,-38,2907,19,385,,61727
212455,3000,Male,GM0193,Zwolle,2017JJ00,2017,61727,,719,,467,,252,3180,,302,2878,3133,,329,-52,2804,47,303,,62030
212456,3000,Male,GM0193,Zwolle,2018JJ00,2018,62030,,743,,474,,269,3530,,422,3108,3034,,351,-32,2683,496,764,,62794
212457,3000,Male,GM0193,Zwolle,2019JJ00,2019,62794,,741,,456,,285,3276,,482,2794,2869,,367,-41,2502,407,694,,63488
212458,3000,Male,GM0193,Zwolle,2020JJ00,2020,63488,,738,,501,,237,3204,,355,2849,2983,,268,-19,2715,221,456,,63944
212459,3000,Male,GM0193,Zwolle,2021JJ00,2021,63944,,779,,535,,244,3136,,411,2725,2931,,290,-60,2641,205,436,,64380
212460,3000,Male,GM0193,Zwolle,2022JJ00,2022,64380,,745,,537,,208,3661,,872,2789,3068,,446,-66,2622,593,803,,65183
212461,3000,Male,GM0193,Zwolle,2023JJ00,2023,65183,,720,,542,,178,3444,,477,2967,3203,,444,-89,2759,241,412,,65595
212778,4000,Female,NL01  ,The Netherlands,2012JJ00,2012,8447477,,85779,,72906,,12873,388951,,77527,311424,377153,,65729,-13038,311424,11798,24759,,8472236
212779,4000,Female,NL01  ,The Netherlands,2013JJ00,2013,8472236,,83384,,72885,,10499,394409,,80708,313701,382451,,68750,-11995,313701,11958,22668,,8494904
212780,4000,Female,NL01  ,The Netherlands,2014JJ00,2014,8494904,,85671,,72102,,13569,420147,,87635,332512,400944,,68432,-9966,332512,19203,32964,,8527868
212781,4000,Female,NL01  ,The Netherlands,2015JJ00,2015,8527868,,83083,,76105,,6978,447701,,97064,350637,420516,,69879,-8845,350637,27185,34117,,8561985
212782,4000,Female,NL01  ,The Netherlands,2016JJ00,2016,8561985,,83933,,76817,,7116,488587,,108477,380110,451103,,70993,-9266,380110,37484,44420,,8606405
212783,4000,Female,NL01  ,The Netherlands,2017JJ00,2017,8606405,,82677,,77553,,5124,516813,,115083,401730,473829,,72099,-10263,401730,42984,47638,,8654043
212784,4000,Female,NL01  ,The Netherlands,2018JJ00,2018,8654043,,82321,,78841,,3480,499360,,118283,381077,455441,,74364,-8421,381077,43919,47034,,8701077
212785,4000,Female,NL01  ,The Netherlands,2019JJ00,2019,8701077,,82787,,77453,,5334,507007,,128968,378039,453483,,75444,-7863,378039,53524,58477,,8759554
212786,4000,Female,NL01  ,The Netherlands,2020JJ00,2020,8759554,,82184,,84361,,-2177,500434,,104283,396151,468529,,72378,-7100,396151,31905,29325,,8788879
212787,4000,Female,NL01  ,The Netherlands,2021JJ00,2021,8788879,,87624,,85203,,2421,519650,,121559,398091,465475,,67384,-5933,398091,54175,56325,,8845204
212788,4000,Female,NL01  ,The Netherlands,2022JJ00,2022,8845204,,81780,,86363,,-4583,598606,,208252,390354,477813,,87459,-8488,390354,120793,115778,,8960982
212789,4000,Female,NL01  ,The Netherlands,2023JJ00,2023,8960982,,80215,,85602,,-5387,565872,,163057,402815,498847,,96032,-12316,402815,67025,61192,,9022174
212860,4000,Female,LD01  ,Noord-Nederland (LD),2012JJ00,2012,863513,,8130,,8288,,-158,40174,,5814,34360,40521,,4735,-720,35786,-347,-502,,863011
212861,4000,Female,LD01  ,Noord-Nederland (LD),2013JJ00,2013,863011,,7758,,8197,,-439,40813,,6087,34726,40671,,4527,-569,36144,142,-270,,862741
212862,4000,Female,LD01  ,Noord-Nederland (LD),2014JJ00,2014,862741,,7886,,8078,,-192,42808,,6930,35878,43075,,5039,-778,38036,-267,-466,,862275
212863,4000,Female,LD01  ,Noord-Nederland (LD),2015JJ00,2015,862275,,7535,,8480,,-945,45962,,8616,37346,45818,,4852,-759,40966,144,-802,,861473
212864,4000,Female,LD01  ,Noord-Nederland (LD),2016JJ00,2016,861473,,7589,,8744,,-1155,55438,,14071,41367,52833,,5078,-798,47755,2605,1437,,862910
212865,4000,Female,LD01  ,Noord-Nederland (LD),2017JJ00,2017,862910,,7451,,8850,,-1399,61026,,17412,43614,59859,,5116,-870,54743,1167,-243,,862667
212866,4000,Female,LD01  ,Noord-Nederland (LD),2018JJ00,2018,862667,,7158,,8995,,-1837,53539,,12364,41175,51180,,5050,-580,46130,2359,504,,863171
212867,4000,Female,LD01  ,Noord-Nederland (LD),2019JJ00,2019,863171,,7325,,8559,,-1234,51337,,12054,39283,47623,,5268,-597,42355,3714,2464,,865635
212868,4000,Female,LD01  ,Noord-Nederland (LD),2020JJ00,2020,865635,,7214,,8750,,-1536,49836,,9762,40074,46960,,5105,-636,41855,2876,1332,,866967
212869,4000,Female,LD01  ,Noord-Nederland (LD),2021JJ00,2021,866967,,7857,,9493,,-1636,54637,,14164,40473,48836,,4665,-614,44171,5801,4160,,871127
212870,4000,Female,LD01  ,Noord-Nederland (LD),2022JJ00,2022,871127,,7319,,9747,,-2428,62094,,22842,39252,51187,,6463,-740,44724,10907,8448,,879575
212871,4000,Female,LD01  ,Noord-Nederland (LD),2023JJ00,2023,879575,,7201,,9553,,-2352,59281,,18059,41222,52843,,7444,-1151,45399,6438,4078,,883653
212942,4000,Female,LD02  ,Oost-Nederland (LD),2012JJ00,2012,1784723,,18269,,14993,,3276,74018,,11075,62943,72667,,9001,-1403,63666,1351,4675,,1789398
212943,4000,Female,LD02  ,Oost-Nederland (LD),2013JJ00,2013,1789398,,17669,,15027,,2642,73440,,11522,61918,74232,,10221,-1951,64011,-792,1870,,1791268
212944,4000,Female,LD02  ,Oost-Nederland (LD),2014JJ00,2014,1791268,,17999,,14822,,3177,77392,,12122,65270,76701,,9902,-1323,66799,691,3988,,1795256
212945,4000,Female,LD02  ,Oost-Nederland (LD),2015JJ00,2015,1795256,,17542,,15685,,1857,82875,,14325,68550,78747,,9976,-1339,68771,4128,5998,,1801254
212946,4000,Female,LD02  ,Oost-Nederland (LD),2016JJ00,2016,1801254,,17417,,15775,,1642,90564,,14687,75877,84304,,10125,-1365,74179,6260,7869,,1809123
212947,4000,Female,LD02  ,Oost-Nederland (LD),2017JJ00,2017,1809123,,17306,,15953,,1353,96085,,13712,82373,87654,,9895,-1443,77759,8431,9691,,1818814
212948,4000,Female,LD02  ,Oost-Nederland (LD),2018JJ00,2018,1818814,,17247,,16476,,771,93155,,15205,77950,84129,,10014,-1137,74115,9026,9757,,1828571
212949,4000,Female,LD02  ,Oost-Nederland (LD),2019JJ00,2019,1828571,,17239,,16441,,798,94844,,17062,77782,83595,,10442,-1333,73153,11249,11950,,1840521
212950,4000,Female,LD02  ,Oost-Nederland (LD),2020JJ00,2020,1840521,,17495,,17620,,-125,94148,,13913,80235,84627,,9390,-1200,75237,9521,9318,,1849839
212951,4000,Female,LD02  ,Oost-Nederland (LD),2021JJ00,2021,1849839,,18319,,17962,,357,94822,,14965,79857,82727,,9217,-1227,73510,12095,12409,,1862248
212952,4000,Female,LD02  ,Oost-Nederland (LD),2022JJ00,2022,1862248,,17547,,18413,,-866,110903,,32183,78720,85978,,13340,-1795,72638,24925,23976,,1886224
212953,4000,Female,LD02  ,Oost-Nederland (LD),2023JJ00,2023,1886224,,17247,,17906,,-659,104079,,22675,81404,91133,,14927,-2792,76206,12946,12220,,1898444
213024,4000,Female,LD03  ,West-Nederland (LD),2012JJ00,2012,3999336,,43313,,33553,,9760,199022,,45695,153327,190709,,40807,-9418,149902,8313,18088,,4017424
213025,4000,Female,LD03  ,West-Nederland (LD),2013JJ00,2013,4017424,,42022,,33490,,8532,202312,,47142,155170,192649,,42057,-8372,150592,9663,18347,,4035771
213026,4000,Female,LD03  ,West-Nederland (LD),2014JJ00,2014,4035771,,43532,,33046,,10486,217694,,51516,166178,201888,,40588,-6377,161300,15806,26380,,4062151
213027,4000,Female,LD03  ,West-Nederland (LD),2015JJ00,2015,4062151,,42247,,34780,,7467,231268,,54735,176533,213064,,41548,-5202,171516,18204,25616,,4087767
213028,4000,Female,LD03  ,West-Nederland (LD),2016JJ00,2016,4087767,,42837,,35200,,7637,247660,,58551,189109,226120,,42348,-5512,183772,21540,29095,,4116862
213029,4000,Female,LD03  ,West-Nederland (LD),2017JJ00,2017,4116862,,42279,,35183,,7096,258784,,62581,196203,234377,,43457,-6505,190920,24407,31253,,4148115
213030,4000,Female,LD03  ,West-Nederland (LD),2018JJ00,2018,4148115,,42110,,35462,,6648,255340,,68373,186967,231799,,44481,-5134,187318,23541,29959,,4178074
213031,4000,Female,LD03  ,West-Nederland (LD),2019JJ00,2019,4178074,,42508,,34950,,7558,261890,,75087,186803,234067,,44597,-4107,189470,27823,35181,,4213255
213032,4000,Female,LD03  ,West-Nederland (LD),2020JJ00,2020,4213255,,41749,,38193,,3556,256951,,58986,197965,245267,,43210,-3954,202057,11684,15004,,4228259
213033,4000,Female,LD03  ,West-Nederland (LD),2021JJ00,2021,4228259,,44394,,38101,,6293,267328,,67567,199761,243587,,39047,-2773,204540,23741,29833,,4258092
213034,4000,Female,LD03  ,West-Nederland (LD),2022JJ00,2022,4258092,,40930,,38708,,2222,308260,,111430,196830,248726,,49330,-4233,199396,59534,61455,,4319547
213035,4000,Female,LD03  ,West-Nederland (LD),2023JJ00,2023,4319547,,40105,,38362,,1743,290776,,87439,203337,257682,,54239,-6058,203443,33094,34494,,4354041
213106,4000,Female,LD04  ,Zuid-Nederland (LD),2012JJ00,2012,1799905,,16067,,16072,,-5,75737,,14943,60794,73256,,11186,-1497,62070,2481,2498,,1802403
213107,4000,Female,LD04  ,Zuid-Nederland (LD),2013JJ00,2013,1802403,,15935,,16171,,-236,77844,,15957,61887,74899,,11945,-1103,62954,2945,2721,,1805124
213108,4000,Female,LD04  ,Zuid-Nederland (LD),2014JJ00,2014,1805124,,16254,,16156,,98,82253,,17067,65186,79280,,12903,-1488,66377,2973,3062,,1808186
213109,4000,Female,LD04  ,Zuid-Nederland (LD),2015JJ00,2015,1808186,,15759,,17160,,-1401,87596,,19388,68208,82887,,13503,-1545,69384,4709,3305,,1811491
213110,4000,Female,LD04  ,Zuid-Nederland (LD),2016JJ00,2016,1811491,,16090,,17098,,-1008,94925,,21168,73757,87846,,13442,-1591,74404,7079,6019,,1817510
213111,4000,Female,LD04  ,Zuid-Nederland (LD),2017JJ00,2017,1817510,,15641,,17567,,-1926,100918,,21378,79540,91939,,13631,-1445,78308,8979,6937,,1824447
213112,4000,Female,LD04  ,Zuid-Nederland (LD),2018JJ00,2018,1824447,,15806,,17908,,-2102,97326,,22341,74985,88333,,14819,-1570,73514,8993,6814,,1831261
213113,4000,Female,LD04  ,Zuid-Nederland (LD),2019JJ00,2019,1831261,,15715,,17503,,-1788,98936,,24765,74171,88198,,15137,-1826,73061,10738,8882,,1840143
213114,4000,Female,LD04  ,Zuid-Nederland (LD),2020JJ00,2020,1840143,,15726,,19798,,-4072,99499,,21622,77877,91675,,14673,-1310,77002,7824,3671,,1843814
213115,4000,Female,LD04  ,Zuid-Nederland (LD),2021JJ00,2021,1843814,,17054,,19647,,-2593,102863,,24863,78000,90325,,14455,-1319,75870,12538,9923,,1853737
213116,4000,Female,LD04  ,Zuid-Nederland (LD),2022JJ00,2022,1853737,,15984,,19495,,-3511,117349,,41797,75552,91922,,18326,-1720,73596,25427,21899,,1875636
213117,4000,Female,LD04  ,Zuid-Nederland (LD),2023JJ00,2023,1875636,,15662,,19781,,-4119,111736,,34884,76852,97189,,19422,-2315,77767,14547,10400,,1886036
213188,4000,Female,PV20  ,Groningen Province (PV),2012JJ00,2012,292121,,2772,,2807,,-35,17723,,3211,14512,17375,,2669,-493,14706,348,309,,292430
213189,4000,Female,PV20  ,Groningen Province (PV),2013JJ00,2013,292430,,2655,,2803,,-148,17953,,3347,14606,17330,,2510,-415,14820,623,478,,292908
213190,4000,Female,PV20  ,Groningen Province (PV),2014JJ00,2014,292908,,2696,,2768,,-72,19261,,4172,15089,18991,,2834,-534,16157,270,194,,293102
213191,4000,Female,PV20  ,Groningen Province (PV),2015JJ00,2015,293102,,2626,,2856,,-230,20605,,5170,15435,20814,,2850,-547,17964,-209,-439,,292663
213192,4000,Female,PV20  ,Groningen Province (PV),2016JJ00,2016,292663,,2641,,2936,,-295,22111,,5368,16743,22173,,2967,-579,19206,-62,-373,,292290
213193,4000,Female,PV20  ,Groningen Province (PV),2017JJ00,2017,292290,,2512,,2925,,-413,21857,,4589,17268,21717,,3016,-582,18701,140,-284,,292006
213194,4000,Female,PV20  ,Groningen Province (PV),2018JJ00,2018,292006,,2417,,3004,,-587,25266,,9137,16129,24135,,2881,-312,21254,1131,548,,292554
213195,4000,Female,PV20  ,Groningen Province (PV),2019JJ00,2019,292554,,2398,,2732,,-334,23227,,8557,14670,22031,,3184,-433,18847,1196,868,,293422
213196,4000,Female,PV20  ,Groningen Province (PV),2020JJ00,2020,293422,,2291,,2843,,-552,22042,,7076,14966,21353,,3280,-465,18073,689,154,,293576
213197,4000,Female,PV20  ,Groningen Province (PV),2021JJ00,2021,293576,,2570,,3096,,-526,26025,,11510,14515,23891,,2754,-293,21137,2134,1646,,295222
213198,4000,Female,PV20  ,Groningen Province (PV),2022JJ00,2022,295222,,2481,,3089,,-608,29478,,15097,14381,25583,,3365,-254,22218,3895,3280,,298502
213199,4000,Female,PV20  ,Groningen Province (PV),2023JJ00,2023,298502,,2435,,3123,,-688,28763,,12615,16148,25548,,3896,-420,21652,3215,2559,,301061
213270,4000,Female,PV21  ,Fryslân (PV),2012JJ00,2012,323719,,3195,,2992,,203,13203,,1648,11555,13710,,1343,-115,12367,-507,-299,,323420
213271,4000,Female,PV21  ,Fryslân (PV),2013JJ00,2013,323420,,3022,,2960,,62,13714,,1716,11998,14145,,1332,-94,12813,-431,-345,,323075
213272,4000,Female,PV21  ,Fryslân (PV),2014JJ00,2014,323075,,3097,,2920,,177,14111,,1759,12352,14497,,1416,-122,13081,-386,-216,,322859
213273,4000,Female,PV21  ,Fryslân (PV),2015JJ00,2015,322859,,2961,,3048,,-87,14393,,1817,12576,14510,,1209,-64,13301,-117,-195,,322664
213274,4000,Female,PV21  ,Fryslân (PV),2016JJ00,2016,322664,,2887,,3197,,-310,15871,,1848,14023,15393,,1341,-126,14052,478,162,,322826
213275,4000,Female,PV21  ,Fryslân (PV),2017JJ00,2017,322826,,2885,,3291,,-406,16450,,1768,14682,16104,,1455,-229,14649,346,-49,,322777
213276,4000,Female,PV21  ,Fryslân (PV),2018JJ00,2018,322777,,2819,,3273,,-454,15926,,2096,13830,15238,,1423,-164,13815,688,229,,323006
213277,4000,Female,PV21  ,Fryslân (PV),2019JJ00,2019,323006,,2933,,3171,,-238,15917,,2255,13662,14686,,1349,-92,13337,1231,1000,,324006
213278,4000,Female,PV21  ,Fryslân (PV),2020JJ00,2020,324006,,2869,,3128,,-259,15651,,1792,13859,14737,,1252,-112,13485,914,641,,324647
213279,4000,Female,PV21  ,Fryslân (PV),2021JJ00,2021,324647,,3110,,3496,,-386,16021,,1744,14277,14400,,1226,-177,13174,1621,1217,,325864
213280,4000,Female,PV21  ,Fryslân (PV),2022JJ00,2022,325864,,2828,,3585,,-757,18286,,4513,13773,14719,,1961,-285,12758,3567,2798,,328662
213281,4000,Female,PV21  ,Fryslân (PV),2023JJ00,2023,328662,,2757,,3508,,-751,17458,,3315,14143,15799,,2174,-417,13625,1659,895,,329557
213352,4000,Female,PV22  ,Drenthe (PV),2012JJ00,2012,247673,,2163,,2489,,-326,9248,,955,8293,9436,,723,-112,8713,-188,-512,,247161
213353,4000,Female,PV22  ,Drenthe (PV),2013JJ00,2013,247161,,2081,,2434,,-353,9146,,1024,8122,9196,,685,-60,8511,-50,-403,,246758
213354,4000,Female,PV22  ,Drenthe (PV),2014JJ00,2014,246758,,2093,,2390,,-297,9436,,999,8437,9587,,789,-122,8798,-151,-444,,246314
213355,4000,Female,PV22  ,Drenthe (PV),2015JJ00,2015,246314,,1948,,2576,,-628,10964,,1629,9335,10494,,793,-148,9701,470,-168,,246146
213356,4000,Female,PV22  ,Drenthe (PV),2016JJ00,2016,246146,,2061,,2611,,-550,17456,,6855,10601,15267,,770,-93,14497,2189,1648,,247794
213357,4000,Female,PV22  ,Drenthe (PV),2017JJ00,2017,247794,,2054,,2634,,-580,22719,,11055,11664,22038,,645,-59,21393,681,90,,247884
213358,4000,Female,PV22  ,Drenthe (PV),2018JJ00,2018,247884,,1922,,2718,,-796,12347,,1131,11216,11807,,746,-104,11061,540,-273,,247611
213359,4000,Female,PV22  ,Drenthe (PV),2019JJ00,2019,247611,,1994,,2656,,-662,12193,,1242,10951,10906,,735,-72,10171,1287,596,,248207
213360,4000,Female,PV22  ,Drenthe (PV),2020JJ00,2020,248207,,2054,,2779,,-725,12143,,894,11249,10870,,573,-59,10297,1273,537,,248744
213361,4000,Female,PV22  ,Drenthe (PV),2021JJ00,2021,248744,,2177,,2901,,-724,12591,,910,11681,10545,,685,-144,9860,2046,1297,,250041
213362,4000,Female,PV22  ,Drenthe (PV),2022JJ00,2022,250041,,2010,,3073,,-1063,14330,,3232,11098,10885,,1137,-201,9748,3445,2370,,252411
213363,4000,Female,PV22  ,Drenthe (PV),2023JJ00,2023,252411,,2009,,2922,,-913,13060,,2129,10931,11496,,1374,-314,10122,1564,624,,253035
213434,4000,Female,PV23  ,Overijssel (PV),2012JJ00,2012,568904,,6077,,4835,,1242,20649,,3331,17318,21132,,2789,-431,18343,-483,756,,569660
213435,4000,Female,PV23  ,Overijssel (PV),2013JJ00,2013,569660,,5945,,5047,,898,20262,,3160,17102,21341,,3049,-467,18292,-1079,-177,,569483
213436,4000,Female,PV23  ,Overijssel (PV),2014JJ00,2014,569483,,5879,,4975,,904,21116,,3248,17868,21761,,2953,-449,18808,-645,275,,569758
213437,4000,Female,PV23  ,Overijssel (PV),2015JJ00,2015,569758,,5639,,5215,,424,22763,,3794,18969,21981,,2910,-337,19071,782,1198,,570956
213438,4000,Female,PV23  ,Overijssel (PV),2016JJ00,2016,570956,,5800,,5250,,550,24344,,3742,20602,23580,,2910,-412,20670,764,1303,,572259
213439,4000,Female,PV23  ,Overijssel (PV),2017JJ00,2017,572259,,5528,,5147,,381,25718,,3646,22072,24273,,2691,-320,21582,1445,1811,,574070
213440,4000,Female,PV23  ,Overijssel (PV),2018JJ00,2018,574070,,5508,,5450,,58,24976,,3877,21099,23136,,2596,-169,20540,1840,1870,,575940
213441,4000,Female,PV23  ,Overijssel (PV),2019JJ00,2019,575940,,5477,,5340,,137,25374,,4407,20967,22756,,2828,-312,19928,2618,2710,,578650
213442,4000,Female,PV23  ,Overijssel (PV),2020JJ00,2020,578650,,5351,,5714,,-363,25146,,3628,21518,22930,,2430,-275,20500,2216,1828,,580478
213443,4000,Female,PV23  ,Overijssel (PV),2021JJ00,2021,580478,,5634,,5873,,-239,24886,,3881,21005,22351,,2511,-306,19840,2535,2274,,582752
213444,4000,Female,PV23  ,Overijssel (PV),2022JJ00,2022,582752,,5598,,5902,,-304,30254,,9108,21146,23295,,3683,-422,19612,6959,6627,,589379
213445,4000,Female,PV23  ,Overijssel (PV),2023JJ00,2023,589379,,5284,,5813,,-529,27496,,5967,21529,25443,,4041,-771,21402,2053,1496,,590875
213516,4000,Female,PV24  ,Flevoland (PV),2012JJ00,2012,197742,,2465,,1112,,1353,7864,,1788,6076,7841,,1285,-109,6556,23,1385,,199127
213517,4000,Female,PV24  ,Flevoland (PV),2013JJ00,2013,199127,,2269,,1093,,1176,8005,,2240,5765,8370,,1571,-257,6799,-365,816,,199943
213518,4000,Female,PV24  ,Flevoland (PV),2014JJ00,2014,199943,,2474,,1050,,1424,8330,,2497,5833,8946,,1636,-167,7310,-616,899,,200842
213519,4000,Female,PV24  ,Flevoland (PV),2015JJ00,2015,200842,,2261,,1142,,1119,9658,,3026,6632,9710,,1717,-251,7993,-52,1069,,201911
213520,4000,Female,PV24  ,Flevoland (PV),2016JJ00,2016,201911,,2252,,1164,,1088,10397,,2748,7649,9718,,1557,-143,8161,679,1769,,203680
213521,4000,Female,PV24  ,Flevoland (PV),2017JJ00,2017,203680,,2257,,1144,,1113,10841,,2174,8667,9865,,1643,-177,8222,976,2078,,205758
213522,4000,Female,PV24  ,Flevoland (PV),2018JJ00,2018,205758,,2321,,1266,,1055,11065,,2518,8547,9564,,1629,-96,7935,1501,2550,,208308
213523,4000,Female,PV24  ,Flevoland (PV),2019JJ00,2019,208308,,2352,,1201,,1151,11814,,3019,8795,9882,,1693,-115,8189,1932,3070,,211378
213524,4000,Female,PV24  ,Flevoland (PV),2020JJ00,2020,211378,,2387,,1293,,1094,11606,,2239,9367,10157,,1427,-119,8730,1449,2547,,213925
213525,4000,Female,PV24  ,Flevoland (PV),2021JJ00,2021,213925,,2536,,1405,,1131,12581,,2549,10032,10443,,1688,-167,8755,2138,3261,,217186
213526,4000,Female,PV24  ,Flevoland (PV),2022JJ00,2022,217186,,2572,,1403,,1169,15215,,5352,9863,11253,,2513,-272,8740,3962,5112,,222298
213527,4000,Female,PV24  ,Flevoland (PV),2023JJ00,2023,222298,,2437,,1423,,1014,13527,,3892,9635,11539,,2856,-386,8683,1988,2993,,225291
213598,4000,Female,PV25  ,Gelderland (PV),2012JJ00,2012,1018077,,9727,,9046,,681,45505,,5956,39549,43694,,4927,-863,38767,1811,2534,,1020611
213599,4000,Female,PV25  ,Gelderland (PV),2013JJ00,2013,1020611,,9455,,8887,,568,45173,,6122,39051,44521,,5601,-1227,38920,652,1231,,1021842
213600,4000,Female,PV25  ,Gelderland (PV),2014JJ00,2014,1021842,,9646,,8797,,849,47946,,6377,41569,45994,,5313,-707,40681,1952,2814,,1024656
213601,4000,Female,PV25  ,Gelderland (PV),2015JJ00,2015,1024656,,9642,,9328,,314,50454,,7505,42949,47056,,5349,-751,41707,3398,3731,,1028387
213602,4000,Female,PV25  ,Gelderland (PV),2016JJ00,2016,1028387,,9365,,9361,,4,55823,,8197,47626,51006,,5658,-810,45348,4817,4797,,1033184
213603,4000,Female,PV25  ,Gelderland (PV),2017JJ00,2017,1033184,,9521,,9662,,-141,59526,,7892,51634,53516,,5561,-946,47955,6010,5802,,1038986
213604,4000,Female,PV25  ,Gelderland (PV),2018JJ00,2018,1038986,,9418,,9760,,-342,57114,,8810,48304,51429,,5789,-872,45640,5685,5337,,1044323
213605,4000,Female,PV25  ,Gelderland (PV),2019JJ00,2019,1044323,,9410,,9900,,-490,57656,,9636,48020,50957,,5921,-906,45036,6699,6170,,1050493
213606,4000,Female,PV25  ,Gelderland (PV),2020JJ00,2020,1050493,,9757,,10613,,-856,57396,,8046,49350,51540,,5533,-806,46007,5856,4943,,1055436
213607,4000,Female,PV25  ,Gelderland (PV),2021JJ00,2021,1055436,,10149,,10684,,-535,57355,,8535,48820,49933,,5018,-754,44915,7422,6874,,1062310
213608,4000,Female,PV25  ,Gelderland (PV),2022JJ00,2022,1062310,,9377,,11108,,-1731,65434,,17723,47711,51430,,7144,-1101,44286,14004,12237,,1074547
213609,4000,Female,PV25  ,Gelderland (PV),2023JJ00,2023,1074547,,9526,,10670,,-1144,63056,,12816,50240,54151,,8030,-1635,46121,8905,7731,,1082278
213680,4000,Female,PV26  ,Utrecht Province (PV),2012JJ00,2012,632085,,7219,,4701,,2518,32574,,4854,27720,31180,,4316,-524,26864,1394,3864,,635949
213681,4000,Female,PV26  ,Utrecht Province (PV),2013JJ00,2013,635949,,6986,,4759,,2227,33522,,5185,28337,31722,,4644,-448,27078,1800,4049,,639998
213682,4000,Female,PV26  ,Utrecht Province (PV),2014JJ00,2014,639998,,7287,,4824,,2463,36265,,5359,30906,34063,,4493,-322,29570,2202,4686,,644684
213683,4000,Female,PV26  ,Utrecht Province (PV),2015JJ00,2015,644684,,7034,,5011,,2023,38550,,5985,32565,36112,,4631,-394,31481,2438,4454,,649138
213684,4000,Female,PV26  ,Utrecht Province (PV),2016JJ00,2016,649138,,7088,,5122,,1966,40789,,6276,34513,37727,,4241,-273,33486,3062,5021,,654159
213685,4000,Female,PV26  ,Utrecht Province (PV),2017JJ00,2017,654159,,7161,,5066,,2095,41585,,6368,35217,38284,,4504,-447,33780,3301,5374,,659533
213686,4000,Female,PV26  ,Utrecht Province (PV),2018JJ00,2018,659533,,6966,,5147,,1819,41053,,6821,34232,37561,,4866,-431,32695,3492,5290,,664823
213687,4000,Female,PV26  ,Utrecht Province (PV),2019JJ00,2019,682596,,7270,,5366,,1904,41944,,7639,34305,37993,,4994,-332,32999,3951,5825,,688421
213688,4000,Female,PV26  ,Utrecht Province (PV),2020JJ00,2020,688421,,7163,,5768,,1395,41353,,5941,35412,40175,,4522,-123,35653,1178,2554,,690975
213689,4000,Female,PV26  ,Utrecht Province (PV),2021JJ00,2021,690975,,7675,,5757,,1918,43139,,6918,36221,40501,,4183,-303,36318,2638,4521,,695496
213690,4000,Female,PV26  ,Utrecht Province (PV),2022JJ00,2022,695496,,6983,,5959,,1024,48494,,12587,35907,40157,,5466,-284,34691,8337,9335,,704831
213691,4000,Female,PV26  ,Utrecht Province (PV),2023JJ00,2023,704831,,6939,,5930,,1009,47114,,9003,38111,41712,,5894,-603,35818,5402,6401,,711232
213762,4000,Female,PV27  ,Noord-Holland (PV),2012JJ00,2012,1376011,,14533,,11647,,2886,72151,,17534,54617,67637,,15947,-3685,51690,4514,7415,,1383426
213763,4000,Female,PV27  ,Noord-Holland (PV),2013JJ00,2013,1383426,,14222,,11365,,2857,73471,,18150,55321,68109,,16037,-2895,52072,5362,8295,,1391721
213764,4000,Female,PV27  ,Noord-Holland (PV),2014JJ00,2014,1391721,,14709,,11357,,3352,80785,,20888,59897,74049,,16128,-2629,57921,6736,10139,,1401860
213765,4000,Female,PV27  ,Noord-Holland (PV),2015JJ00,2015,1401860,,14257,,11898,,2359,86955,,22728,64227,78809,,16585,-1657,62224,8146,10532,,1412392
213766,4000,Female,PV27  ,Noord-Holland (PV),2016JJ00,2016,1412392,,14433,,12083,,2350,91925,,25020,66905,83649,,17030,-1494,66619,8276,10626,,1423018
213767,4000,Female,PV27  ,Noord-Holland (PV),2017JJ00,2017,1423018,,14211,,11868,,2343,95201,,27167,68034,87249,,18161,-2339,69088,7952,10220,,1433238
213768,4000,Female,PV27  ,Noord-Holland (PV),2018JJ00,2018,1433238,,14421,,12076,,2345,95995,,31039,64956,87742,,19166,-2029,68576,8253,10552,,1443790
213769,4000,Female,PV27  ,Noord-Holland (PV),2019JJ00,2019,1443790,,14307,,11833,,2474,100574,,34227,66347,90528,,19483,-1631,71045,10046,12434,,1456224
213770,4000,Female,PV27  ,Noord-Holland (PV),2020JJ00,2020,1456224,,14215,,12800,,1415,96487,,25739,70748,94132,,18476,-954,75656,2355,3703,,1459927
213771,4000,Female,PV27  ,Noord-Holland (PV),2021JJ00,2021,1459927,,15158,,12814,,2344,101370,,30168,71202,92238,,16719,-789,75519,9132,11423,,1471350
213772,4000,Female,PV27  ,Noord-Holland (PV),2022JJ00,2022,1471350,,13920,,13219,,701,118664,,48840,69824,95938,,21103,-1415,74835,22726,23311,,1494661
213773,4000,Female,PV27  ,Noord-Holland (PV),2023JJ00,2023,1494661,,13442,,13075,,367,109769,,39165,70604,98186,,23594,-2123,74592,11583,11788,,1506449
213844,4000,Female,PV28  ,Zuid-Holland (PV),2012JJ00,2012,1799014,,19761,,15288,,4473,86605,,21560,65045,84290,,19426,-4966,64864,2315,6840,,1805854
213845,4000,Female,PV28  ,Zuid-Holland (PV),2013JJ00,2013,1805854,,19094,,15450,,3644,87773,,22128,65645,85221,,20344,-4875,64877,2552,6251,,1812105
213846,4000,Female,PV28  ,Zuid-Holland (PV),2014JJ00,2014,1812105,,19746,,15096,,4650,92933,,23659,69274,86100,,18771,-3226,67329,6833,11494,,1823599
213847,4000,Female,PV28  ,Zuid-Holland (PV),2015JJ00,2015,1823599,,19199,,15896,,3303,97672,,24262,73410,90391,,19150,-2971,71241,7281,10501,,1834100
213848,4000,Female,PV28  ,Zuid-Holland (PV),2016JJ00,2016,1834100,,19607,,16002,,3605,106078,,25305,80773,96256,,19863,-3557,76393,9822,13354,,1847454
213849,4000,Female,PV28  ,Zuid-Holland (PV),2017JJ00,2017,1847454,,19200,,16202,,2998,112701,,27254,85447,100289,,19623,-3563,80666,12412,15269,,1862723
213850,4000,Female,PV28  ,Zuid-Holland (PV),2018JJ00,2018,1862723,,19082,,16185,,2897,109009,,28456,80553,97931,,19149,-2489,78782,11078,13808,,1876531
213851,4000,Female,PV28  ,Zuid-Holland (PV),2019JJ00,2019,1858758,,19291,,15757,,3534,110358,,31141,79217,97015,,18807,-1987,78208,13343,16799,,1875557
213852,4000,Female,PV28  ,Zuid-Holland (PV),2020JJ00,2020,1875557,,18683,,17574,,1109,109747,,25453,84294,102900,,19037,-2741,83863,6847,7824,,1883381
213853,4000,Female,PV28  ,Zuid-Holland (PV),2021JJ00,2021,1883381,,19770,,17221,,2549,113722,,28625,85097,102911,,16853,-1490,86058,10811,13260,,1896641
213854,4000,Female,PV28  ,Zuid-Holland (PV),2022JJ00,2022,1896641,,18344,,17353,,991,129699,,45999,83700,104152,,20916,-2326,83236,25547,26397,,1923038
213855,4000,Female,PV28  ,Zuid-Holland (PV),2023JJ00,2023,1923038,,18098,,17137,,961,124038,,36706,87332,108536,,23003,-3089,85533,15502,16306,,1939344
213926,4000,Female,PV29  ,Zeeland (PV),2012JJ00,2012,192226,,1800,,1917,,-117,7692,,1747,5945,7602,,1118,-243,6484,90,-31,,192195
213927,4000,Female,PV29  ,Zeeland (PV),2013JJ00,2013,192195,,1720,,1916,,-196,7546,,1679,5867,7597,,1032,-154,6565,-51,-248,,191947
213928,4000,Female,PV29  ,Zeeland (PV),2014JJ00,2014,191947,,1790,,1769,,21,7711,,1610,6101,7676,,1196,-200,6480,35,61,,192008
213929,4000,Female,PV29  ,Zeeland (PV),2015JJ00,2015,192008,,1757,,1975,,-218,8091,,1760,6331,7752,,1182,-180,6570,339,129,,192137
213930,4000,Female,PV29  ,Zeeland (PV),2016JJ00,2016,192137,,1709,,1993,,-284,8868,,1950,6918,8488,,1214,-188,7274,380,94,,192231
213931,4000,Female,PV29  ,Zeeland (PV),2017JJ00,2017,192231,,1707,,2047,,-340,9297,,1792,7505,8555,,1169,-156,7386,742,390,,192621
213932,4000,Female,PV29  ,Zeeland (PV),2018JJ00,2018,192621,,1641,,2054,,-413,9283,,2057,7226,8565,,1300,-185,7265,718,309,,192930
213933,4000,Female,PV29  ,Zeeland (PV),2019JJ00,2019,192930,,1640,,1994,,-354,9014,,2080,6934,8531,,1313,-157,7218,483,123,,193053
213934,4000,Female,PV29  ,Zeeland (PV),2020JJ00,2020,193053,,1688,,2051,,-363,9364,,1853,7511,8060,,1175,-136,6885,1304,923,,193976
213935,4000,Female,PV29  ,Zeeland (PV),2021JJ00,2021,193976,,1791,,2309,,-518,9097,,1856,7241,7937,,1292,-191,6645,1160,629,,194605
213936,4000,Female,PV29  ,Zeeland (PV),2022JJ00,2022,194605,,1683,,2177,,-494,11403,,4004,7399,8479,,1845,-208,6634,2924,2412,,197017
213937,4000,Female,PV29  ,Zeeland (PV),2023JJ00,2023,197017,,1626,,2220,,-594,9855,,2565,7290,9248,,1748,-243,7500,607,-1,,197016
214008,4000,Female,PV30  ,Noord-Brabant (PV),2012JJ00,2012,1233718,,11613,,10446,,1167,51079,,9079,42000,49020,,7056,-1111,41964,2059,3255,,1236973
214009,4000,Female,PV30  ,Noord-Brabant (PV),2013JJ00,2013,1236973,,11459,,10494,,965,53124,,9985,43139,50478,,7475,-760,43003,2646,3633,,1240606
214010,4000,Female,PV30  ,Noord-Brabant (PV),2014JJ00,2014,1240606,,11909,,10563,,1346,56330,,10730,45600,53397,,8105,-1117,45292,2933,4289,,1244895
214011,4000,Female,PV30  ,Noord-Brabant (PV),2015JJ00,2015,1244895,,11493,,11249,,244,60158,,12378,47780,56196,,8347,-1118,47849,3962,4213,,1249108
214012,4000,Female,PV30  ,Noord-Brabant (PV),2016JJ00,2016,1249108,,11729,,11281,,448,66000,,14205,51795,60519,,8600,-1254,51919,5481,5905,,1255013
214013,4000,Female,PV30  ,Noord-Brabant (PV),2017JJ00,2017,1255013,,11419,,11478,,-59,70258,,14210,56048,62945,,8436,-1083,54509,7313,7180,,1262193
214014,4000,Female,PV30  ,Noord-Brabant (PV),2018JJ00,2018,1262193,,11515,,11809,,-294,67612,,14785,52827,59723,,8970,-1215,50753,7889,7533,,1269726
214015,4000,Female,PV30  ,Noord-Brabant (PV),2019JJ00,2019,1269726,,11446,,11485,,-39,68360,,16293,52067,59734,,9240,-1377,50494,8626,8543,,1278269
214016,4000,Female,PV30  ,Noord-Brabant (PV),2020JJ00,2020,1278269,,11466,,13057,,-1591,68690,,14226,54464,62229,,8386,-1013,53843,6461,4822,,1283091
214017,4000,Female,PV30  ,Noord-Brabant (PV),2021JJ00,2021,1283091,,12448,,12745,,-297,71045,,16679,54366,61990,,8629,-866,53361,9055,8765,,1291856
214018,4000,Female,PV30  ,Noord-Brabant (PV),2022JJ00,2022,1291856,,11603,,12965,,-1362,80629,,28307,52322,62844,,10982,-1186,51862,17785,16428,,1308284
214019,4000,Female,PV30  ,Noord-Brabant (PV),2023JJ00,2023,1308284,,11318,,13051,,-1733,77350,,23624,53726,67420,,11929,-1609,55491,9930,8180,,1316464
214090,4000,Female,PV31  ,Limburg (PV),2012JJ00,2012,566187,,4454,,5626,,-1172,24658,,5864,18794,24236,,4130,-386,20106,422,-757,,565430
214091,4000,Female,PV31  ,Limburg (PV),2013JJ00,2013,565430,,4476,,5677,,-1201,24720,,5972,18748,24421,,4470,-343,19951,299,-912,,564518
214092,4000,Female,PV31  ,Limburg (PV),2014JJ00,2014,564518,,4345,,5593,,-1248,25923,,6337,19586,25883,,4798,-371,21085,40,-1227,,563291
214093,4000,Female,PV31  ,Limburg (PV),2015JJ00,2015,563291,,4266,,5911,,-1645,27438,,7010,20428,26691,,5156,-427,21535,747,-908,,562383
214094,4000,Female,PV31  ,Limburg (PV),2016JJ00,2016,562383,,4361,,5817,,-1456,28925,,6963,21962,27327,,4842,-337,22485,1598,114,,562497
214095,4000,Female,PV31  ,Limburg (PV),2017JJ00,2017,562497,,4222,,6089,,-1867,30660,,7168,23492,28994,,5195,-362,23799,1666,-243,,562254
214096,4000,Female,PV31  ,Limburg (PV),2018JJ00,2018,562254,,4291,,6099,,-1808,29714,,7556,22158,28610,,5849,-355,22761,1104,-719,,561535
214097,4000,Female,PV31  ,Limburg (PV),2019JJ00,2019,561535,,4269,,6018,,-1749,30576,,8472,22104,28464,,5897,-449,22567,2112,339,,561874
214098,4000,Female,PV31  ,Limburg (PV),2020JJ00,2020,561874,,4260,,6741,,-2481,30809,,7396,23413,29446,,6287,-297,23159,1363,-1151,,560723
214099,4000,Female,PV31  ,Limburg (PV),2021JJ00,2021,560723,,4606,,6902,,-2296,31818,,8184,23634,28335,,5826,-453,22509,3483,1158,,561881
214100,4000,Female,PV31  ,Limburg (PV),2022JJ00,2022,561881,,4381,,6530,,-2149,36720,,13490,23230,29078,,7344,-534,21734,7642,5471,,567352
214101,4000,Female,PV31  ,Limburg (PV),2023JJ00,2023,567352,,4344,,6730,,-2386,34386,,11260,23126,29769,,7493,-706,22276,4617,2220,,569572
214172,4000,Female,CR01  ,Oost-Groningen (CR),2012JJ00,2012,75847,,675,,865,,-190,3289,,300,2989,3531,,269,-81,3262,-242,-438,,75409
214173,4000,Female,CR01  ,Oost-Groningen (CR),2013JJ00,2013,75409,,659,,904,,-245,3159,,443,2716,3352,,234,-32,3118,-193,-437,,74972
214174,4000,Female,CR01  ,Oost-Groningen (CR),2014JJ00,2014,74972,,609,,875,,-266,3903,,1086,2817,3914,,212,-28,3702,-11,-285,,74687
214175,4000,Female,CR01  ,Oost-Groningen (CR),2015JJ00,2015,74687,,590,,881,,-291,5050,,1964,3086,5026,,277,-59,4749,24,-271,,74416
214176,4000,Female,CR01  ,Oost-Groningen (CR),2016JJ00,2016,74416,,622,,927,,-305,5061,,1678,3383,5311,,244,-38,5067,-250,-562,,73854
214177,4000,Female,CR01  ,Oost-Groningen (CR),2017JJ00,2017,73854,,567,,902,,-335,4738,,963,3775,4675,,224,-74,4451,63,-280,,73574
214178,4000,Female,CR01  ,Oost-Groningen (CR),2018JJ00,2018,67676,,512,,917,,-405,8165,,5052,3113,7796,,201,-28,7595,369,-24,,67652
214179,4000,Female,CR01  ,Oost-Groningen (CR),2019JJ00,2019,67652,,527,,795,,-268,7570,,4194,3376,7083,,189,-31,6894,487,236,,67888
214180,4000,Female,CR01  ,Oost-Groningen (CR),2020JJ00,2020,67888,,455,,854,,-399,7040,,3482,3558,6490,,199,-45,6291,550,171,,68059
214181,4000,Female,CR01  ,Oost-Groningen (CR),2021JJ00,2021,68059,,512,,955,,-443,10784,,7230,3554,10122,,158,-9,9964,662,266,,68325
214182,4000,Female,CR01  ,Oost-Groningen (CR),2022JJ00,2022,68325,,558,,887,,-329,11968,,8536,3432,11113,,313,-65,10800,855,532,,68857
214183,4000,Female,CR01  ,Oost-Groningen (CR),2023JJ00,2023,68857,,512,,928,,-416,10755,,7478,3277,10378,,383,-96,9995,377,16,,68873
214254,4000,Female,CR02  ,Delfzijl en omgeving (CR),2012JJ00,2012,24463,,201,,296,,-95,1034,,159,875,1111,,85,-23,1026,-77,-168,,24295
214255,4000,Female,CR02  ,Delfzijl en omgeving (CR),2013JJ00,2013,24295,,187,,289,,-102,1049,,151,898,1151,,103,-32,1048,-102,-203,,24092
214256,4000,Female,CR02  ,Delfzijl en omgeving (CR),2014JJ00,2014,24092,,224,,292,,-68,1127,,210,917,1279,,85,-12,1194,-152,-220,,23872
214257,4000,Female,CR02  ,Delfzijl en omgeving (CR),2015JJ00,2015,23872,,191,,316,,-125,1224,,252,972,1313,,83,-11,1230,-89,-214,,23658
214258,4000,Female,CR02  ,Delfzijl en omgeving (CR),2016JJ00,2016,23658,,211,,305,,-94,1353,,172,1181,1448,,73,-18,1375,-95,-191,,23467
214259,4000,Female,CR02  ,Delfzijl en omgeving (CR),2017JJ00,2017,23467,,189,,287,,-98,1275,,109,1166,1411,,71,-17,1340,-136,-236,,23231
214260,4000,Female,CR02  ,Delfzijl en omgeving (CR),2018JJ00,2018,23231,,153,,301,,-148,1266,,159,1107,1306,,68,-7,1238,-40,-189,,23042
214261,4000,Female,CR02  ,Delfzijl en omgeving (CR),2019JJ00,2019,23042,,187,,268,,-81,1289,,155,1134,1323,,79,-15,1244,-34,-115,,22927
214262,4000,Female,CR02  ,Delfzijl en omgeving (CR),2020JJ00,2020,22927,,140,,257,,-117,1199,,136,1063,1267,,59,-4,1208,-68,-181,,22746
214263,4000,Female,CR02  ,Delfzijl en omgeving (CR),2021JJ00,2021,22746,,212,,306,,-94,968,,137,831,991,,77,-6,914,-23,-117,,22629
214264,4000,Female,CR02  ,Delfzijl en omgeving (CR),2022JJ00,2022,22629,,168,,297,,-129,1323,,247,1076,1176,,93,-15,1083,147,22,,22651
214265,4000,Female,CR02  ,Delfzijl en omgeving (CR),2023JJ00,2023,22651,,203,,285,,-82,1036,,143,893,1179,,92,-5,1087,-143,-226,,22425
214336,4000,Female,CR03  ,Overig Groningen (CR),2012JJ00,2012,191811,,1896,,1646,,250,13400,,2752,10648,12733,,2315,-389,10418,667,915,,192726
214337,4000,Female,CR03  ,Overig Groningen (CR),2013JJ00,2013,192726,,1809,,1610,,199,13745,,2753,10992,12827,,2173,-351,10654,918,1118,,193844
214338,4000,Female,CR03  ,Overig Groningen (CR),2014JJ00,2014,193844,,1863,,1601,,262,14231,,2876,11355,13798,,2537,-494,11261,433,699,,194543
214339,4000,Female,CR03  ,Overig Groningen (CR),2015JJ00,2015,194543,,1845,,1659,,186,14331,,2954,11377,14475,,2490,-477,11985,-144,46,,194589
214340,4000,Female,CR03  ,Overig Groningen (CR),2016JJ00,2016,194589,,1808,,1704,,104,15697,,3518,12179,15414,,2650,-523,12764,283,380,,194969
214341,4000,Female,CR03  ,Overig Groningen (CR),2017JJ00,2017,194969,,1756,,1736,,20,15844,,3517,12327,15631,,2721,-491,12910,213,232,,195201
214342,4000,Female,CR03  ,Overig Groningen (CR),2018JJ00,2018,201099,,1752,,1786,,-34,15835,,3926,11909,15033,,2612,-277,12421,802,761,,201860
214343,4000,Female,CR03  ,Overig Groningen (CR),2019JJ00,2019,201860,,1684,,1669,,15,14368,,4208,10160,13625,,2916,-387,10709,743,747,,202607
214344,4000,Female,CR03  ,Overig Groningen (CR),2020JJ00,2020,202607,,1696,,1732,,-36,13803,,3458,10345,13596,,3022,-416,10574,207,164,,202771
214345,4000,Female,CR03  ,Overig Groningen (CR),2021JJ00,2021,202771,,1846,,1835,,11,14273,,4143,10130,12778,,2519,-278,10259,1495,1497,,204268
214346,4000,Female,CR03  ,Overig Groningen (CR),2022JJ00,2022,204268,,1755,,1905,,-150,16187,,6314,9873,13294,,2959,-174,10335,2893,2726,,206994
214347,4000,Female,CR03  ,Overig Groningen (CR),2023JJ00,2023,206994,,1720,,1910,,-190,16972,,4994,11978,13991,,3421,-319,10570,2981,2769,,209763
214418,4000,Female,CR04  ,Noord-Friesland (CR),2012JJ00,2012,166159,,1710,,1543,,167,7730,,1113,6617,7877,,902,-36,6975,-147,23,,166182
214419,4000,Female,CR04  ,Noord-Friesland (CR),2013JJ00,2013,166182,,1587,,1492,,95,8073,,1156,6917,8260,,940,-61,7320,-187,-83,,166099
214420,4000,Female,CR04  ,Noord-Friesland (CR),2014JJ00,2014,161852,,1611,,1480,,131,7970,,1140,6830,8386,,1038,-75,7348,-416,-291,,161561
214421,4000,Female,CR04  ,Noord-Friesland (CR),2015JJ00,2015,161561,,1536,,1485,,51,8181,,1203,6978,8286,,806,-39,7480,-105,-55,,161506
214422,4000,Female,CR04  ,Noord-Friesland (CR),2016JJ00,2016,161506,,1485,,1535,,-50,8905,,1219,7686,8834,,889,-71,7945,71,14,,161520
214423,4000,Female,CR04  ,Noord-Friesland (CR),2017JJ00,2017,161520,,1547,,1636,,-89,9055,,1206,7849,9104,,1018,-179,8086,-49,-137,,161383
214424,4000,Female,CR04  ,Noord-Friesland (CR),2018JJ00,2018,158733,,1436,,1588,,-152,8795,,1455,7340,8316,,984,-110,7332,479,322,,159055
214425,4000,Female,CR04  ,Noord-Friesland (CR),2019JJ00,2019,159055,,1453,,1526,,-73,8859,,1569,7290,8136,,940,-62,7196,723,657,,159712
214426,4000,Female,CR04  ,Noord-Friesland (CR),2020JJ00,2020,159712,,1447,,1520,,-73,8551,,1225,7326,8071,,957,-83,7114,480,398,,160110
214427,4000,Female,CR04  ,Noord-Friesland (CR),2021JJ00,2021,160110,,1622,,1717,,-95,8733,,1222,7511,7632,,868,-137,6764,1101,997,,161107
214428,4000,Female,CR04  ,Noord-Friesland (CR),2022JJ00,2022,161107,,1410,,1707,,-297,9740,,2640,7100,7887,,1243,-187,6644,1853,1545,,162652
214429,4000,Female,CR04  ,Noord-Friesland (CR),2023JJ00,2023,162652,,1464,,1608,,-144,9860,,2252,7608,8650,,1491,-311,7159,1210,1061,,163713
214500,4000,Female,CR05  ,Zuidwest-Friesland (CR),2012JJ00,2012,53054,,530,,492,,38,1639,,181,1458,1615,,159,-30,1456,24,60,,53114
214501,4000,Female,CR05  ,Zuidwest-Friesland (CR),2013JJ00,2013,53114,,506,,525,,-19,1635,,173,1462,1721,,159,-14,1562,-86,-111,,53003
214502,4000,Female,CR05  ,Zuidwest-Friesland (CR),2014JJ00,2014,67626,,607,,608,,-1,2127,,198,1929,2266,,151,-12,2115,-139,-153,,67473
214503,4000,Female,CR05  ,Zuidwest-Friesland (CR),2015JJ00,2015,67473,,562,,635,,-73,2143,,198,1945,2159,,149,0,2010,-16,-82,,67391
214504,4000,Female,CR05  ,Zuidwest-Friesland (CR),2016JJ00,2016,67391,,630,,638,,-8,2580,,260,2320,2388,,172,-10,2216,192,181,,67572
214505,4000,Female,CR05  ,Zuidwest-Friesland (CR),2017JJ00,2017,67572,,539,,635,,-96,2878,,273,2605,2771,,194,-29,2577,107,21,,67593
214506,4000,Female,CR05  ,Zuidwest-Friesland (CR),2018JJ00,2018,70243,,595,,696,,-101,2685,,309,2376,2656,,209,-25,2447,29,-72,,70171
214507,4000,Female,CR05  ,Zuidwest-Friesland (CR),2019JJ00,2019,70171,,658,,701,,-43,2643,,302,2341,2454,,193,-23,2261,189,148,,70319
214508,4000,Female,CR05  ,Zuidwest-Friesland (CR),2020JJ00,2020,70319,,648,,658,,-10,2726,,252,2474,2607,,137,-17,2470,119,108,,70427
214509,4000,Female,CR05  ,Zuidwest-Friesland (CR),2021JJ00,2021,70427,,629,,769,,-140,2872,,265,2607,2780,,167,-7,2613,92,-53,,70374
214510,4000,Female,CR05  ,Zuidwest-Friesland (CR),2022JJ00,2022,70374,,602,,794,,-192,3511,,889,2622,2841,,321,-30,2520,670,481,,70855
214511,4000,Female,CR05  ,Zuidwest-Friesland (CR),2023JJ00,2023,70855,,574,,797,,-223,2839,,377,2462,2981,,302,-34,2679,-142,-359,,70496
214582,4000,Female,CR06  ,Zuidoost-Friesland (CR),2012JJ00,2012,104506,,955,,957,,-2,3834,,354,3480,4218,,282,-49,3936,-384,-382,,104124
214583,4000,Female,CR06  ,Zuidoost-Friesland (CR),2013JJ00,2013,104124,,929,,943,,-14,4006,,387,3619,4164,,233,-19,3931,-158,-151,,103973
214584,4000,Female,CR06  ,Zuidoost-Friesland (CR),2014JJ00,2014,93597,,879,,832,,47,4014,,421,3593,3845,,227,-35,3618,169,228,,93825
214585,4000,Female,CR06  ,Zuidoost-Friesland (CR),2015JJ00,2015,93825,,863,,928,,-65,4069,,416,3653,4065,,254,-25,3811,4,-58,,93767
214586,4000,Female,CR06  ,Zuidoost-Friesland (CR),2016JJ00,2016,93767,,772,,1024,,-252,4386,,369,4017,4171,,280,-45,3891,215,-33,,93734
214587,4000,Female,CR06  ,Zuidoost-Friesland (CR),2017JJ00,2017,93734,,799,,1020,,-221,4517,,289,4228,4229,,243,-21,3986,288,67,,93801
214588,4000,Female,CR06  ,Zuidoost-Friesland (CR),2018JJ00,2018,93801,,788,,989,,-201,4446,,332,4114,4266,,230,-29,4036,180,-21,,93780
214589,4000,Female,CR06  ,Zuidoost-Friesland (CR),2019JJ00,2019,93780,,822,,944,,-122,4415,,384,4031,4096,,216,-7,3880,319,195,,93975
214590,4000,Female,CR06  ,Zuidoost-Friesland (CR),2020JJ00,2020,93975,,774,,950,,-176,4374,,315,4059,4059,,158,-12,3901,315,135,,94110
214591,4000,Female,CR06  ,Zuidoost-Friesland (CR),2021JJ00,2021,94110,,859,,1010,,-151,4416,,257,4159,3988,,191,-33,3797,428,273,,94383
214592,4000,Female,CR06  ,Zuidoost-Friesland (CR),2022JJ00,2022,94383,,816,,1084,,-268,5035,,984,4051,3991,,397,-68,3594,1044,772,,95155
214593,4000,Female,CR06  ,Zuidoost-Friesland (CR),2023JJ00,2023,95155,,719,,1103,,-384,4759,,686,4073,4168,,381,-72,3787,591,193,,95348
214664,4000,Female,CR07  ,Noord-Drenthe (CR),2012JJ00,2012,96059,,826,,946,,-120,3782,,261,3521,3766,,188,16,3578,16,-105,,95954
214665,4000,Female,CR07  ,Noord-Drenthe (CR),2013JJ00,2013,95954,,750,,913,,-163,3767,,296,3471,3773,,215,14,3558,-6,-169,,95785
214666,4000,Female,CR07  ,Noord-Drenthe (CR),2014JJ00,2014,95785,,795,,877,,-82,3941,,293,3648,3994,,266,-24,3728,-53,-130,,95655
214667,4000,Female,CR07  ,Noord-Drenthe (CR),2015JJ00,2015,95655,,721,,978,,-257,4927,,638,4289,4551,,270,-18,4281,376,113,,95768
214668,4000,Female,CR07  ,Noord-Drenthe (CR),2016JJ00,2016,95768,,771,,977,,-206,10793,,5981,4812,9089,,280,-15,8809,1704,1507,,97275
214669,4000,Female,CR07  ,Noord-Drenthe (CR),2017JJ00,2017,97275,,760,,1002,,-242,15589,,10440,5149,15580,,240,-24,15340,9,-243,,97032
214670,4000,Female,CR07  ,Noord-Drenthe (CR),2018JJ00,2018,97032,,741,,1072,,-331,5339,,378,4961,5468,,263,-29,5205,-129,-472,,96560
214671,4000,Female,CR07  ,Noord-Drenthe (CR),2019JJ00,2019,96560,,729,,992,,-263,5230,,520,4710,4601,,231,-6,4370,629,364,,96924
214672,4000,Female,CR07  ,Noord-Drenthe (CR),2020JJ00,2020,96924,,790,,1091,,-301,5182,,297,4885,4698,,187,-20,4511,484,183,,97107
214673,4000,Female,CR07  ,Noord-Drenthe (CR),2021JJ00,2021,97107,,870,,1058,,-188,5302,,276,5026,4643,,239,-41,4404,659,466,,97573
214674,4000,Female,CR07  ,Noord-Drenthe (CR),2022JJ00,2022,97573,,794,,1132,,-338,6153,,1305,4848,4831,,444,-50,4387,1322,982,,98555
214675,4000,Female,CR07  ,Noord-Drenthe (CR),2023JJ00,2023,98555,,745,,1101,,-356,5567,,749,4818,4935,,477,-125,4458,632,272,,98827
214746,4000,Female,CR08  ,Zuidoost-Drenthe (CR),2012JJ00,2012,85855,,740,,882,,-142,3097,,512,2585,3302,,386,-124,2916,-205,-346,,85509
214747,4000,Female,CR08  ,Zuidoost-Drenthe (CR),2013JJ00,2013,85509,,729,,859,,-130,3158,,533,2625,3116,,322,-75,2794,42,-88,,85421
214748,4000,Female,CR08  ,Zuidoost-Drenthe (CR),2014JJ00,2014,85421,,691,,879,,-188,2909,,477,2432,3154,,339,-81,2815,-245,-433,,84988
214749,4000,Female,CR08  ,Zuidoost-Drenthe (CR),2015JJ00,2015,84988,,638,,941,,-303,3180,,506,2674,3249,,353,-116,2896,-69,-377,,84611
214750,4000,Female,CR08  ,Zuidoost-Drenthe (CR),2016JJ00,2016,84611,,680,,937,,-257,3291,,443,2848,3220,,313,-61,2907,71,-181,,84430
214751,4000,Female,CR08  ,Zuidoost-Drenthe (CR),2017JJ00,2017,84430,,700,,926,,-226,3610,,321,3289,3513,,239,-25,3274,97,-131,,84299
214752,4000,Female,CR08  ,Zuidoost-Drenthe (CR),2018JJ00,2018,84299,,641,,934,,-293,3624,,384,3240,3349,,242,-20,3107,275,-26,,84273
214753,4000,Female,CR08  ,Zuidoost-Drenthe (CR),2019JJ00,2019,84273,,677,,963,,-286,3652,,397,3255,3457,,327,-63,3130,195,-113,,84160
214754,4000,Female,CR08  ,Zuidoost-Drenthe (CR),2020JJ00,2020,84160,,691,,976,,-285,3611,,307,3304,3265,,229,-30,3036,346,45,,84205
214755,4000,Female,CR08  ,Zuidoost-Drenthe (CR),2021JJ00,2021,84205,,697,,1049,,-352,3883,,297,3586,3117,,262,-74,2855,766,395,,84600
214756,4000,Female,CR08  ,Zuidoost-Drenthe (CR),2022JJ00,2022,84600,,667,,1127,,-460,4303,,965,3338,3224,,368,-87,2856,1079,602,,85202
214757,4000,Female,CR08  ,Zuidoost-Drenthe (CR),2023JJ00,2023,85202,,687,,1029,,-342,4046,,763,3283,3489,,492,-94,2997,557,194,,85396
214828,4000,Female,CR09  ,Zuidwest-Drenthe (CR),2012JJ00,2012,65759,,597,,661,,-64,2369,,182,2187,2368,,149,-4,2219,1,-61,,65698
214829,4000,Female,CR09  ,Zuidwest-Drenthe (CR),2013JJ00,2013,65698,,602,,662,,-60,2221,,195,2026,2307,,148,1,2159,-86,-146,,65552
214830,4000,Female,CR09  ,Zuidwest-Drenthe (CR),2014JJ00,2014,65552,,607,,634,,-27,2586,,229,2357,2439,,184,-17,2255,147,119,,65671
214831,4000,Female,CR09  ,Zuidwest-Drenthe (CR),2015JJ00,2015,65671,,589,,657,,-68,2857,,485,2372,2694,,170,-14,2524,163,96,,65767
214832,4000,Female,CR09  ,Zuidwest-Drenthe (CR),2016JJ00,2016,65767,,610,,697,,-87,3372,,431,2941,2958,,177,-17,2781,414,322,,66089
214833,4000,Female,CR09  ,Zuidwest-Drenthe (CR),2017JJ00,2017,66089,,594,,706,,-112,3520,,294,3226,2945,,166,-10,2779,575,464,,66553
214834,4000,Female,CR09  ,Zuidwest-Drenthe (CR),2018JJ00,2018,66553,,540,,712,,-172,3384,,369,3015,2990,,241,-55,2749,394,225,,66778
214835,4000,Female,CR09  ,Zuidwest-Drenthe (CR),2019JJ00,2019,66778,,588,,701,,-113,3311,,325,2986,2848,,177,-3,2671,463,345,,67123
214836,4000,Female,CR09  ,Zuidwest-Drenthe (CR),2020JJ00,2020,67123,,573,,712,,-139,3350,,290,3060,2907,,157,-9,2750,443,309,,67432
214837,4000,Female,CR09  ,Zuidwest-Drenthe (CR),2021JJ00,2021,67432,,610,,794,,-184,3406,,337,3069,2785,,184,-29,2601,621,436,,67868
214838,4000,Female,CR09  ,Zuidwest-Drenthe (CR),2022JJ00,2022,67868,,549,,814,,-265,3874,,962,2912,2830,,325,-64,2505,1044,786,,68654
214839,4000,Female,CR09  ,Zuidwest-Drenthe (CR),2023JJ00,2023,68654,,577,,792,,-215,3447,,617,2830,3072,,405,-95,2667,375,158,,68812
214910,4000,Female,CR10  ,Noord-Overijssel (CR),2012JJ00,2012,179721,,2184,,1354,,830,6689,,741,5948,6742,,644,-92,6098,-53,776,,180497
214911,4000,Female,CR10  ,Noord-Overijssel (CR),2013JJ00,2013,180497,,2119,,1426,,693,6625,,738,5887,6988,,697,-103,6291,-363,329,,180826
214912,4000,Female,CR10  ,Noord-Overijssel (CR),2014JJ00,2014,180826,,2095,,1431,,664,6920,,740,6180,7192,,698,-106,6494,-272,402,,181228
214913,4000,Female,CR10  ,Noord-Overijssel (CR),2015JJ00,2015,181228,,2048,,1474,,574,7712,,937,6775,7187,,670,-44,6517,525,1103,,182331
214914,4000,Female,CR10  ,Noord-Overijssel (CR),2016JJ00,2016,182331,,2098,,1497,,601,8045,,830,7215,7789,,727,-47,7062,256,853,,183184
214915,4000,Female,CR10  ,Noord-Overijssel (CR),2017JJ00,2017,183184,,1966,,1502,,464,8613,,937,7676,7979,,643,-63,7336,634,1090,,184274
214916,4000,Female,CR10  ,Noord-Overijssel (CR),2018JJ00,2018,184274,,2011,,1597,,414,8659,,930,7729,7867,,662,-41,7205,792,1198,,185472
214917,4000,Female,CR10  ,Noord-Overijssel (CR),2019JJ00,2019,185472,,1992,,1501,,491,8566,,1111,7455,7545,,673,-50,6872,1021,1505,,186977
214918,4000,Female,CR10  ,Noord-Overijssel (CR),2020JJ00,2020,186977,,1971,,1594,,377,8546,,866,7680,7605,,582,-58,7023,941,1311,,188288
214919,4000,Female,CR10  ,Noord-Overijssel (CR),2021JJ00,2021,188288,,2014,,1594,,420,8355,,853,7502,7514,,622,-59,6892,841,1254,,189542
214920,4000,Female,CR10  ,Noord-Overijssel (CR),2022JJ00,2022,189542,,2037,,1705,,332,10563,,2909,7654,7854,,1128,-126,6726,2709,3036,,192578
214921,4000,Female,CR10  ,Noord-Overijssel (CR),2023JJ00,2023,192578,,1900,,1606,,294,9063,,1605,7458,8451,,1115,-178,7336,612,893,,193471
214992,4000,Female,CR11  ,Zuidwest-Overijssel (CR),2012JJ00,2012,77132,,808,,694,,114,2907,,576,2331,3155,,433,-92,2722,-248,-135,,76997
214993,4000,Female,CR11  ,Zuidwest-Overijssel (CR),2013JJ00,2013,76997,,778,,698,,80,2961,,559,2402,3218,,493,-134,2725,-257,-174,,76823
214994,4000,Female,CR11  ,Zuidwest-Overijssel (CR),2014JJ00,2014,76823,,779,,689,,90,3204,,606,2598,3185,,451,-87,2734,19,110,,76933
214995,4000,Female,CR11  ,Zuidwest-Overijssel (CR),2015JJ00,2015,76933,,701,,703,,-2,3393,,563,2830,3257,,433,-52,2824,136,128,,77061
214996,4000,Female,CR11  ,Zuidwest-Overijssel (CR),2016JJ00,2016,77061,,776,,677,,99,3659,,622,3037,3340,,379,-72,2961,319,414,,77475
214997,4000,Female,CR11  ,Zuidwest-Overijssel (CR),2017JJ00,2017,77475,,703,,716,,-13,3906,,489,3417,3567,,367,-68,3200,339,330,,77805
214998,4000,Female,CR11  ,Zuidwest-Overijssel (CR),2018JJ00,2018,77805,,746,,752,,-6,3687,,567,3120,3366,,324,-45,3042,321,306,,78111
214999,4000,Female,CR11  ,Zuidwest-Overijssel (CR),2019JJ00,2019,78111,,741,,778,,-37,3825,,660,3165,3160,,376,-35,2784,665,622,,78733
215000,4000,Female,CR11  ,Zuidwest-Overijssel (CR),2020JJ00,2020,78733,,710,,815,,-105,3681,,444,3237,3192,,262,-14,2930,489,386,,79119
215001,4000,Female,CR11  ,Zuidwest-Overijssel (CR),2021JJ00,2021,79119,,704,,814,,-110,3576,,436,3140,3199,,317,-40,2882,377,263,,79382
215002,4000,Female,CR11  ,Zuidwest-Overijssel (CR),2022JJ00,2022,79382,,752,,817,,-65,4102,,1042,3060,3096,,366,-44,2730,1006,930,,80312
215003,4000,Female,CR11  ,Zuidwest-Overijssel (CR),2023JJ00,2023,80312,,710,,845,,-135,3858,,773,3085,3480,,534,-134,2946,378,233,,80545
215074,4000,Female,CR12  ,Twente (CR),2012JJ00,2012,312051,,3085,,2787,,298,11053,,2014,9039,11235,,1712,-247,9523,-182,115,,312166
215075,4000,Female,CR12  ,Twente (CR),2013JJ00,2013,312166,,3048,,2923,,125,10676,,1863,8813,11135,,1859,-230,9276,-459,-332,,311834
215076,4000,Female,CR12  ,Twente (CR),2014JJ00,2014,311834,,3005,,2855,,150,10992,,1902,9090,11384,,1804,-256,9580,-392,-237,,311597
215077,4000,Female,CR12  ,Twente (CR),2015JJ00,2015,311597,,2890,,3038,,-148,11658,,2294,9364,11537,,1807,-241,9730,121,-33,,311564
215078,4000,Female,CR12  ,Twente (CR),2016JJ00,2016,311564,,2926,,3076,,-150,12640,,2290,10350,12451,,1804,-293,10647,189,36,,311600
215079,4000,Female,CR12  ,Twente (CR),2017JJ00,2017,311600,,2859,,2929,,-70,13199,,2220,10979,12727,,1681,-189,11046,472,391,,311991
215080,4000,Female,CR12  ,Twente (CR),2018JJ00,2018,311991,,2751,,3101,,-350,12630,,2380,10250,11903,,1610,-83,10293,727,366,,312357
215081,4000,Female,CR12  ,Twente (CR),2019JJ00,2019,312357,,2744,,3061,,-317,12983,,2636,10347,12051,,1779,-227,10272,932,583,,312940
215082,4000,Female,CR12  ,Twente (CR),2020JJ00,2020,312940,,2670,,3305,,-635,12919,,2318,10601,12133,,1586,-203,10547,786,131,,313071
215083,4000,Female,CR12  ,Twente (CR),2021JJ00,2021,313071,,2916,,3465,,-549,12955,,2592,10363,11638,,1572,-207,10066,1317,757,,313828
215084,4000,Female,CR12  ,Twente (CR),2022JJ00,2022,313828,,2809,,3380,,-571,15589,,5157,10432,12345,,2189,-252,10156,3244,2661,,316489
215085,4000,Female,CR12  ,Twente (CR),2023JJ00,2023,316489,,2674,,3362,,-688,14575,,3589,10986,13512,,2392,-459,11120,1063,370,,316859
215156,4000,Female,CR13  ,Veluwe (CR),2012JJ00,2012,333898,,3505,,2876,,629,13696,,2002,11694,12899,,1582,-240,11317,797,1471,,335369
215157,4000,Female,CR13  ,Veluwe (CR),2013JJ00,2013,335369,,3368,,2790,,578,13698,,2122,11576,13378,,2038,-582,11340,320,901,,336270
215158,4000,Female,CR13  ,Veluwe (CR),2014JJ00,2014,336270,,3488,,2888,,600,15100,,2297,12803,13978,,1909,-239,12069,1122,1750,,338020
215159,4000,Female,CR13  ,Veluwe (CR),2015JJ00,2015,338020,,3479,,3073,,406,15658,,2682,12976,14402,,1928,-301,12474,1256,1683,,339703
215160,4000,Female,CR13  ,Veluwe (CR),2016JJ00,2016,339703,,3443,,3127,,316,16954,,2421,14533,14882,,2041,-300,12841,2072,2388,,342091
215161,4000,Female,CR13  ,Veluwe (CR),2017JJ00,2017,342091,,3463,,3060,,403,17822,,2594,15228,15633,,2026,-363,13607,2189,2564,,344655
215162,4000,Female,CR13  ,Veluwe (CR),2018JJ00,2018,344655,,3440,,3198,,242,18006,,2737,15269,15712,,1951,-221,13761,2294,2535,,347190
215163,4000,Female,CR13  ,Veluwe (CR),2019JJ00,2019,347190,,3498,,3247,,251,18068,,2897,15171,15261,,1887,-175,13374,2807,3047,,350237
215164,4000,Female,CR13  ,Veluwe (CR),2020JJ00,2020,350237,,3590,,3521,,69,18268,,2445,15823,15751,,1751,-184,14000,2517,2564,,352801
215165,4000,Female,CR13  ,Veluwe (CR),2021JJ00,2021,352801,,3753,,3469,,284,17863,,2561,15302,15378,,1640,-158,13738,2485,2772,,355573
215166,4000,Female,CR13  ,Veluwe (CR),2022JJ00,2022,355573,,3458,,3587,,-129,20290,,5658,14632,15574,,2240,-278,13334,4716,4585,,360158
215167,4000,Female,CR13  ,Veluwe (CR),2023JJ00,2023,360158,,3487,,3443,,44,19893,,3947,15946,16590,,2663,-388,13927,3303,3339,,363497
215238,4000,Female,CR14  ,Achterhoek (CR),2012JJ00,2012,201814,,1662,,1954,,-292,7248,,752,6496,7255,,513,-65,6742,-7,-299,,201515
215239,4000,Female,CR14  ,Achterhoek (CR),2013JJ00,2013,201515,,1556,,1950,,-394,7134,,760,6374,7402,,613,-71,6789,-268,-652,,200863
215240,4000,Female,CR14  ,Achterhoek (CR),2014JJ00,2014,200863,,1597,,1899,,-302,7308,,783,6525,7574,,594,-62,6980,-266,-580,,200283
215241,4000,Female,CR14  ,Achterhoek (CR),2015JJ00,2015,200283,,1615,,2021,,-406,8087,,982,7105,7513,,532,-51,6981,574,172,,200455
215242,4000,Female,CR14  ,Achterhoek (CR),2016JJ00,2016,200455,,1464,,2035,,-571,9144,,1399,7745,8462,,577,-29,7885,682,113,,200568
215243,4000,Female,CR14  ,Achterhoek (CR),2017JJ00,2017,200568,,1536,,2161,,-625,9726,,780,8946,8793,,541,-44,8252,933,299,,200867
215244,4000,Female,CR14  ,Achterhoek (CR),2018JJ00,2018,200867,,1581,,2132,,-551,8832,,863,7969,8179,,562,-47,7617,653,105,,200972
215245,4000,Female,CR14  ,Achterhoek (CR),2019JJ00,2019,200972,,1586,,2143,,-557,8973,,867,8106,8219,,569,-52,7650,754,183,,201155
215246,4000,Female,CR14  ,Achterhoek (CR),2020JJ00,2020,201155,,1588,,2239,,-651,9004,,707,8297,7891,,458,-61,7433,1113,459,,201614
215247,4000,Female,CR14  ,Achterhoek (CR),2021JJ00,2021,201614,,1618,,2377,,-759,9080,,638,8442,7817,,497,-34,7320,1263,491,,202105
215248,4000,Female,CR14  ,Achterhoek (CR),2022JJ00,2022,202105,,1464,,2455,,-991,10335,,2065,8270,7808,,868,-110,6940,2527,1522,,203627
215249,4000,Female,CR14  ,Achterhoek (CR),2023JJ00,2023,203627,,1581,,2384,,-803,9248,,1195,8053,8373,,865,-122,7508,875,65,,203692
215320,4000,Female,CR15  ,Arnhem/Nijmegen (CR),2012JJ00,2012,364021,,3434,,3305,,129,20197,,2674,17523,19220,,2517,-544,16703,977,1106,,365127
215321,4000,Female,CR15  ,Arnhem/Nijmegen (CR),2013JJ00,2013,365127,,3322,,3217,,105,20098,,2704,17394,19416,,2580,-548,16836,682,783,,365910
215322,4000,Female,CR15  ,Arnhem/Nijmegen (CR),2014JJ00,2014,365910,,3397,,3103,,294,20946,,2694,18252,19774,,2422,-386,17352,1172,1462,,367372
215323,4000,Female,CR15  ,Arnhem/Nijmegen (CR),2015JJ00,2015,367372,,3400,,3224,,176,21688,,3238,18450,20275,,2485,-381,17790,1413,1580,,368952
215324,4000,Female,CR15  ,Arnhem/Nijmegen (CR),2016JJ00,2016,368952,,3258,,3244,,14,24244,,3805,20439,22598,,2665,-479,19933,1646,1642,,370594
215325,4000,Female,CR15  ,Arnhem/Nijmegen (CR),2017JJ00,2017,370594,,3330,,3410,,-80,25830,,3922,21908,23383,,2563,-487,20820,2447,2339,,372933
215326,4000,Female,CR15  ,Arnhem/Nijmegen (CR),2018JJ00,2018,372933,,3218,,3414,,-196,23785,,4049,19736,22155,,2832,-568,19323,1630,1422,,374355
215327,4000,Female,CR15  ,Arnhem/Nijmegen (CR),2019JJ00,2019,374355,,3154,,3471,,-317,24236,,4701,19535,22058,,2859,-562,19199,2178,1856,,376211
215328,4000,Female,CR15  ,Arnhem/Nijmegen (CR),2020JJ00,2020,376211,,3358,,3678,,-320,23280,,3614,19666,21992,,2463,-392,19529,1288,941,,377152
215329,4000,Female,CR15  ,Arnhem/Nijmegen (CR),2021JJ00,2021,377152,,3447,,3693,,-246,23774,,4156,19618,20964,,2015,-425,18949,2810,2559,,379711
215330,4000,Female,CR15  ,Arnhem/Nijmegen (CR),2022JJ00,2022,379711,,3232,,3876,,-644,26760,,7321,19439,21930,,2744,-466,19186,4830,4173,,383884
215331,4000,Female,CR15  ,Arnhem/Nijmegen (CR),2023JJ00,2023,383884,,3233,,3765,,-532,26926,,5995,20931,22582,,3099,-605,19483,4344,3813,,387697
215402,4000,Female,CR16  ,Zuidwest-Gelderland (CR),2012JJ00,2012,118344,,1126,,911,,215,4364,,528,3836,4320,,315,-14,4005,44,256,,118600
215403,4000,Female,CR16  ,Zuidwest-Gelderland (CR),2013JJ00,2013,118600,,1209,,930,,279,4243,,536,3707,4325,,370,-26,3955,-82,199,,118799
215404,4000,Female,CR16  ,Zuidwest-Gelderland (CR),2014JJ00,2014,118799,,1164,,907,,257,4592,,603,3989,4668,,388,-20,4280,-76,182,,118981
215405,4000,Female,CR16  ,Zuidwest-Gelderland (CR),2015JJ00,2015,118981,,1148,,1010,,138,5021,,603,4418,4866,,404,-18,4462,155,296,,119277
215406,4000,Female,CR16  ,Zuidwest-Gelderland (CR),2016JJ00,2016,119277,,1200,,955,,245,5481,,572,4909,5064,,375,-2,4689,417,654,,119931
215407,4000,Female,CR16  ,Zuidwest-Gelderland (CR),2017JJ00,2017,119931,,1192,,1031,,161,6148,,596,5552,5707,,431,-52,5276,441,600,,120531
215408,4000,Female,CR16  ,Zuidwest-Gelderland (CR),2018JJ00,2018,120531,,1179,,1016,,163,6491,,1161,5330,5383,,444,-36,4939,1108,1275,,121806
215409,4000,Female,CR16  ,Zuidwest-Gelderland (CR),2019JJ00,2019,121806,,1172,,1039,,133,6379,,1171,5208,5419,,606,-117,4813,960,1084,,122890
215410,4000,Female,CR16  ,Zuidwest-Gelderland (CR),2020JJ00,2020,122890,,1221,,1175,,46,6844,,1280,5564,5906,,861,-169,5045,938,979,,123869
215411,4000,Female,CR16  ,Zuidwest-Gelderland (CR),2021JJ00,2021,123869,,1331,,1145,,186,6638,,1180,5458,5774,,866,-137,4908,864,1052,,124921
215412,4000,Female,CR16  ,Zuidwest-Gelderland (CR),2022JJ00,2022,124921,,1223,,1190,,33,8049,,2679,5370,6118,,1292,-247,4826,1931,1957,,126878
215413,4000,Female,CR16  ,Zuidwest-Gelderland (CR),2023JJ00,2023,126878,,1225,,1078,,147,6989,,1679,5310,6606,,1403,-520,5203,383,514,,127392
215484,4000,Female,CR17  ,Utrecht (CR),2012JJ00,2012,632085,,7219,,4701,,2518,32574,,4854,27720,31180,,4316,-524,26864,1394,3864,,635949
215485,4000,Female,CR17  ,Utrecht (CR),2013JJ00,2013,635949,,6986,,4759,,2227,33522,,5185,28337,31722,,4644,-448,27078,1800,4049,,639998
215486,4000,Female,CR17  ,Utrecht (CR),2014JJ00,2014,639998,,7287,,4824,,2463,36265,,5359,30906,34063,,4493,-322,29570,2202,4686,,644684
215487,4000,Female,CR17  ,Utrecht (CR),2015JJ00,2015,644684,,7034,,5011,,2023,38550,,5985,32565,36112,,4631,-394,31481,2438,4454,,649138
215488,4000,Female,CR17  ,Utrecht (CR),2016JJ00,2016,649138,,7088,,5122,,1966,40789,,6276,34513,37727,,4241,-273,33486,3062,5021,,654159
215489,4000,Female,CR17  ,Utrecht (CR),2017JJ00,2017,654159,,7161,,5066,,2095,41585,,6368,35217,38284,,4504,-447,33780,3301,5374,,659533
215490,4000,Female,CR17  ,Utrecht (CR),2018JJ00,2018,659533,,6966,,5147,,1819,41053,,6821,34232,37561,,4866,-431,32695,3492,5290,,664823
215491,4000,Female,CR17  ,Utrecht (CR),2019JJ00,2019,682596,,7270,,5366,,1904,41944,,7639,34305,37993,,4994,-332,32999,3951,5825,,688421
215492,4000,Female,CR17  ,Utrecht (CR),2020JJ00,2020,688421,,7163,,5768,,1395,41353,,5941,35412,40175,,4522,-123,35653,1178,2554,,690975
215493,4000,Female,CR17  ,Utrecht (CR),2021JJ00,2021,690975,,7675,,5757,,1918,43139,,6918,36221,40501,,4183,-303,36318,2638,4521,,695496
215494,4000,Female,CR17  ,Utrecht (CR),2022JJ00,2022,695496,,6983,,5959,,1024,48494,,12587,35907,40157,,5466,-284,34691,8337,9335,,704831
215495,4000,Female,CR17  ,Utrecht (CR),2023JJ00,2023,704831,,6939,,5930,,1009,47114,,9003,38111,41712,,5894,-603,35818,5402,6401,,711232
215566,4000,Female,CR18  ,Kop van Noord-Holland (CR),2012JJ00,2012,185717,,1758,,1488,,270,6747,,923,5824,6945,,717,-68,6228,-198,74,,185791
215567,4000,Female,CR18  ,Kop van Noord-Holland (CR),2013JJ00,2013,185791,,1730,,1549,,181,6575,,1035,5540,6874,,723,-42,6151,-299,-132,,185659
215568,4000,Female,CR18  ,Kop van Noord-Holland (CR),2014JJ00,2014,185659,,1750,,1534,,216,6970,,1106,5864,7121,,802,-68,6319,-151,73,,185732
215569,4000,Female,CR18  ,Kop van Noord-Holland (CR),2015JJ00,2015,185732,,1686,,1568,,118,7794,,1338,6456,7547,,799,-62,6748,247,374,,186106
215570,4000,Female,CR18  ,Kop van Noord-Holland (CR),2016JJ00,2016,186106,,1730,,1688,,42,8203,,1184,7019,8032,,812,-74,7220,171,214,,186320
215571,4000,Female,CR18  ,Kop van Noord-Holland (CR),2017JJ00,2017,186320,,1722,,1708,,14,8879,,1155,7724,8296,,840,-69,7456,583,589,,186909
215572,4000,Female,CR18  ,Kop van Noord-Holland (CR),2018JJ00,2018,186909,,1700,,1710,,-10,8713,,1277,7436,8083,,760,-84,7323,630,619,,187528
215573,4000,Female,CR18  ,Kop van Noord-Holland (CR),2019JJ00,2019,187528,,1643,,1666,,-23,8940,,1761,7179,8047,,922,-142,7125,893,865,,188393
215574,4000,Female,CR18  ,Kop van Noord-Holland (CR),2020JJ00,2020,188393,,1644,,1781,,-137,9235,,1515,7720,8309,,1046,-176,7263,926,794,,189187
215575,4000,Female,CR18  ,Kop van Noord-Holland (CR),2021JJ00,2021,189187,,1815,,1863,,-48,9275,,1361,7914,8241,,1114,-133,7127,1034,973,,190160
215576,4000,Female,CR18  ,Kop van Noord-Holland (CR),2022JJ00,2022,190160,,1787,,1860,,-73,11618,,3580,8038,8848,,1735,-286,7113,2770,2695,,192855
215577,4000,Female,CR18  ,Kop van Noord-Holland (CR),2023JJ00,2023,192855,,1598,,1960,,-362,9659,,2067,7592,8993,,1660,-360,7333,666,284,,193139
215648,4000,Female,CR19  ,Alkmaar en omgeving (CR),2012JJ00,2012,117400,,1168,,989,,179,5299,,700,4599,5376,,741,-118,4635,-77,113,,117513
215649,4000,Female,CR19  ,Alkmaar en omgeving (CR),2013JJ00,2013,117513,,1116,,948,,168,5322,,747,4575,5164,,512,-51,4652,158,328,,117841
215650,4000,Female,CR19  ,Alkmaar en omgeving (CR),2014JJ00,2014,117841,,1148,,960,,188,5461,,805,4656,5314,,533,-26,4781,147,338,,118179
215651,4000,Female,CR19  ,Alkmaar en omgeving (CR),2015JJ00,2015,121369,,1100,,1049,,51,6440,,925,5515,5886,,590,-38,5296,554,597,,121966
215652,4000,Female,CR19  ,Alkmaar en omgeving (CR),2016JJ00,2016,121966,,1103,,1105,,-2,7240,,1045,6195,6363,,613,-85,5750,877,885,,122851
215653,4000,Female,CR19  ,Alkmaar en omgeving (CR),2017JJ00,2017,122851,,1062,,1031,,31,7276,,741,6535,6597,,563,-33,6034,679,701,,123552
215654,4000,Female,CR19  ,Alkmaar en omgeving (CR),2018JJ00,2018,123552,,1086,,1091,,-5,6963,,781,6182,6109,,557,-87,5552,854,837,,124389
215655,4000,Female,CR19  ,Alkmaar en omgeving (CR),2019JJ00,2019,124389,,1088,,1059,,29,7240,,824,6416,6065,,526,-48,5539,1175,1193,,125582
215656,4000,Female,CR19  ,Alkmaar en omgeving (CR),2020JJ00,2020,125582,,1129,,1180,,-51,7175,,687,6488,6313,,471,-50,5842,862,804,,126386
215657,4000,Female,CR19  ,Alkmaar en omgeving (CR),2021JJ00,2021,126386,,1204,,1194,,10,7000,,694,6306,5994,,518,-56,5476,1006,1024,,127410
215658,4000,Female,CR19  ,Alkmaar en omgeving (CR),2022JJ00,2022,127410,,1106,,1306,,-200,7687,,1785,5902,5865,,721,-111,5144,1822,1618,,129028
215659,4000,Female,CR19  ,Alkmaar en omgeving (CR),2023JJ00,2023,129028,,1102,,1214,,-112,7018,,1086,5932,6197,,874,-214,5323,821,706,,129734
215730,4000,Female,CR20  ,IJmond (CR),2012JJ00,2012,98190,,834,,951,,-117,3887,,499,3388,3945,,401,-84,3544,-58,-176,,98014
215731,4000,Female,CR20  ,IJmond (CR),2013JJ00,2013,98014,,853,,890,,-37,3922,,519,3403,3735,,395,-46,3340,187,144,,98158
215732,4000,Female,CR20  ,IJmond (CR),2014JJ00,2014,98158,,928,,924,,4,4237,,504,3733,4164,,423,-48,3741,73,81,,98239
215733,4000,Female,CR20  ,IJmond (CR),2015JJ00,2015,98239,,855,,976,,-121,4742,,507,4235,4260,,470,-91,3790,482,361,,98600
215734,4000,Female,CR20  ,IJmond (CR),2016JJ00,2016,98600,,892,,1017,,-125,5068,,537,4531,4434,,383,-61,4051,634,501,,99101
215735,4000,Female,CR20  ,IJmond (CR),2017JJ00,2017,99101,,872,,999,,-127,5008,,509,4499,4409,,471,-64,3938,599,465,,99566
215736,4000,Female,CR20  ,IJmond (CR),2018JJ00,2018,99566,,872,,1036,,-164,4605,,637,3968,4141,,486,-68,3655,464,305,,99871
215737,4000,Female,CR20  ,IJmond (CR),2019JJ00,2019,99871,,849,,1029,,-180,4965,,627,4338,4366,,467,-55,3899,599,412,,100283
215738,4000,Female,CR20  ,IJmond (CR),2020JJ00,2020,100283,,905,,1082,,-177,4923,,500,4423,4598,,368,-18,4230,325,151,,100434
215739,4000,Female,CR20  ,IJmond (CR),2021JJ00,2021,100434,,944,,1035,,-91,4697,,487,4210,4382,,360,-42,4022,315,216,,100650
215740,4000,Female,CR20  ,IJmond (CR),2022JJ00,2022,100650,,918,,1114,,-196,5405,,986,4419,4604,,482,-59,4122,801,600,,101250
215741,4000,Female,CR20  ,IJmond (CR),2023JJ00,2023,101250,,851,,1167,,-316,5062,,808,4254,4612,,575,-99,4037,450,125,,101375
215812,4000,Female,CR21  ,Agglomeratie Haarlem (CR),2012JJ00,2012,114772,,1174,,1297,,-123,6383,,1100,5283,5550,,838,-168,4712,833,707,,115479
215813,4000,Female,CR21  ,Agglomeratie Haarlem (CR),2013JJ00,2013,115479,,1164,,1215,,-51,6606,,1119,5487,5668,,878,-96,4790,938,887,,116366
215814,4000,Female,CR21  ,Agglomeratie Haarlem (CR),2014JJ00,2014,116366,,1227,,1191,,36,7461,,1120,6341,6462,,980,-193,5482,999,1024,,117390
215815,4000,Female,CR21  ,Agglomeratie Haarlem (CR),2015JJ00,2015,117390,,1157,,1349,,-192,7860,,1136,6724,6945,,923,-86,6022,915,724,,118114
215816,4000,Female,CR21  ,Agglomeratie Haarlem (CR),2016JJ00,2016,118114,,1084,,1277,,-193,8406,,1379,7027,7428,,951,-96,6477,978,776,,118890
215817,4000,Female,CR21  ,Agglomeratie Haarlem (CR),2017JJ00,2017,118890,,1169,,1308,,-139,8462,,1413,7049,7632,,1021,-107,6611,830,693,,119583
215818,4000,Female,CR21  ,Agglomeratie Haarlem (CR),2018JJ00,2018,119583,,1165,,1282,,-117,8352,,1687,6665,7204,,1004,-68,6200,1148,1022,,120605
215819,4000,Female,CR21  ,Agglomeratie Haarlem (CR),2019JJ00,2019,117537,,1145,,1222,,-77,8301,,1757,6544,7352,,1043,-81,6309,949,869,,118406
215820,4000,Female,CR21  ,Agglomeratie Haarlem (CR),2020JJ00,2020,118406,,1137,,1334,,-197,8016,,1419,6597,8058,,981,-88,7077,-42,-247,,118159
215821,4000,Female,CR21  ,Agglomeratie Haarlem (CR),2021JJ00,2021,118159,,1195,,1316,,-121,8219,,1394,6825,7864,,981,-62,6883,355,229,,118388
215822,4000,Female,CR21  ,Agglomeratie Haarlem (CR),2022JJ00,2022,118388,,1107,,1338,,-231,9734,,2741,6993,7563,,1179,-66,6384,2171,1939,,120327
215823,4000,Female,CR21  ,Agglomeratie Haarlem (CR),2023JJ00,2023,120327,,1071,,1306,,-235,8892,,1857,7035,7787,,1298,-129,6489,1105,859,,121186
215894,4000,Female,CR22  ,Zaanstreek (CR),2012JJ00,2012,82857,,827,,713,,114,3120,,504,2616,2601,,421,-62,2180,519,642,,83499
215895,4000,Female,CR22  ,Zaanstreek (CR),2013JJ00,2013,83499,,820,,707,,113,3193,,560,2633,2755,,499,-89,2256,438,559,,84058
215896,4000,Female,CR22  ,Zaanstreek (CR),2014JJ00,2014,84058,,847,,704,,143,3197,,614,2583,2866,,485,-102,2381,331,482,,84540
215897,4000,Female,CR22  ,Zaanstreek (CR),2015JJ00,2015,84540,,888,,732,,156,3430,,585,2845,3133,,494,-73,2639,297,456,,84996
215898,4000,Female,CR22  ,Zaanstreek (CR),2016JJ00,2016,84996,,929,,737,,192,3753,,600,3153,3284,,531,-69,2753,469,656,,85652
215899,4000,Female,CR22  ,Zaanstreek (CR),2017JJ00,2017,85652,,896,,720,,176,3854,,627,3227,3353,,481,-43,2872,501,674,,86326
215900,4000,Female,CR22  ,Zaanstreek (CR),2018JJ00,2018,86326,,901,,773,,128,4078,,744,3334,3612,,540,-53,3072,466,596,,86922
215901,4000,Female,CR22  ,Zaanstreek (CR),2019JJ00,2019,86922,,950,,703,,247,3918,,798,3120,3650,,493,-82,3157,268,516,,87438
215902,4000,Female,CR22  ,Zaanstreek (CR),2020JJ00,2020,87438,,817,,894,,-77,3833,,753,3080,3797,,447,-53,3350,36,-49,,87389
215903,4000,Female,CR22  ,Zaanstreek (CR),2021JJ00,2021,87389,,942,,766,,176,3868,,714,3154,3824,,464,-48,3360,44,221,,87610
215904,4000,Female,CR22  ,Zaanstreek (CR),2022JJ00,2022,87610,,849,,874,,-25,4938,,1423,3515,3814,,573,-69,3241,1124,1100,,88710
215905,4000,Female,CR22  ,Zaanstreek (CR),2023JJ00,2023,88710,,824,,865,,-41,4830,,1169,3661,3902,,725,-110,3177,928,879,,89589
215976,4000,Female,CR23  ,Groot-Amsterdam (CR),2012JJ00,2012,650629,,7686,,4841,,2845,39758,,12750,27008,36526,,11972,-3016,24554,3232,6075,,656704
215977,4000,Female,CR23  ,Groot-Amsterdam (CR),2013JJ00,2013,656704,,7504,,4685,,2819,41003,,13123,27880,37350,,12128,-2499,25222,3653,6555,,663259
215978,4000,Female,CR23  ,Groot-Amsterdam (CR),2014JJ00,2014,663259,,7717,,4644,,3073,45428,,15538,29890,41024,,11971,-2112,29053,4404,7515,,670774
215979,4000,Female,CR23  ,Groot-Amsterdam (CR),2015JJ00,2015,667584,,7438,,4782,,2656,47995,,16861,31134,43589,,12412,-1241,31177,4406,7080,,674664
215980,4000,Female,CR23  ,Groot-Amsterdam (CR),2016JJ00,2016,674664,,7646,,4834,,2812,50342,,18835,31507,46554,,12842,-1036,33712,3788,6609,,681273
215981,4000,Female,CR23  ,Groot-Amsterdam (CR),2017JJ00,2017,681273,,7356,,4706,,2650,52443,,21265,31178,49083,,13895,-1956,35188,3360,5969,,687242
215982,4000,Female,CR23  ,Groot-Amsterdam (CR),2018JJ00,2018,687242,,7483,,4765,,2718,54573,,24287,30286,50988,,14863,-1606,36125,3585,6268,,693510
215983,4000,Female,CR23  ,Groot-Amsterdam (CR),2019JJ00,2019,696578,,7443,,4688,,2755,57929,,26694,31235,53060,,15076,-1172,37984,4869,7561,,704139
215984,4000,Female,CR23  ,Groot-Amsterdam (CR),2020JJ00,2020,704139,,7385,,4994,,2391,53756,,19445,34311,54763,,14266,-518,40497,-1007,1336,,705475
215985,4000,Female,CR23  ,Groot-Amsterdam (CR),2021JJ00,2021,705475,,7785,,5063,,2722,58857,,24041,34816,53549,,12342,-386,41207,5308,7988,,713463
215986,4000,Female,CR23  ,Groot-Amsterdam (CR),2022JJ00,2022,713463,,7095,,5343,,1752,69173,,35295,33878,57538,,15249,-757,42289,11635,13287,,737407
215987,4000,Female,CR23  ,Groot-Amsterdam (CR),2023JJ00,2023,737407,,6953,,5167,,1786,65642,,30201,35441,58812,,17271,-1111,41541,6830,8513,,745920
216058,4000,Female,CR24  ,Het Gooi en Vechtstreek (CR),2012JJ00,2012,126446,,1086,,1368,,-282,6957,,1058,5899,6694,,857,-169,5837,263,-20,,126426
216059,4000,Female,CR24  ,Het Gooi en Vechtstreek (CR),2013JJ00,2013,126426,,1035,,1371,,-336,6850,,1047,5803,6563,,902,-72,5661,287,-46,,126380
216060,4000,Female,CR24  ,Het Gooi en Vechtstreek (CR),2014JJ00,2014,126380,,1092,,1400,,-308,8031,,1201,6830,7098,,934,-80,6164,933,626,,127006
216061,4000,Female,CR24  ,Het Gooi en Vechtstreek (CR),2015JJ00,2015,127006,,1133,,1442,,-309,8694,,1376,7318,7449,,897,-66,6552,1245,940,,127946
216062,4000,Female,CR24  ,Het Gooi en Vechtstreek (CR),2016JJ00,2016,127946,,1049,,1425,,-376,8913,,1440,7473,7554,,898,-73,6656,1359,985,,128931
216063,4000,Female,CR24  ,Het Gooi en Vechtstreek (CR),2017JJ00,2017,128931,,1134,,1396,,-262,9279,,1457,7822,7879,,890,-67,6989,1400,1129,,130060
216064,4000,Female,CR24  ,Het Gooi en Vechtstreek (CR),2018JJ00,2018,130060,,1214,,1419,,-205,8711,,1626,7085,7605,,956,-63,6649,1106,905,,130965
216065,4000,Female,CR24  ,Het Gooi en Vechtstreek (CR),2019JJ00,2019,130965,,1189,,1466,,-277,9281,,1766,7515,7988,,956,-51,7032,1293,1018,,131983
216066,4000,Female,CR24  ,Het Gooi en Vechtstreek (CR),2020JJ00,2020,131983,,1198,,1535,,-337,9549,,1420,8129,8294,,897,-51,7397,1255,914,,132897
216067,4000,Female,CR24  ,Het Gooi en Vechtstreek (CR),2021JJ00,2021,132897,,1273,,1577,,-304,9454,,1477,7977,8384,,940,-62,7444,1070,772,,133669
216068,4000,Female,CR24  ,Het Gooi en Vechtstreek (CR),2022JJ00,2022,133669,,1058,,1384,,-326,10109,,3030,7079,7706,,1164,-67,6542,2403,2072,,125084
216069,4000,Female,CR24  ,Het Gooi en Vechtstreek (CR),2023JJ00,2023,125084,,1043,,1396,,-353,8666,,1977,6689,7883,,1191,-100,6692,783,422,,125506
216140,4000,Female,CR25  ,Agglomeratie Leiden en Bollenstreek (CR),2012JJ00,2012,207682,,2057,,1709,,348,11386,,2175,9211,10505,,1785,-259,8720,881,1240,,208922
216141,4000,Female,CR25  ,Agglomeratie Leiden en Bollenstreek (CR),2013JJ00,2013,208922,,1996,,1786,,210,11496,,2321,9175,10805,,1881,-228,8924,691,904,,209826
216142,4000,Female,CR25  ,Agglomeratie Leiden en Bollenstreek (CR),2014JJ00,2014,209826,,1973,,1772,,201,12120,,2327,9793,11206,,1928,-280,9278,914,1107,,210933
216143,4000,Female,CR25  ,Agglomeratie Leiden en Bollenstreek (CR),2015JJ00,2015,210933,,1959,,1772,,187,13394,,2889,10505,12116,,2011,-253,10105,1278,1460,,212393
216144,4000,Female,CR25  ,Agglomeratie Leiden en Bollenstreek (CR),2016JJ00,2016,212393,,2007,,1790,,217,14600,,2856,11744,13146,,2312,-393,10834,1454,1655,,214048
216145,4000,Female,CR25  ,Agglomeratie Leiden en Bollenstreek (CR),2017JJ00,2017,214048,,1953,,1790,,163,15093,,3122,11971,13409,,2529,-505,10880,1684,1837,,215885
216146,4000,Female,CR25  ,Agglomeratie Leiden en Bollenstreek (CR),2018JJ00,2018,215885,,2014,,1938,,76,13968,,3201,10767,12733,,2339,-311,10394,1235,1312,,217197
216147,4000,Female,CR25  ,Agglomeratie Leiden en Bollenstreek (CR),2019JJ00,2019,217197,,1988,,1853,,135,14071,,3350,10721,12630,,2244,-200,10386,1441,1568,,218765
216148,4000,Female,CR25  ,Agglomeratie Leiden en Bollenstreek (CR),2020JJ00,2020,218765,,1930,,2052,,-122,14193,,2452,11741,13625,,2266,-414,11359,568,442,,219207
216149,4000,Female,CR25  ,Agglomeratie Leiden en Bollenstreek (CR),2021JJ00,2021,219207,,2031,,1949,,82,14170,,2856,11314,12780,,1760,-146,11020,1390,1466,,220673
216150,4000,Female,CR25  ,Agglomeratie Leiden en Bollenstreek (CR),2022JJ00,2022,220673,,1908,,2013,,-105,16519,,5119,11400,13189,,2309,-159,10880,3330,3225,,223898
216151,4000,Female,CR25  ,Agglomeratie Leiden en Bollenstreek (CR),2023JJ00,2023,223898,,1972,,2054,,-82,17199,,4044,13155,14069,,2545,-250,11524,3130,3039,,226937
216222,4000,Female,CR26  ,Agglomeratie 's-Gravenhage (CR),2012JJ00,2012,417806,,5024,,3674,,1350,23752,,7943,15809,22325,,6713,-1533,15612,1427,2794,,420600
216223,4000,Female,CR26  ,Agglomeratie 's-Gravenhage (CR),2013JJ00,2013,420600,,4834,,3536,,1298,24658,,8383,16275,23274,,7765,-2319,15509,1384,2693,,423293
216224,4000,Female,CR26  ,Agglomeratie 's-Gravenhage (CR),2014JJ00,2014,423293,,5088,,3605,,1483,25993,,8866,17127,23326,,6554,-1190,16772,2667,4083,,427376
216225,4000,Female,CR26  ,Agglomeratie 's-Gravenhage (CR),2015JJ00,2015,427376,,4913,,3758,,1155,26532,,8662,17870,24245,,6495,-812,17750,2287,3341,,430717
216226,4000,Female,CR26  ,Agglomeratie 's-Gravenhage (CR),2016JJ00,2016,430717,,4982,,3789,,1193,28762,,9278,19484,26052,,7076,-1268,18976,2710,3840,,434557
216227,4000,Female,CR26  ,Agglomeratie 's-Gravenhage (CR),2017JJ00,2017,434557,,4862,,3700,,1162,29965,,10155,19810,26388,,6598,-937,19790,3577,4672,,439229
216228,4000,Female,CR26  ,Agglomeratie 's-Gravenhage (CR),2018JJ00,2018,439229,,4862,,3734,,1128,29147,,10348,18799,26254,,6781,-1002,19473,2893,3841,,443070
216229,4000,Female,CR26  ,Agglomeratie 's-Gravenhage (CR),2019JJ00,2019,443070,,4830,,3639,,1191,30299,,11373,18926,26160,,6411,-488,19749,4139,5283,,448353
216230,4000,Female,CR26  ,Agglomeratie 's-Gravenhage (CR),2020JJ00,2020,448353,,4536,,3979,,557,29037,,9230,19807,28038,,6930,-1059,21108,999,1507,,449860
216231,4000,Female,CR26  ,Agglomeratie 's-Gravenhage (CR),2021JJ00,2021,449860,,4709,,3965,,744,31114,,10415,20699,27581,,5714,-107,21867,3533,4235,,454095
216232,4000,Female,CR26  ,Agglomeratie 's-Gravenhage (CR),2022JJ00,2022,454095,,4363,,4087,,276,35214,,15237,19977,28518,,7164,-602,21354,6696,6918,,461013
216233,4000,Female,CR26  ,Agglomeratie 's-Gravenhage (CR),2023JJ00,2023,461013,,4337,,3815,,522,32668,,12678,19990,29964,,8093,-886,21871,2704,3176,,464189
216304,4000,Female,CR27  ,Delft en Westland (CR),2012JJ00,2012,106544,,996,,772,,224,6227,,2441,3786,5870,,2029,-551,3841,357,581,,107125
216305,4000,Female,CR27  ,Delft en Westland (CR),2013JJ00,2013,107125,,1047,,865,,182,6399,,2438,3961,6100,,2098,-393,4002,299,482,,107607
216306,4000,Female,CR27  ,Delft en Westland (CR),2014JJ00,2014,107607,,968,,790,,178,7163,,2801,4362,6339,,2133,-385,4206,824,1001,,108608
216307,4000,Female,CR27  ,Delft en Westland (CR),2015JJ00,2015,108608,,1044,,844,,200,7143,,2795,4348,6822,,2443,-634,4379,321,515,,109123
216308,4000,Female,CR27  ,Delft en Westland (CR),2016JJ00,2016,109123,,1085,,806,,279,7557,,2807,4750,7168,,2367,-526,4801,389,657,,109780
216309,4000,Female,CR27  ,Delft en Westland (CR),2017JJ00,2017,109780,,987,,877,,110,8334,,2978,5356,6987,,2141,-451,4846,1347,1446,,111226
216310,4000,Female,CR27  ,Delft en Westland (CR),2018JJ00,2018,111226,,1018,,854,,164,8270,,3146,5124,7274,,2494,-349,4780,996,1167,,112393
216311,4000,Female,CR27  ,Delft en Westland (CR),2019JJ00,2019,112393,,1107,,830,,277,8416,,3176,5240,7324,,2346,-354,4978,1092,1361,,113754
216312,4000,Female,CR27  ,Delft en Westland (CR),2020JJ00,2020,113754,,1042,,956,,86,8031,,2503,5528,7443,,2222,-314,5221,588,668,,114422
216313,4000,Female,CR27  ,Delft en Westland (CR),2021JJ00,2021,114422,,1119,,962,,157,8318,,2768,5550,7516,,1821,-288,5695,802,955,,115377
216314,4000,Female,CR27  ,Delft en Westland (CR),2022JJ00,2022,115377,,1031,,1011,,20,9532,,4237,5295,7438,,2044,-377,5394,2094,2103,,117480
216315,4000,Female,CR27  ,Delft en Westland (CR),2023JJ00,2023,117480,,1012,,987,,25,9975,,3436,6539,8194,,2445,-463,5749,1781,1809,,119289
216386,4000,Female,CR28  ,Oost-Zuid-Holland (CR),2012JJ00,2012,148401,,1481,,1125,,356,4916,,599,4317,5347,,509,-67,4838,-431,-74,,148327
216387,4000,Female,CR28  ,Oost-Zuid-Holland (CR),2013JJ00,2013,148327,,1421,,1088,,333,5321,,677,4644,5406,,514,-26,4892,-85,259,,148586
216388,4000,Female,CR28  ,Oost-Zuid-Holland (CR),2014JJ00,2014,148586,,1621,,1160,,461,5513,,733,4780,5335,,530,-70,4805,178,660,,149246
216389,4000,Female,CR28  ,Oost-Zuid-Holland (CR),2015JJ00,2015,160573,,1644,,1298,,346,6496,,784,5712,5834,,529,-68,5305,662,987,,161560
216390,4000,Female,CR28  ,Oost-Zuid-Holland (CR),2016JJ00,2016,161560,,1625,,1310,,315,7537,,1029,6508,6277,,702,-93,5575,1260,1566,,163126
216391,4000,Female,CR28  ,Oost-Zuid-Holland (CR),2017JJ00,2017,163126,,1677,,1302,,375,8321,,962,7359,6799,,746,-131,6053,1522,1886,,165012
216392,4000,Female,CR28  ,Oost-Zuid-Holland (CR),2018JJ00,2018,165012,,1645,,1311,,334,8166,,1067,7099,6633,,721,-124,5912,1533,1875,,166887
216393,4000,Female,CR28  ,Oost-Zuid-Holland (CR),2019JJ00,2019,166887,,1752,,1359,,393,7805,,1042,6763,6663,,722,-94,5941,1142,1531,,168418
216394,4000,Female,CR28  ,Oost-Zuid-Holland (CR),2020JJ00,2020,168418,,1717,,1471,,246,8166,,932,7234,6980,,575,-56,6405,1186,1438,,169856
216395,4000,Female,CR28  ,Oost-Zuid-Holland (CR),2021JJ00,2021,169856,,1946,,1433,,513,7657,,900,6757,6846,,668,-98,6178,811,1319,,171175
216396,4000,Female,CR28  ,Oost-Zuid-Holland (CR),2022JJ00,2022,171175,,1813,,1510,,303,9641,,2433,7208,7153,,1050,-240,6103,2488,2794,,173969
216397,4000,Female,CR28  ,Oost-Zuid-Holland (CR),2023JJ00,2023,173969,,1820,,1517,,303,8619,,1430,7189,7509,,1043,-215,6466,1110,1406,,175375
216468,4000,Female,CR29  ,Groot-Rijnmond (CR),2012JJ00,2012,717010,,7967,,6299,,1668,32906,,7487,25419,32675,,7403,-2404,25272,231,1916,,718926
216469,4000,Female,CR29  ,Groot-Rijnmond (CR),2013JJ00,2013,718926,,7697,,6392,,1305,32644,,7355,25289,32242,,7196,-1828,25046,402,1733,,720659
216470,4000,Female,CR29  ,Groot-Rijnmond (CR),2014JJ00,2014,720659,,7872,,6013,,1859,34738,,8024,26714,32376,,6693,-1173,25683,2362,4283,,724942
216471,4000,Female,CR29  ,Groot-Rijnmond (CR),2015JJ00,2015,713615,,7558,,6347,,1211,36052,,8199,27853,33368,,6796,-1091,26572,2684,3935,,717550
216472,4000,Female,CR29  ,Groot-Rijnmond (CR),2016JJ00,2016,717550,,7773,,6381,,1392,38767,,8393,30374,35221,,6632,-1202,28589,3546,4963,,722513
216473,4000,Female,CR29  ,Groot-Rijnmond (CR),2017JJ00,2017,722513,,7557,,6618,,939,41093,,9047,32046,37438,,6824,-1446,30614,3655,4564,,727077
216474,4000,Female,CR29  ,Groot-Rijnmond (CR),2018JJ00,2018,727077,,7421,,6444,,977,40240,,9599,30641,36254,,5993,-582,30261,3986,4944,,732021
216475,4000,Female,CR29  ,Groot-Rijnmond (CR),2019JJ00,2019,732021,,7733,,6369,,1364,41509,,11104,30405,36535,,6439,-798,30096,4974,6329,,738350
216476,4000,Female,CR29  ,Groot-Rijnmond (CR),2020JJ00,2020,738350,,7567,,7260,,307,41937,,9407,32530,38939,,6501,-854,32438,2998,3234,,741584
216477,4000,Female,CR29  ,Groot-Rijnmond (CR),2021JJ00,2021,741584,,7876,,6931,,945,43457,,10751,32706,39941,,6216,-784,33725,3516,4425,,746009
216478,4000,Female,CR29  ,Groot-Rijnmond (CR),2022JJ00,2022,746009,,7267,,6908,,359,48241,,16009,32232,39590,,7255,-795,32335,8651,8931,,754940
216479,4000,Female,CR29  ,Groot-Rijnmond (CR),2023JJ00,2023,754940,,7132,,6940,,192,46113,,13543,32570,39872,,7731,-975,32141,6241,6359,,761299
216550,4000,Female,CR30  ,Zuidoost-Zuid-Holland (CR),2012JJ00,2012,201571,,2236,,1709,,527,7418,,915,6503,7568,,987,-152,6581,-150,383,,201954
216551,4000,Female,CR30  ,Zuidoost-Zuid-Holland (CR),2013JJ00,2013,201954,,2099,,1783,,316,7255,,954,6301,7394,,890,-81,6504,-139,180,,202134
216552,4000,Female,CR30  ,Zuidoost-Zuid-Holland (CR),2014JJ00,2014,202134,,2224,,1756,,468,7406,,908,6498,7518,,933,-128,6585,-112,360,,202494
216553,4000,Female,CR30  ,Zuidoost-Zuid-Holland (CR),2015JJ00,2015,202494,,2081,,1877,,204,8055,,933,7122,8006,,876,-113,7130,49,263,,202757
216554,4000,Female,CR30  ,Zuidoost-Zuid-Holland (CR),2016JJ00,2016,202757,,2135,,1926,,209,8855,,942,7913,8392,,774,-75,7618,463,673,,203430
216555,4000,Female,CR30  ,Zuidoost-Zuid-Holland (CR),2017JJ00,2017,203430,,2164,,1915,,249,9895,,990,8905,9268,,785,-93,8483,627,864,,204294
216556,4000,Female,CR30  ,Zuidoost-Zuid-Holland (CR),2018JJ00,2018,204294,,2122,,1904,,218,9218,,1095,8123,8783,,821,-121,7962,435,669,,204963
216557,4000,Female,CR30  ,Zuidoost-Zuid-Holland (CR),2019JJ00,2019,187190,,1881,,1707,,174,8258,,1096,7162,7703,,645,-53,7058,555,727,,187917
216558,4000,Female,CR30  ,Zuidoost-Zuid-Holland (CR),2020JJ00,2020,187917,,1891,,1856,,35,8383,,929,7454,7875,,543,-44,7332,508,535,,188452
216559,4000,Female,CR30  ,Zuidoost-Zuid-Holland (CR),2021JJ00,2021,188452,,2089,,1981,,108,9006,,935,8071,8247,,674,-67,7573,759,860,,189312
216560,4000,Female,CR30  ,Zuidoost-Zuid-Holland (CR),2022JJ00,2022,189312,,1962,,1824,,138,10552,,2964,7588,8264,,1094,-153,7170,2288,2426,,191738
216561,4000,Female,CR30  ,Zuidoost-Zuid-Holland (CR),2023JJ00,2023,191738,,1825,,1824,,1,9464,,1575,7889,8928,,1146,-300,7782,536,517,,192255
216632,4000,Female,CR31  ,Zeeuwsch-Vlaanderen (CR),2012JJ00,2012,53507,,424,,610,,-186,1838,,691,1147,1691,,414,-53,1277,147,-43,,53464
216633,4000,Female,CR31  ,Zeeuwsch-Vlaanderen (CR),2013JJ00,2013,53464,,429,,602,,-173,1774,,666,1108,1726,,411,-54,1315,48,-129,,53335
216634,4000,Female,CR31  ,Zeeuwsch-Vlaanderen (CR),2014JJ00,2014,53335,,432,,530,,-98,1818,,655,1163,1786,,489,-71,1297,32,-66,,53269
216635,4000,Female,CR31  ,Zeeuwsch-Vlaanderen (CR),2015JJ00,2015,53269,,444,,637,,-193,1771,,634,1137,1652,,435,-49,1217,119,-79,,53190
216636,4000,Female,CR31  ,Zeeuwsch-Vlaanderen (CR),2016JJ00,2016,53190,,433,,589,,-156,2076,,807,1269,1924,,480,-54,1444,152,-7,,53183
216637,4000,Female,CR31  ,Zeeuwsch-Vlaanderen (CR),2017JJ00,2017,53183,,419,,626,,-207,1998,,731,1267,1883,,457,-46,1426,115,-103,,53080
216638,4000,Female,CR31  ,Zeeuwsch-Vlaanderen (CR),2018JJ00,2018,53080,,391,,619,,-228,2058,,863,1195,1923,,506,-23,1417,135,-86,,52994
216639,4000,Female,CR31  ,Zeeuwsch-Vlaanderen (CR),2019JJ00,2019,52994,,354,,623,,-269,1957,,783,1174,1870,,475,-45,1395,87,-187,,52807
216640,4000,Female,CR31  ,Zeeuwsch-Vlaanderen (CR),2020JJ00,2020,52807,,381,,641,,-260,2058,,746,1312,1798,,463,-26,1335,260,-4,,52803
216641,4000,Female,CR31  ,Zeeuwsch-Vlaanderen (CR),2021JJ00,2021,52803,,462,,667,,-205,1942,,658,1284,1791,,471,-38,1320,151,-50,,52753
216642,4000,Female,CR31  ,Zeeuwsch-Vlaanderen (CR),2022JJ00,2022,52753,,376,,691,,-315,2537,,1181,1356,1901,,625,-75,1276,636,316,,53069
216643,4000,Female,CR31  ,Zeeuwsch-Vlaanderen (CR),2023JJ00,2023,53069,,419,,683,,-264,2158,,839,1319,2021,,561,-75,1460,137,-126,,52943
216714,4000,Female,CR32  ,Overig Zeeland (CR),2012JJ00,2012,138719,,1376,,1307,,69,5854,,1056,4798,5911,,704,-190,5207,-57,12,,138731
216715,4000,Female,CR32  ,Overig Zeeland (CR),2013JJ00,2013,138731,,1291,,1314,,-23,5772,,1013,4759,5871,,621,-100,5250,-99,-119,,138612
216716,4000,Female,CR32  ,Overig Zeeland (CR),2014JJ00,2014,138612,,1358,,1239,,119,5893,,955,4938,5890,,707,-129,5183,3,127,,138739
216717,4000,Female,CR32  ,Overig Zeeland (CR),2015JJ00,2015,138739,,1313,,1338,,-25,6320,,1126,5194,6100,,747,-131,5353,220,208,,138947
216718,4000,Female,CR32  ,Overig Zeeland (CR),2016JJ00,2016,138947,,1276,,1404,,-128,6792,,1143,5649,6564,,734,-134,5830,228,101,,139048
216719,4000,Female,CR32  ,Overig Zeeland (CR),2017JJ00,2017,139048,,1288,,1421,,-133,7299,,1061,6238,6672,,712,-110,5960,627,493,,139541
216720,4000,Female,CR32  ,Overig Zeeland (CR),2018JJ00,2018,139541,,1250,,1435,,-185,7225,,1194,6031,6642,,794,-162,5848,583,395,,139936
216721,4000,Female,CR32  ,Overig Zeeland (CR),2019JJ00,2019,139936,,1286,,1371,,-85,7057,,1297,5760,6661,,838,-112,5823,396,310,,140246
216722,4000,Female,CR32  ,Overig Zeeland (CR),2020JJ00,2020,140246,,1307,,1410,,-103,7306,,1107,6199,6262,,712,-110,5550,1044,927,,141173
216723,4000,Female,CR32  ,Overig Zeeland (CR),2021JJ00,2021,141173,,1329,,1642,,-313,7155,,1198,5957,6146,,821,-153,5325,1009,679,,141852
216724,4000,Female,CR32  ,Overig Zeeland (CR),2022JJ00,2022,141852,,1307,,1486,,-179,8866,,2823,6043,6578,,1220,-133,5358,2288,2096,,143948
216725,4000,Female,CR32  ,Overig Zeeland (CR),2023JJ00,2023,143948,,1207,,1537,,-330,7697,,1726,5971,7227,,1187,-168,6040,470,125,,144073
216796,4000,Female,CR33  ,West-Noord-Brabant (CR),2012JJ00,2012,312859,,2877,,2826,,51,12510,,2361,10149,11956,,1909,-316,10047,554,619,,313478
216797,4000,Female,CR33  ,West-Noord-Brabant (CR),2013JJ00,2013,313478,,2789,,2846,,-57,13223,,2665,10558,12411,,2121,-208,10290,812,766,,314244
216798,4000,Female,CR33  ,West-Noord-Brabant (CR),2014JJ00,2014,314244,,2915,,2885,,30,13956,,2842,11114,13225,,2363,-309,10862,731,766,,315010
216799,4000,Female,CR33  ,West-Noord-Brabant (CR),2015JJ00,2015,315010,,2843,,3030,,-187,14824,,3107,11717,14110,,2427,-320,11683,714,524,,315534
216800,4000,Female,CR33  ,West-Noord-Brabant (CR),2016JJ00,2016,315534,,2917,,3112,,-195,15772,,3197,12575,14631,,2425,-342,12206,1141,929,,316463
216801,4000,Female,CR33  ,West-Noord-Brabant (CR),2017JJ00,2017,316463,,2808,,3121,,-313,16965,,3434,13531,15209,,2487,-418,12722,1756,1415,,317878
216802,4000,Female,CR33  ,West-Noord-Brabant (CR),2018JJ00,2018,317878,,2822,,3130,,-308,16229,,3700,12529,14765,,2721,-378,12044,1464,1132,,319010
216803,4000,Female,CR33  ,West-Noord-Brabant (CR),2019JJ00,2019,319010,,2791,,3060,,-269,16185,,3608,12577,14909,,2876,-605,12033,1276,1000,,320010
216804,4000,Female,CR33  ,West-Noord-Brabant (CR),2020JJ00,2020,320010,,2734,,3322,,-588,15575,,2951,12624,14566,,2226,-260,12340,1009,419,,320429
216805,4000,Female,CR33  ,West-Noord-Brabant (CR),2021JJ00,2021,320429,,2975,,3381,,-406,15943,,3307,12636,14078,,2373,-272,11705,1865,1462,,321891
216806,4000,Female,CR33  ,West-Noord-Brabant (CR),2022JJ00,2022,321891,,2797,,3427,,-630,18256,,5477,12779,14203,,2929,-323,11274,4053,3422,,325313
216807,4000,Female,CR33  ,West-Noord-Brabant (CR),2023JJ00,2023,325313,,2725,,3407,,-682,17839,,4313,13526,15066,,3156,-404,11910,2773,2084,,327397
216878,4000,Female,CR34  ,Midden-Noord-Brabant (CR),2012JJ00,2012,231698,,2186,,1948,,238,10244,,1818,8426,9767,,1366,-142,8401,477,717,,232415
216879,4000,Female,CR34  ,Midden-Noord-Brabant (CR),2013JJ00,2013,232415,,2201,,1929,,272,10728,,2039,8689,9918,,1420,-95,8498,810,1090,,233505
216880,4000,Female,CR34  ,Midden-Noord-Brabant (CR),2014JJ00,2014,233505,,2243,,1975,,268,10900,,2072,8828,10470,,1521,-295,8949,430,701,,234206
216881,4000,Female,CR34  ,Midden-Noord-Brabant (CR),2015JJ00,2015,234206,,2238,,2066,,172,11887,,2546,9341,10971,,1575,-247,9396,916,1094,,235300
216882,4000,Female,CR34  ,Midden-Noord-Brabant (CR),2016JJ00,2016,235300,,2267,,2045,,222,13788,,3552,10236,12811,,1697,-300,11114,977,1207,,236507
216883,4000,Female,CR34  ,Midden-Noord-Brabant (CR),2017JJ00,2017,236507,,2197,,2112,,85,13886,,2907,10979,12458,,1672,-158,10786,1428,1507,,238014
216884,4000,Female,CR34  ,Midden-Noord-Brabant (CR),2018JJ00,2018,238014,,2248,,2206,,42,13907,,3426,10481,12085,,1853,-322,10232,1822,1855,,239869
216885,4000,Female,CR34  ,Midden-Noord-Brabant (CR),2019JJ00,2019,239869,,2187,,2148,,39,13780,,3658,10122,11497,,1814,-231,9683,2283,2324,,242193
216886,4000,Female,CR34  ,Midden-Noord-Brabant (CR),2020JJ00,2020,242193,,2215,,2419,,-204,14420,,3559,10861,13021,,2101,-363,10920,1399,1187,,243380
216887,4000,Female,CR34  ,Midden-Noord-Brabant (CR),2021JJ00,2021,246839,,2384,,2370,,14,14658,,4317,10341,12645,,1929,-204,10716,2013,2033,,248872
216888,4000,Female,CR34  ,Midden-Noord-Brabant (CR),2022JJ00,2022,248872,,2263,,2491,,-228,16392,,6167,10225,12841,,2358,-201,10483,3551,3326,,252198
216889,4000,Female,CR34  ,Midden-Noord-Brabant (CR),2023JJ00,2023,252198,,2266,,2445,,-179,15853,,5423,10430,13994,,2799,-381,11195,1859,1684,,253882
216960,4000,Female,CR35  ,Noordoost-Noord-Brabant (CR),2012JJ00,2012,321170,,3037,,2638,,399,12522,,1686,10836,12293,,1313,-252,10980,229,634,,321804
216961,4000,Female,CR35  ,Noordoost-Noord-Brabant (CR),2013JJ00,2013,321804,,2997,,2662,,335,12447,,1767,10680,12575,,1273,-167,11302,-128,207,,322011
216962,4000,Female,CR35  ,Noordoost-Noord-Brabant (CR),2014JJ00,2014,322011,,3102,,2611,,491,13649,,2039,11610,13283,,1366,-152,11917,366,853,,322864
216963,4000,Female,CR35  ,Noordoost-Noord-Brabant (CR),2015JJ00,2015,322864,,2952,,2827,,125,14536,,2244,12292,13714,,1437,-226,12277,822,950,,323814
216964,4000,Female,CR35  ,Noordoost-Noord-Brabant (CR),2016JJ00,2016,323814,,3047,,2771,,276,15193,,2117,13076,13933,,1427,-201,12506,1260,1526,,325340
216965,4000,Female,CR35  ,Noordoost-Noord-Brabant (CR),2017JJ00,2017,325340,,2976,,2912,,64,16370,,2028,14342,14425,,1399,-179,13026,1945,1989,,327329
216966,4000,Female,CR35  ,Noordoost-Noord-Brabant (CR),2018JJ00,2018,327329,,2940,,2992,,-52,15815,,2227,13588,13978,,1443,-205,12535,1837,1780,,329109
216967,4000,Female,CR35  ,Noordoost-Noord-Brabant (CR),2019JJ00,2019,329109,,2965,,2906,,59,15917,,2430,13487,13920,,1530,-219,12390,1997,2025,,331134
216968,4000,Female,CR35  ,Noordoost-Noord-Brabant (CR),2020JJ00,2020,331134,,3032,,3480,,-448,16242,,2130,14112,14228,,1211,-133,13017,2014,1551,,332685
216969,4000,Female,CR35  ,Noordoost-Noord-Brabant (CR),2021JJ00,2021,329226,,3195,,3239,,-44,16382,,2149,14233,14093,,1410,-164,12683,2289,2237,,331463
216970,4000,Female,CR35  ,Noordoost-Noord-Brabant (CR),2022JJ00,2022,331463,,3036,,3259,,-223,17791,,4828,12963,13472,,2049,-328,11423,4319,4087,,335550
216971,4000,Female,CR35  ,Noordoost-Noord-Brabant (CR),2023JJ00,2023,335550,,2900,,3389,,-489,16676,,3360,13316,14289,,2040,-393,12249,2387,1879,,337429
217042,4000,Female,CR36  ,Zuidoost-Noord-Brabant (CR),2012JJ00,2012,367991,,3513,,3034,,479,15803,,3214,12589,15004,,2468,-401,12536,799,1285,,369276
217043,4000,Female,CR36  ,Zuidoost-Noord-Brabant (CR),2013JJ00,2013,369276,,3472,,3057,,415,16726,,3514,13212,15574,,2661,-290,12913,1152,1570,,370846
217044,4000,Female,CR36  ,Zuidoost-Noord-Brabant (CR),2014JJ00,2014,370846,,3649,,3092,,557,17825,,3777,14048,16419,,2855,-361,13564,1406,1969,,372815
217045,4000,Female,CR36  ,Zuidoost-Noord-Brabant (CR),2015JJ00,2015,372815,,3460,,3326,,134,18911,,4481,14430,17401,,2908,-325,14493,1510,1645,,374460
217046,4000,Female,CR36  ,Zuidoost-Noord-Brabant (CR),2016JJ00,2016,374460,,3498,,3353,,145,21247,,5339,15908,19144,,3051,-411,16093,2103,2243,,376703
217047,4000,Female,CR36  ,Zuidoost-Noord-Brabant (CR),2017JJ00,2017,376703,,3438,,3333,,105,23037,,5841,17196,20853,,2878,-328,17975,2184,2269,,378972
217048,4000,Female,CR36  ,Zuidoost-Noord-Brabant (CR),2018JJ00,2018,378972,,3505,,3481,,24,21661,,5432,16229,18895,,2953,-310,15942,2766,2766,,381738
217049,4000,Female,CR36  ,Zuidoost-Noord-Brabant (CR),2019JJ00,2019,381738,,3503,,3371,,132,22478,,6597,15881,19408,,3020,-322,16388,3070,3194,,384932
217050,4000,Female,CR36  ,Zuidoost-Noord-Brabant (CR),2020JJ00,2020,384932,,3485,,3836,,-351,22453,,5586,16867,20414,,2848,-257,17566,2039,1665,,386597
217051,4000,Female,CR36  ,Zuidoost-Noord-Brabant (CR),2021JJ00,2021,386597,,3894,,3755,,139,24062,,6906,17156,21174,,2917,-226,18257,2888,3033,,389630
217052,4000,Female,CR36  ,Zuidoost-Noord-Brabant (CR),2022JJ00,2022,389630,,3507,,3788,,-281,28190,,11835,16355,22328,,3646,-334,18682,5862,5593,,395223
217053,4000,Female,CR36  ,Zuidoost-Noord-Brabant (CR),2023JJ00,2023,395223,,3427,,3810,,-383,26982,,10528,16454,24071,,3934,-431,20137,2911,2533,,397756
217124,4000,Female,CR37  ,Noord-Limburg (CR),2012JJ00,2012,139759,,1271,,1102,,169,4415,,1081,3334,4660,,714,-44,3946,-245,-70,,139689
217125,4000,Female,CR37  ,Noord-Limburg (CR),2013JJ00,2013,139689,,1245,,1219,,26,4488,,1170,3318,4453,,611,-54,3842,35,63,,139752
217126,4000,Female,CR37  ,Noord-Limburg (CR),2014JJ00,2014,139752,,1148,,1153,,-5,4857,,1242,3615,4975,,725,-64,4250,-118,-120,,139632
217127,4000,Female,CR37  ,Noord-Limburg (CR),2015JJ00,2015,139632,,1086,,1273,,-187,4890,,1128,3762,4918,,851,-146,4067,-28,-213,,139419
217128,4000,Female,CR37  ,Noord-Limburg (CR),2016JJ00,2016,139419,,1202,,1255,,-53,5603,,1421,4182,4961,,715,-58,4246,642,576,,139995
217129,4000,Female,CR37  ,Noord-Limburg (CR),2017JJ00,2017,139995,,1159,,1270,,-111,5662,,1278,4384,5585,,866,-123,4719,77,-46,,139949
217130,4000,Female,CR37  ,Noord-Limburg (CR),2018JJ00,2018,139949,,1212,,1343,,-131,5321,,1376,3945,5037,,818,-104,4219,284,150,,140099
217131,4000,Female,CR37  ,Noord-Limburg (CR),2019JJ00,2019,140099,,1172,,1309,,-137,5552,,1551,4001,5189,,913,-168,4276,363,222,,140321
217132,4000,Female,CR37  ,Noord-Limburg (CR),2020JJ00,2020,140321,,1144,,1376,,-232,5653,,1463,4190,5130,,862,-76,4268,523,289,,140610
217133,4000,Female,CR37  ,Noord-Limburg (CR),2021JJ00,2021,140610,,1306,,1413,,-107,5963,,1575,4388,5051,,963,-166,4088,912,800,,141410
217134,4000,Female,CR37  ,Noord-Limburg (CR),2022JJ00,2022,141410,,1221,,1378,,-157,7861,,3493,4368,5444,,1426,-197,4018,2417,2260,,143670
217135,4000,Female,CR37  ,Noord-Limburg (CR),2023JJ00,2023,143670,,1145,,1497,,-352,7124,,2868,4256,6421,,1827,-296,4594,703,351,,144021
217206,4000,Female,CR38  ,Midden-Limburg (CR),2012JJ00,2012,117749,,992,,1123,,-131,4679,,915,3764,4506,,561,-47,3945,173,39,,117788
217207,4000,Female,CR38  ,Midden-Limburg (CR),2013JJ00,2013,117788,,987,,1089,,-102,4597,,834,3763,4575,,598,-70,3977,22,-77,,117711
217208,4000,Female,CR38  ,Midden-Limburg (CR),2014JJ00,2014,117711,,956,,1124,,-168,4739,,1005,3734,4589,,563,-70,4026,150,-25,,117686
217209,4000,Female,CR38  ,Midden-Limburg (CR),2015JJ00,2015,117686,,982,,1232,,-250,5111,,991,4120,4866,,632,-72,4234,245,2,,117688
217210,4000,Female,CR38  ,Midden-Limburg (CR),2016JJ00,2016,117688,,956,,1144,,-188,5559,,915,4644,5263,,612,-88,4651,296,104,,117792
217211,4000,Female,CR38  ,Midden-Limburg (CR),2017JJ00,2017,117792,,970,,1243,,-273,6065,,890,5175,5444,,593,-36,4851,621,340,,118132
217212,4000,Female,CR38  ,Midden-Limburg (CR),2018JJ00,2018,118132,,913,,1212,,-299,5741,,993,4748,5323,,617,-76,4706,418,113,,118245
217213,4000,Female,CR38  ,Midden-Limburg (CR),2019JJ00,2019,118245,,915,,1206,,-291,5978,,1186,4792,5402,,744,-141,4658,576,274,,118519
217214,4000,Female,CR38  ,Midden-Limburg (CR),2020JJ00,2020,118519,,933,,1361,,-428,6155,,973,5182,5332,,647,-99,4685,823,385,,118904
217215,4000,Female,CR38  ,Midden-Limburg (CR),2021JJ00,2021,118904,,1037,,1448,,-411,5952,,1000,4952,5114,,706,-130,4408,838,418,,119322
217216,4000,Female,CR38  ,Midden-Limburg (CR),2022JJ00,2022,119322,,982,,1388,,-406,7023,,1943,5080,5451,,1020,-172,4431,1572,1161,,120483
217217,4000,Female,CR38  ,Midden-Limburg (CR),2023JJ00,2023,120483,,988,,1413,,-425,6261,,1512,4749,5334,,972,-211,4362,927,497,,120980
217288,4000,Female,CR39  ,Zuid-Limburg (CR),2012JJ00,2012,308679,,2191,,3401,,-1210,15564,,3868,11696,15070,,2855,-295,12215,494,-726,,307953
217289,4000,Female,CR39  ,Zuid-Limburg (CR),2013JJ00,2013,307953,,2244,,3369,,-1125,15635,,3968,11667,15393,,3261,-219,12132,242,-898,,307055
217290,4000,Female,CR39  ,Zuid-Limburg (CR),2014JJ00,2014,307055,,2241,,3316,,-1075,16327,,4090,12237,16319,,3510,-237,12809,8,-1082,,305973
217291,4000,Female,CR39  ,Zuid-Limburg (CR),2015JJ00,2015,305973,,2198,,3406,,-1208,17437,,4891,12546,16907,,3673,-209,13234,530,-697,,305276
217292,4000,Female,CR39  ,Zuid-Limburg (CR),2016JJ00,2016,305276,,2203,,3418,,-1215,17763,,4627,13136,17103,,3515,-191,13588,660,-566,,304710
217293,4000,Female,CR39  ,Zuid-Limburg (CR),2017JJ00,2017,304710,,2093,,3576,,-1483,18933,,5000,13933,17965,,3736,-203,14229,968,-537,,304173
217294,4000,Female,CR39  ,Zuid-Limburg (CR),2018JJ00,2018,304173,,2166,,3544,,-1378,18652,,5187,13465,18250,,4414,-175,13836,402,-982,,303191
217295,4000,Female,CR39  ,Zuid-Limburg (CR),2019JJ00,2019,303191,,2182,,3503,,-1321,19046,,5735,13311,17873,,4240,-140,13633,1173,-157,,303034
217296,4000,Female,CR39  ,Zuid-Limburg (CR),2020JJ00,2020,303034,,2183,,4004,,-1821,19001,,4960,14041,18984,,4778,-122,14206,17,-1825,,301209
217297,4000,Female,CR39  ,Zuid-Limburg (CR),2021JJ00,2021,301209,,2263,,4041,,-1778,19903,,5609,14294,18170,,4157,-157,14013,1733,-60,,301149
217298,4000,Female,CR39  ,Zuid-Limburg (CR),2022JJ00,2022,301149,,2178,,3764,,-1586,21836,,8054,13782,18183,,4898,-165,13285,3653,2050,,303199
217299,4000,Female,CR39  ,Zuid-Limburg (CR),2023JJ00,2023,303199,,2211,,3820,,-1609,21001,,6880,14121,18014,,4694,-199,13320,2987,1372,,304571
217370,4000,Female,CR40  ,Flevoland (CR),2012JJ00,2012,197742,,2465,,1112,,1353,7864,,1788,6076,7841,,1285,-109,6556,23,1385,,199127
217371,4000,Female,CR40  ,Flevoland (CR),2013JJ00,2013,199127,,2269,,1093,,1176,8005,,2240,5765,8370,,1571,-257,6799,-365,816,,199943
217372,4000,Female,CR40  ,Flevoland (CR),2014JJ00,2014,199943,,2474,,1050,,1424,8330,,2497,5833,8946,,1636,-167,7310,-616,899,,200842
217373,4000,Female,CR40  ,Flevoland (CR),2015JJ00,2015,200842,,2261,,1142,,1119,9658,,3026,6632,9710,,1717,-251,7993,-52,1069,,201911
217374,4000,Female,CR40  ,Flevoland (CR),2016JJ00,2016,201911,,2252,,1164,,1088,10397,,2748,7649,9718,,1557,-143,8161,679,1769,,203680
217375,4000,Female,CR40  ,Flevoland (CR),2017JJ00,2017,203680,,2257,,1144,,1113,10841,,2174,8667,9865,,1643,-177,8222,976,2078,,205758
217376,4000,Female,CR40  ,Flevoland (CR),2018JJ00,2018,205758,,2321,,1266,,1055,11065,,2518,8547,9564,,1629,-96,7935,1501,2550,,208308
217377,4000,Female,CR40  ,Flevoland (CR),2019JJ00,2019,208308,,2352,,1201,,1151,11814,,3019,8795,9882,,1693,-115,8189,1932,3070,,211378
217378,4000,Female,CR40  ,Flevoland (CR),2020JJ00,2020,211378,,2387,,1293,,1094,11606,,2239,9367,10157,,1427,-119,8730,1449,2547,,213925
217379,4000,Female,CR40  ,Flevoland (CR),2021JJ00,2021,213925,,2536,,1405,,1131,12581,,2549,10032,10443,,1688,-167,8755,2138,3261,,217186
217380,4000,Female,CR40  ,Flevoland (CR),2022JJ00,2022,217186,,2572,,1403,,1169,15215,,5352,9863,11253,,2513,-272,8740,3962,5112,,222298
217381,4000,Female,CR40  ,Flevoland (CR),2023JJ00,2023,222298,,2437,,1423,,1014,13527,,3892,9635,11539,,2856,-386,8683,1988,2993,,225291
217452,4000,Female,GM1680,Aa en Hunze,2012JJ00,2012,12904,,74,,120,,-46,543,,44,499,546,,19,-7,527,-3,-49,,12855
217453,4000,Female,GM1680,Aa en Hunze,2013JJ00,2013,12855,,76,,109,,-33,511,,28,483,577,,30,-7,547,-66,-99,,12756
217454,4000,Female,GM1680,Aa en Hunze,2014JJ00,2014,12756,,73,,112,,-39,557,,27,530,617,,49,-6,568,-60,-98,,12658
217455,4000,Female,GM1680,Aa en Hunze,2015JJ00,2015,12658,,77,,120,,-43,683,,32,651,629,,28,-1,601,54,8,,12666
217456,4000,Female,GM1680,Aa en Hunze,2016JJ00,2016,12666,,67,,148,,-81,745,,37,708,649,,51,-5,598,96,17,,12683
217457,4000,Female,GM1680,Aa en Hunze,2017JJ00,2017,12683,,74,,134,,-60,856,,44,812,754,,36,-1,718,102,41,,12724
217458,4000,Female,GM1680,Aa en Hunze,2018JJ00,2018,12724,,78,,146,,-68,743,,44,699,671,,31,1,640,72,3,,12727
217459,4000,Female,GM1680,Aa en Hunze,2019JJ00,2019,12727,,87,,136,,-49,758,,49,709,698,,27,-1,671,60,10,,12737
217460,4000,Female,GM1680,Aa en Hunze,2020JJ00,2020,12737,,73,,138,,-65,756,,30,726,737,,30,-3,707,19,-47,,12690
217461,4000,Female,GM1680,Aa en Hunze,2021JJ00,2021,12690,,98,,138,,-40,770,,24,746,615,,27,-3,588,155,115,,12805
217462,4000,Female,GM1680,Aa en Hunze,2022JJ00,2022,12805,,86,,152,,-66,860,,227,633,695,,86,-11,609,165,99,,12904
217463,4000,Female,GM1680,Aa en Hunze,2023JJ00,2023,12904,,90,,153,,-63,820,,125,695,679,,74,-15,605,141,74,,12978
217616,4000,Female,GM0738,Aalburg,2012JJ00,2012,6308,,73,,41,,32,187,,27,160,212,,29,-6,183,-25,7,,6315
217617,4000,Female,GM0738,Aalburg,2013JJ00,2013,6315,,64,,50,,14,201,,26,175,174,,6,5,168,27,41,,6356
217618,4000,Female,GM0738,Aalburg,2014JJ00,2014,6356,,75,,52,,23,226,,29,197,225,,16,-4,209,1,26,,6382
217619,4000,Female,GM0738,Aalburg,2015JJ00,2015,6382,,86,,54,,32,255,,45,210,216,,17,-1,199,39,74,,6456
217620,4000,Female,GM0738,Aalburg,2016JJ00,2016,6456,,71,,64,,7,235,,26,209,244,,19,-5,225,-9,-4,,6452
217621,4000,Female,GM0738,Aalburg,2017JJ00,2017,6452,,51,,40,,11,270,,29,241,264,,7,0,257,6,17,,6469
217622,4000,Female,GM0738,Aalburg,2018JJ00,2018,6469,,80,,41,,39,329,,39,290,304,,17,-1,287,25,71,,6540
217698,4000,Female,GM0358,Aalsmeer,2012JJ00,2012,15315,,163,,115,,48,635,,139,496,559,,83,-12,476,76,125,,15440
217699,4000,Female,GM0358,Aalsmeer,2013JJ00,2013,15440,,184,,109,,75,636,,136,500,613,,101,-24,512,23,97,,15537
217700,4000,Female,GM0358,Aalsmeer,2014JJ00,2014,15537,,144,,114,,30,769,,171,598,635,,78,-9,557,134,166,,15703
217701,4000,Female,GM0358,Aalsmeer,2015JJ00,2015,15703,,137,,107,,30,790,,181,609,699,,116,-27,583,91,119,,15822
217702,4000,Female,GM0358,Aalsmeer,2016JJ00,2016,15822,,120,,116,,4,872,,159,713,841,,101,-24,740,31,35,,15857
217703,4000,Female,GM0358,Aalsmeer,2017JJ00,2017,15857,,118,,138,,-20,885,,145,740,819,,125,-22,694,66,46,,15903
217704,4000,Female,GM0358,Aalsmeer,2018JJ00,2018,15903,,151,,143,,8,844,,123,721,722,,110,-12,612,122,131,,16034
217705,4000,Female,GM0358,Aalsmeer,2019JJ00,2019,16034,,112,,137,,-25,805,,166,639,770,,110,-15,660,35,10,,16044
217706,4000,Female,GM0358,Aalsmeer,2020JJ00,2020,16044,,108,,152,,-44,948,,174,774,868,,106,-14,762,80,34,,16078
217707,4000,Female,GM0358,Aalsmeer,2021JJ00,2021,16078,,168,,124,,44,1062,,341,721,837,,124,-23,713,225,267,,16345
217708,4000,Female,GM0358,Aalsmeer,2022JJ00,2022,16345,,131,,141,,-10,1297,,579,718,935,,288,-57,647,362,347,,16692
217709,4000,Female,GM0358,Aalsmeer,2023JJ00,2023,16692,,111,,144,,-33,1300,,545,755,1135,,477,-43,658,165,131,,16823
217780,4000,Female,GM0197,Aalten,2012JJ00,2012,13619,,124,,103,,21,339,,31,308,422,,36,-9,386,-83,-64,,13555
217781,4000,Female,GM0197,Aalten,2013JJ00,2013,13555,,129,,126,,3,317,,37,280,365,,36,1,329,-48,-46,,13509
217782,4000,Female,GM0197,Aalten,2014JJ00,2014,13509,,106,,116,,-10,336,,43,293,403,,43,-5,360,-67,-76,,13433
217783,4000,Female,GM0197,Aalten,2015JJ00,2015,13433,,116,,135,,-19,409,,48,361,395,,43,0,352,14,-3,,13430
217784,4000,Female,GM0197,Aalten,2016JJ00,2016,13430,,104,,135,,-31,555,,101,454,530,,32,1,498,25,-8,,13422
217785,4000,Female,GM0197,Aalten,2017JJ00,2017,13422,,114,,151,,-37,603,,62,541,585,,35,-6,550,18,-19,,13403
217786,4000,Female,GM0197,Aalten,2018JJ00,2018,13403,,111,,134,,-23,493,,63,430,421,,51,0,370,72,49,,13452
217787,4000,Female,GM0197,Aalten,2019JJ00,2019,13452,,115,,135,,-20,455,,47,408,413,,36,-4,377,42,20,,13472
217788,4000,Female,GM0197,Aalten,2020JJ00,2020,13472,,127,,146,,-19,408,,47,361,395,,29,0,366,13,-7,,13465
217789,4000,Female,GM0197,Aalten,2021JJ00,2021,13465,,136,,159,,-23,460,,47,413,432,,53,-4,379,28,5,,13470
217790,4000,Female,GM0197,Aalten,2022JJ00,2022,13470,,103,,165,,-62,504,,122,382,396,,54,-14,342,108,44,,13514
217791,4000,Female,GM0197,Aalten,2023JJ00,2023,13514,,106,,152,,-46,482,,88,394,422,,68,-16,354,60,14,,13528
218354,4000,Female,GM0059,Achtkarspelen,2012JJ00,2012,13828,,148,,122,,26,416,,30,386,441,,16,-1,425,-25,1,,13829
218355,4000,Female,GM0059,Achtkarspelen,2013JJ00,2013,13829,,126,,108,,18,354,,24,330,440,,22,-3,418,-86,-68,,13761
218356,4000,Female,GM0059,Achtkarspelen,2014JJ00,2014,13761,,137,,102,,35,418,,26,392,448,,20,-3,428,-30,4,,13765
218357,4000,Female,GM0059,Achtkarspelen,2015JJ00,2015,13765,,148,,126,,22,505,,36,469,525,,14,-2,511,-20,3,,13768
218358,4000,Female,GM0059,Achtkarspelen,2016JJ00,2016,13768,,142,,126,,16,496,,14,482,570,,31,-4,539,-74,-60,,13708
218359,4000,Female,GM0059,Achtkarspelen,2017JJ00,2017,13708,,127,,113,,14,522,,17,505,513,,19,0,494,9,24,,13732
218360,4000,Female,GM0059,Achtkarspelen,2018JJ00,2018,13732,,129,,121,,8,545,,35,510,600,,24,-3,576,-55,-47,,13685
218361,4000,Female,GM0059,Achtkarspelen,2019JJ00,2019,13685,,137,,125,,12,577,,26,551,610,,33,1,577,-33,-22,,13663
218362,4000,Female,GM0059,Achtkarspelen,2020JJ00,2020,13663,,146,,129,,17,509,,26,483,506,,12,-1,494,3,20,,13683
218363,4000,Female,GM0059,Achtkarspelen,2021JJ00,2021,13683,,140,,152,,-12,532,,26,506,508,,23,-4,485,24,12,,13695
218364,4000,Female,GM0059,Achtkarspelen,2022JJ00,2022,13695,,131,,117,,14,610,,142,468,522,,56,-12,466,88,102,,13797
218365,4000,Female,GM0059,Achtkarspelen,2023JJ00,2023,13797,,140,,122,,18,604,,125,479,574,,69,-27,505,30,49,,13846
218764,4000,Female,GM0482,Alblasserdam,2012JJ00,2012,9971,,127,,88,,39,322,,19,303,299,,31,0,268,23,62,,10033
218765,4000,Female,GM0482,Alblasserdam,2013JJ00,2013,10033,,120,,79,,41,345,,24,321,312,,20,-2,292,33,75,,10108
218766,4000,Female,GM0482,Alblasserdam,2014JJ00,2014,10108,,123,,89,,34,309,,32,277,318,,23,-1,295,-9,24,,10132
218767,4000,Female,GM0482,Alblasserdam,2015JJ00,2015,10132,,124,,100,,24,389,,39,350,361,,37,-4,324,28,52,,10184
218768,4000,Female,GM0482,Alblasserdam,2016JJ00,2016,10184,,119,,90,,29,362,,25,337,375,,17,1,358,-13,15,,10199
218769,4000,Female,GM0482,Alblasserdam,2017JJ00,2017,10199,,118,,96,,22,403,,40,363,435,,23,3,412,-32,-11,,10188
218770,4000,Female,GM0482,Alblasserdam,2018JJ00,2018,10188,,121,,72,,49,390,,30,360,409,,28,-2,381,-19,28,,10216
218771,4000,Female,GM0482,Alblasserdam,2019JJ00,2019,10216,,118,,97,,21,426,,35,391,412,,20,-1,392,14,35,,10251
218772,4000,Female,GM0482,Alblasserdam,2020JJ00,2020,10251,,97,,105,,-8,419,,21,398,423,,15,2,408,-4,-12,,10239
218773,4000,Female,GM0482,Alblasserdam,2021JJ00,2021,10239,,120,,109,,11,415,,34,381,462,,27,0,435,-47,-37,,10202
218774,4000,Female,GM0482,Alblasserdam,2022JJ00,2022,10202,,113,,100,,13,581,,162,419,460,,39,-8,421,121,135,,10337
218775,4000,Female,GM0482,Alblasserdam,2023JJ00,2023,10337,,112,,88,,24,446,,87,359,507,,69,-30,438,-61,-38,,10299
218846,4000,Female,GM0613,Albrandswaard,2012JJ00,2012,12615,,135,,94,,41,484,,42,442,494,,30,2,464,-10,31,,12646
218847,4000,Female,GM0613,Albrandswaard,2013JJ00,2013,12646,,127,,87,,40,454,,42,412,522,,38,7,484,-68,-28,,12618
218848,4000,Female,GM0613,Albrandswaard,2014JJ00,2014,12618,,127,,85,,42,529,,26,503,566,,34,8,532,-37,5,,12623
218849,4000,Female,GM0613,Albrandswaard,2015JJ00,2015,12623,,98,,85,,13,540,,45,495,615,,31,1,584,-75,-62,,12561
218850,4000,Female,GM0613,Albrandswaard,2016JJ00,2016,12561,,121,,77,,44,746,,49,697,694,,46,-5,648,52,94,,12655
218851,4000,Female,GM0613,Albrandswaard,2017JJ00,2017,12655,,116,,83,,33,687,,37,650,656,,59,-4,597,31,64,,12719
218852,4000,Female,GM0613,Albrandswaard,2018JJ00,2018,12719,,102,,84,,18,616,,51,565,602,,29,-7,573,14,34,,12753
218853,4000,Female,GM0613,Albrandswaard,2019JJ00,2019,12753,,99,,76,,23,713,,48,665,576,,29,-2,547,137,160,,12913
218854,4000,Female,GM0613,Albrandswaard,2020JJ00,2020,12913,,105,,98,,7,736,,27,709,650,,23,1,627,86,94,,13007
218855,4000,Female,GM0613,Albrandswaard,2021JJ00,2021,13007,,110,,78,,32,668,,51,617,662,,34,-1,628,6,39,,13046
218856,4000,Female,GM0613,Albrandswaard,2022JJ00,2022,13046,,114,,80,,34,767,,96,671,535,,42,-5,493,232,266,,13312
218857,4000,Female,GM0613,Albrandswaard,2023JJ00,2023,13312,,99,,84,,15,594,,54,540,585,,48,-1,537,9,23,,13335
219092,4000,Female,GM0361,Alkmaar,2012JJ00,2012,47846,,529,,407,,122,2359,,403,1956,2378,,373,-82,2005,-19,110,,47956
219093,4000,Female,GM0361,Alkmaar,2013JJ00,2013,47956,,506,,387,,119,2291,,414,1877,2252,,249,-30,2003,39,160,,48116
219094,4000,Female,GM0361,Alkmaar,2014JJ00,2014,48116,,556,,402,,154,2356,,433,1923,2372,,253,-16,2119,-16,143,,48259
219095,4000,Female,GM0361,Alkmaar,2015JJ00,2015,54133,,536,,463,,73,2896,,571,2325,2749,,317,-19,2432,147,216,,54349
219096,4000,Female,GM0361,Alkmaar,2016JJ00,2016,54349,,567,,492,,75,3288,,524,2764,3006,,373,-69,2633,282,365,,54714
219097,4000,Female,GM0361,Alkmaar,2017JJ00,2017,54714,,514,,427,,87,3088,,377,2711,3128,,296,-25,2832,-40,43,,54757
219098,4000,Female,GM0361,Alkmaar,2018JJ00,2018,54757,,534,,478,,56,2873,,411,2462,2819,,322,-79,2497,54,106,,54863
219099,4000,Female,GM0361,Alkmaar,2019JJ00,2019,54863,,538,,462,,76,2942,,406,2536,2585,,260,-11,2325,357,423,,55286
219100,4000,Female,GM0361,Alkmaar,2020JJ00,2020,55286,,513,,489,,24,2949,,340,2609,2710,,240,-33,2470,239,255,,55541
219101,4000,Female,GM0361,Alkmaar,2021JJ00,2021,55541,,579,,520,,59,3007,,372,2635,2669,,274,-31,2395,338,400,,55941
219102,4000,Female,GM0361,Alkmaar,2022JJ00,2022,55941,,554,,553,,1,3392,,848,2544,2679,,340,-59,2339,713,714,,56655
219103,4000,Female,GM0361,Alkmaar,2023JJ00,2023,56655,,495,,515,,-20,2999,,474,2525,2747,,375,-64,2372,252,226,,56881
219174,4000,Female,GM0141,Almelo,2012JJ00,2012,36668,,353,,341,,12,1248,,247,1001,1324,,150,-27,1174,-76,-63,,36605
219175,4000,Female,GM0141,Almelo,2013JJ00,2013,36605,,375,,355,,20,1169,,226,943,1343,,163,-29,1180,-174,-152,,36453
219176,4000,Female,GM0141,Almelo,2014JJ00,2014,36453,,340,,304,,36,1158,,192,966,1344,,154,-14,1190,-186,-153,,36300
219177,4000,Female,GM0141,Almelo,2015JJ00,2015,36300,,364,,357,,7,1329,,235,1094,1326,,156,-34,1170,3,10,,36310
219178,4000,Female,GM0141,Almelo,2016JJ00,2016,36310,,358,,399,,-41,1402,,273,1129,1353,,158,-23,1195,49,4,,36314
219179,4000,Female,GM0141,Almelo,2017JJ00,2017,36314,,321,,366,,-45,1587,,237,1350,1460,,148,-20,1312,127,76,,36390
219180,4000,Female,GM0141,Almelo,2018JJ00,2018,36390,,299,,393,,-94,1562,,289,1273,1429,,175,-28,1254,133,38,,36428
219181,4000,Female,GM0141,Almelo,2019JJ00,2019,36428,,359,,370,,-11,1462,,280,1182,1356,,143,-22,1213,106,87,,36515
219182,4000,Female,GM0141,Almelo,2020JJ00,2020,36515,,323,,370,,-47,1394,,247,1147,1373,,154,-32,1219,21,-26,,36489
219183,4000,Female,GM0141,Almelo,2021JJ00,2021,36489,,324,,417,,-93,1431,,240,1191,1317,,179,-43,1138,114,19,,36508
219184,4000,Female,GM0141,Almelo,2022JJ00,2022,36508,,320,,413,,-93,1929,,609,1320,1504,,212,-24,1292,425,327,,36835
219185,4000,Female,GM0141,Almelo,2023JJ00,2023,36835,,269,,406,,-137,1731,,381,1350,1473,,251,-72,1222,258,118,,36953
219256,4000,Female,GM0034,Almere,2012JJ00,2012,97289,,1239,,477,,762,3958,,860,3098,3723,,712,57,3011,235,996,,98285
219257,4000,Female,GM0034,Almere,2013JJ00,2013,98285,,1128,,448,,680,3877,,999,2878,4069,,865,-18,3204,-192,490,,98775
219258,4000,Female,GM0034,Almere,2014JJ00,2014,98775,,1198,,431,,767,3969,,1079,2890,4246,,899,-52,3347,-277,491,,99266
219259,4000,Female,GM0034,Almere,2015JJ00,2015,99266,,1111,,472,,639,4392,,1063,3329,4386,,859,-141,3527,6,639,,99905
219260,4000,Female,GM0034,Almere,2016JJ00,2016,99905,,1132,,467,,665,4954,,1131,3823,4284,,761,-30,3523,670,1336,,101241
219261,4000,Female,GM0034,Almere,2017JJ00,2017,101241,,1176,,478,,698,5242,,1041,4201,4360,,727,-23,3633,882,1568,,102809
219262,4000,Female,GM0034,Almere,2018JJ00,2018,102809,,1143,,516,,627,5673,,1215,4458,4285,,716,24,3569,1388,2013,,104822
219263,4000,Female,GM0034,Almere,2019JJ00,2019,104822,,1214,,487,,727,5839,,1324,4515,4610,,700,-14,3910,1229,1941,,106763
219264,4000,Female,GM0034,Almere,2020JJ00,2020,106763,,1243,,513,,730,5742,,1063,4679,5044,,667,-10,4377,698,1429,,108192
219265,4000,Female,GM0034,Almere,2021JJ00,2021,108192,,1281,,593,,688,5986,,1156,4830,5130,,743,-69,4387,856,1545,,109737
219266,4000,Female,GM0034,Almere,2022JJ00,2022,109737,,1309,,603,,706,7158,,2182,4976,5356,,980,-86,4376,1802,2499,,112236
219267,4000,Female,GM0034,Almere,2023JJ00,2023,112236,,1262,,596,,666,6580,,1841,4739,5285,,1092,-135,4193,1295,1961,,114197
219420,4000,Female,GM0484,Alphen aan den Rijn,2012JJ00,2012,36895,,397,,281,,116,1080,,175,905,1198,,174,-37,1024,-118,1,,36896
219421,4000,Female,GM0484,Alphen aan den Rijn,2013JJ00,2013,36896,,379,,258,,121,1129,,166,963,1169,,163,-16,1006,-40,102,,36998
219422,4000,Female,GM0484,Alphen aan den Rijn,2014JJ00,2014,53806,,555,,398,,157,1770,,279,1491,1642,,209,-27,1433,128,269,,54075
219423,4000,Female,GM0484,Alphen aan den Rijn,2015JJ00,2015,54075,,548,,434,,114,1918,,279,1639,1775,,194,-13,1581,143,261,,54336
219424,4000,Female,GM0484,Alphen aan den Rijn,2016JJ00,2016,54336,,532,,420,,112,2270,,309,1961,1966,,239,-33,1727,304,415,,54751
219425,4000,Female,GM0484,Alphen aan den Rijn,2017JJ00,2017,54751,,516,,423,,93,2307,,292,2015,2030,,214,-6,1816,277,368,,55119
219426,4000,Female,GM0484,Alphen aan den Rijn,2018JJ00,2018,55119,,518,,421,,97,2492,,417,2075,2008,,262,-43,1746,484,584,,55703
219427,4000,Female,GM0484,Alphen aan den Rijn,2019JJ00,2019,55703,,552,,430,,122,2360,,422,1938,2031,,269,-33,1762,329,453,,56156
219428,4000,Female,GM0484,Alphen aan den Rijn,2020JJ00,2020,56156,,530,,465,,65,2395,,332,2063,2131,,213,-22,1918,264,332,,56488
219429,4000,Female,GM0484,Alphen aan den Rijn,2021JJ00,2021,56488,,608,,472,,136,2249,,319,1930,2241,,228,-43,2013,8,142,,56630
219430,4000,Female,GM0484,Alphen aan den Rijn,2022JJ00,2022,56630,,548,,495,,53,2883,,832,2051,2224,,373,-108,1851,659,712,,57342
219431,4000,Female,GM0484,Alphen aan den Rijn,2023JJ00,2023,57342,,550,,480,,70,2610,,498,2112,2294,,392,-98,1902,316,387,,57729
219584,4000,Female,GM1723,Alphen-Chaam,2012JJ00,2012,4700,,34,,34,,0,253,,38,215,193,,21,-3,172,60,59,,4759
219585,4000,Female,GM1723,Alphen-Chaam,2013JJ00,2013,4759,,24,,40,,-16,241,,26,215,189,,11,4,178,52,38,,4797
219586,4000,Female,GM1723,Alphen-Chaam,2014JJ00,2014,4797,,36,,27,,9,223,,32,191,225,,22,-2,203,-2,5,,4802
219587,4000,Female,GM1723,Alphen-Chaam,2015JJ00,2015,4802,,42,,31,,11,263,,23,240,210,,21,-5,189,53,64,,4866
219588,4000,Female,GM1723,Alphen-Chaam,2016JJ00,2016,4866,,48,,32,,16,289,,33,256,232,,22,-2,210,57,71,,4937
219589,4000,Female,GM1723,Alphen-Chaam,2017JJ00,2017,4937,,38,,43,,-5,280,,30,250,268,,30,-3,238,12,7,,4944
219590,4000,Female,GM1723,Alphen-Chaam,2018JJ00,2018,4944,,42,,42,,0,282,,38,244,270,,17,-5,253,12,11,,4955
219591,4000,Female,GM1723,Alphen-Chaam,2019JJ00,2019,4955,,53,,45,,8,270,,31,239,234,,32,-1,202,36,44,,4999
219592,4000,Female,GM1723,Alphen-Chaam,2020JJ00,2020,4999,,38,,46,,-8,372,,50,322,257,,29,2,228,115,106,,5105
219593,4000,Female,GM1723,Alphen-Chaam,2021JJ00,2021,5105,,46,,47,,-1,276,,19,257,270,,45,-5,225,6,5,,5110
219594,4000,Female,GM1723,Alphen-Chaam,2022JJ00,2022,5110,,39,,55,,-16,291,,67,224,259,,50,2,209,32,16,,5126
219595,4000,Female,GM1723,Alphen-Chaam,2023JJ00,2023,5126,,47,,42,,5,296,,68,228,300,,65,-1,235,-4,3,,5129
219673,4000,Female,GM1959,Altena,2019JJ00,2019,27510,,266,,237,,29,985,,132,853,718,,75,-11,643,267,294,,27804
219674,4000,Female,GM1959,Altena,2020JJ00,2020,27804,,286,,278,,8,1017,,139,878,843,,52,-3,791,174,185,,27989
219675,4000,Female,GM1959,Altena,2021JJ00,2021,27989,,309,,250,,59,1074,,128,946,796,,81,-14,715,278,337,,28326
219676,4000,Female,GM1959,Altena,2022JJ00,2022,28326,,280,,262,,18,1193,,330,863,856,,135,-16,721,337,356,,28682
219677,4000,Female,GM1959,Altena,2023JJ00,2023,28682,,300,,289,,11,1213,,358,855,996,,173,-37,823,217,228,,28910
220158,4000,Female,GM0060,Ameland,2012JJ00,2012,1773,,15,,17,,-2,77,,10,67,73,,7,0,66,4,2,,1775
220159,4000,Female,GM0060,Ameland,2013JJ00,2013,1775,,23,,9,,14,108,,9,99,75,,4,-1,71,33,47,,1822
220160,4000,Female,GM0060,Ameland,2014JJ00,2014,1822,,22,,13,,9,84,,14,70,88,,1,0,87,-4,4,,1826
220161,4000,Female,GM0060,Ameland,2015JJ00,2015,1826,,13,,10,,3,95,,15,80,105,,24,-1,81,-10,-7,,1819
220162,4000,Female,GM0060,Ameland,2016JJ00,2016,1819,,8,,14,,-6,108,,13,95,87,,12,-2,75,21,15,,1834
220163,4000,Female,GM0060,Ameland,2017JJ00,2017,1834,,17,,16,,1,119,,14,105,112,,7,1,105,7,8,,1842
220164,4000,Female,GM0060,Ameland,2018JJ00,2018,1842,,16,,27,,-11,125,,17,108,102,,8,0,94,23,12,,1854
220165,4000,Female,GM0060,Ameland,2019JJ00,2019,1854,,22,,12,,10,118,,26,92,109,,22,-4,87,9,19,,1873
220166,4000,Female,GM0060,Ameland,2020JJ00,2020,1873,,10,,15,,-5,125,,26,99,131,,24,-3,107,-6,-12,,1861
220167,4000,Female,GM0060,Ameland,2021JJ00,2021,1861,,18,,21,,-3,136,,33,103,130,,32,-14,98,6,2,,1863
220168,4000,Female,GM0060,Ameland,2022JJ00,2022,1863,,19,,17,,2,158,,55,103,121,,25,-3,96,37,39,,1902
220169,4000,Female,GM0060,Ameland,2023JJ00,2023,1902,,18,,21,,-3,144,,42,102,137,,28,-3,109,7,4,,1906
220322,4000,Female,GM0307,Amersfoort,2012JJ00,2012,75401,,998,,502,,496,3187,,379,2808,2944,,411,-67,2533,243,735,,76136
220323,4000,Female,GM0307,Amersfoort,2013JJ00,2013,76136,,919,,592,,327,3238,,422,2816,2981,,385,-64,2596,257,586,,76722
220324,4000,Female,GM0307,Amersfoort,2014JJ00,2014,76722,,937,,545,,392,3531,,423,3108,3131,,405,-32,2726,400,792,,77514
220325,4000,Female,GM0307,Amersfoort,2015JJ00,2015,77514,,858,,573,,285,3621,,457,3164,3382,,433,-47,2949,239,519,,78033
220326,4000,Female,GM0307,Amersfoort,2016JJ00,2016,78033,,856,,594,,262,3917,,435,3482,3821,,403,-47,3418,96,361,,78394
220327,4000,Female,GM0307,Amersfoort,2017JJ00,2017,78394,,882,,596,,286,3916,,433,3483,3850,,394,-30,3456,66,346,,78740
220328,4000,Female,GM0307,Amersfoort,2018JJ00,2018,78740,,878,,620,,258,3965,,500,3465,3716,,336,-31,3380,249,509,,79249
220329,4000,Female,GM0307,Amersfoort,2019JJ00,2019,79249,,854,,602,,252,3815,,506,3309,3691,,382,-65,3309,124,373,,79622
220330,4000,Female,GM0307,Amersfoort,2020JJ00,2020,79622,,803,,593,,210,3761,,448,3313,3935,,299,-8,3636,-174,33,,79655
220331,4000,Female,GM0307,Amersfoort,2021JJ00,2021,79655,,881,,626,,255,4130,,445,3685,3945,,276,-37,3669,185,438,,80093
220332,4000,Female,GM0307,Amersfoort,2022JJ00,2022,80093,,791,,657,,134,4767,,965,3802,3807,,403,-48,3404,960,1092,,81185
220333,4000,Female,GM0307,Amersfoort,2023JJ00,2023,81185,,860,,635,,225,4388,,550,3838,4121,,437,-49,3684,267,495,,81680
220568,4000,Female,GM0362,Amstelveen,2012JJ00,2012,43652,,437,,457,,-20,4086,,1483,2603,3565,,1363,-248,2202,521,500,,44152
220569,4000,Female,GM0362,Amstelveen,2013JJ00,2013,44152,,413,,462,,-49,4024,,1600,2424,3572,,1432,-196,2140,452,405,,44557
220570,4000,Female,GM0362,Amstelveen,2014JJ00,2014,44557,,432,,458,,-26,4880,,1740,3140,3843,,1376,-220,2467,1037,1028,,45585
220571,4000,Female,GM0362,Amstelveen,2015JJ00,2015,45585,,410,,501,,-91,4943,,1931,3012,4181,,1547,-298,2634,762,680,,46265
220572,4000,Female,GM0362,Amstelveen,2016JJ00,2016,46265,,427,,452,,-25,4911,,1990,2921,4595,,1655,-235,2940,316,290,,46555
220573,4000,Female,GM0362,Amstelveen,2017JJ00,2017,46555,,399,,488,,-89,5231,,2304,2927,4892,,1695,-143,3197,339,248,,46803
220574,4000,Female,GM0362,Amstelveen,2018JJ00,2018,46803,,412,,436,,-24,5410,,2372,3038,5003,,1831,-166,3172,407,385,,47188
220575,4000,Female,GM0362,Amstelveen,2019JJ00,2019,47188,,365,,423,,-58,5605,,2639,2966,5179,,1699,-114,3480,426,362,,47550
220576,4000,Female,GM0362,Amstelveen,2020JJ00,2020,47550,,387,,504,,-117,4850,,1781,3069,5227,,1608,-75,3619,-377,-500,,47050
220577,4000,Female,GM0362,Amstelveen,2021JJ00,2021,47050,,395,,490,,-95,5808,,2465,3343,5028,,1204,-77,3824,780,682,,47732
220578,4000,Female,GM0362,Amstelveen,2022JJ00,2022,47732,,349,,540,,-191,7034,,3721,3313,5737,,1580,-102,4157,1297,1107,,48839
220579,4000,Female,GM0362,Amstelveen,2023JJ00,2023,48839,,326,,535,,-209,6168,,2792,3376,5520,,1617,-107,3903,648,431,,49270
220732,4000,Female,GM0363,Amsterdam,2012JJ00,2012,401105,,5397,,2906,,2491,27303,,9747,17556,24876,,9395,-2600,15481,2427,4912,,406017
220733,4000,Female,GM0363,Amsterdam,2013JJ00,2013,406017,,5254,,2784,,2470,28246,,9947,18299,25396,,9418,-2112,15978,2850,5403,,411420
220734,4000,Female,GM0363,Amsterdam,2014JJ00,2014,411513,,5507,,2695,,2812,30400,,11685,18715,27873,,9310,-1746,18563,2527,5358,,416871
220735,4000,Female,GM0363,Amsterdam,2015JJ00,2015,416871,,5311,,2790,,2521,32265,,12870,19395,29661,,9447,-688,20214,2604,5145,,422016
220736,4000,Female,GM0363,Amsterdam,2016JJ00,2016,422016,,5351,,2773,,2578,33570,,14562,19008,31358,,9806,-583,21552,2212,4804,,426820
220737,4000,Female,GM0363,Amsterdam,2017JJ00,2017,426820,,5220,,2643,,2577,35297,,16832,18465,33731,,10818,-1639,22913,1566,4113,,430933
220738,4000,Female,GM0363,Amsterdam,2018JJ00,2018,430933,,5228,,2664,,2564,36923,,19357,17566,35219,,11599,-1250,23620,1704,4245,,435178
220739,4000,Female,GM0363,Amsterdam,2019JJ00,2019,435178,,5174,,2578,,2596,38847,,20780,18067,36691,,11952,-904,24739,2156,4700,,439878
220740,4000,Female,GM0363,Amsterdam,2020JJ00,2020,439878,,5028,,2723,,2305,35246,,15252,19994,37614,,11057,-214,26557,-2368,-90,,439788
220741,4000,Female,GM0363,Amsterdam,2021JJ00,2021,439788,,5228,,2728,,2500,39287,,18868,20419,36494,,9629,-123,26865,2793,5263,,445051
220742,4000,Female,GM0363,Amsterdam,2022JJ00,2022,445051,,4798,,2919,,1879,45457,,25653,19804,39129,,11364,-383,27765,6328,8136,,463844
220743,4000,Female,GM0363,Amsterdam,2023JJ00,2023,463844,,4736,,2861,,1875,44651,,23396,21255,39741,,13069,-619,26672,4910,6688,,470532
221306,4000,Female,GM0200,Apeldoorn,2012JJ00,2012,79436,,726,,754,,-28,2658,,361,2297,2372,,270,-13,2102,286,263,,79699
221307,4000,Female,GM0200,Apeldoorn,2013JJ00,2013,79699,,704,,797,,-93,2573,,357,2216,2432,,267,-4,2165,141,50,,79749
221308,4000,Female,GM0200,Apeldoorn,2014JJ00,2014,79749,,707,,776,,-69,2751,,364,2387,2514,,350,-43,2164,237,187,,79936
221309,4000,Female,GM0200,Apeldoorn,2015JJ00,2015,79936,,768,,854,,-86,2872,,445,2427,2510,,293,-25,2217,362,280,,80216
221310,4000,Female,GM0200,Apeldoorn,2016JJ00,2016,80216,,726,,830,,-104,3105,,382,2723,2661,,339,-59,2322,444,340,,80556
221311,4000,Female,GM0200,Apeldoorn,2017JJ00,2017,80556,,735,,801,,-66,3297,,470,2827,2794,,281,-53,2513,503,438,,80994
221312,4000,Female,GM0200,Apeldoorn,2018JJ00,2018,80994,,755,,818,,-63,3273,,528,2745,2636,,278,-20,2358,637,571,,81565
221313,4000,Female,GM0200,Apeldoorn,2019JJ00,2019,81565,,742,,858,,-116,3316,,523,2793,2570,,315,-43,2255,746,621,,82186
221314,4000,Female,GM0200,Apeldoorn,2020JJ00,2020,82186,,722,,937,,-215,3540,,457,3083,2885,,255,-35,2630,655,438,,82624
221315,4000,Female,GM0200,Apeldoorn,2021JJ00,2021,82624,,795,,846,,-51,3248,,414,2834,2854,,282,-32,2572,394,345,,82969
221316,4000,Female,GM0200,Apeldoorn,2022JJ00,2022,82969,,717,,926,,-209,3981,,1181,2800,3053,,398,-55,2655,928,717,,83686
221317,4000,Female,GM0200,Apeldoorn,2023JJ00,2023,83686,,730,,913,,-183,3771,,944,2827,3162,,465,-110,2697,609,424,,84110
221470,4000,Female,GM0003,Appingedam,2012JJ00,2012,6231,,52,,76,,-24,280,,8,272,270,,6,1,264,10,-13,,6218
221471,4000,Female,GM0003,Appingedam,2013JJ00,2013,6218,,47,,77,,-30,285,,8,277,254,,9,-2,245,31,0,,6218
221472,4000,Female,GM0003,Appingedam,2014JJ00,2014,6218,,52,,80,,-28,308,,15,293,295,,28,-2,267,13,-14,,6204
221473,4000,Female,GM0003,Appingedam,2015JJ00,2015,6204,,51,,83,,-32,312,,16,296,284,,9,-1,275,28,-5,,6199
221474,4000,Female,GM0003,Appingedam,2016JJ00,2016,6199,,55,,95,,-40,365,,20,345,354,,19,-4,335,11,-30,,6169
221475,4000,Female,GM0003,Appingedam,2017JJ00,2017,6169,,43,,90,,-47,295,,16,279,368,,8,1,360,-73,-119,,6050
221476,4000,Female,GM0003,Appingedam,2018JJ00,2018,6050,,44,,78,,-34,312,,22,290,325,,13,-2,312,-13,-49,,6001
221477,4000,Female,GM0003,Appingedam,2019JJ00,2019,6001,,39,,80,,-41,307,,12,295,296,,14,1,282,11,-30,,5971
221478,4000,Female,GM0003,Appingedam,2020JJ00,2020,5971,,33,,81,,-48,314,,11,303,355,,7,0,348,-41,-86,,5885
221798,4000,Female,GM0202,Arnhem,2012JJ00,2012,75204,,930,,676,,254,4566,,700,3866,4556,,723,-173,3833,10,264,,75468
221799,4000,Female,GM0202,Arnhem,2013JJ00,2013,75468,,873,,645,,228,4662,,710,3952,4564,,710,-155,3854,98,326,,75794
221800,4000,Female,GM0202,Arnhem,2014JJ00,2014,75794,,878,,650,,228,4838,,609,4229,4441,,633,-124,3808,397,627,,76421
221801,4000,Female,GM0202,Arnhem,2015JJ00,2015,76421,,886,,625,,261,5137,,770,4367,4608,,674,-139,3934,529,781,,77202
221802,4000,Female,GM0202,Arnhem,2016JJ00,2016,77202,,853,,646,,207,6006,,1190,4816,5423,,664,-155,4759,583,790,,77992
221803,4000,Female,GM0202,Arnhem,2017JJ00,2017,77992,,801,,651,,150,6196,,1220,4976,5621,,626,-161,4995,575,722,,78714
221804,4000,Female,GM0202,Arnhem,2018JJ00,2018,78714,,819,,728,,91,6264,,1335,4929,5380,,616,-114,4764,884,978,,79692
221805,4000,Female,GM0202,Arnhem,2019JJ00,2019,79692,,722,,711,,11,6609,,1879,4730,5772,,618,-45,5154,837,851,,80543
221806,4000,Female,GM0202,Arnhem,2020JJ00,2020,80543,,804,,705,,99,6074,,1333,4741,5664,,595,-70,5069,410,505,,81048
221807,4000,Female,GM0202,Arnhem,2021JJ00,2021,81048,,854,,738,,116,6717,,1877,4840,6035,,602,-119,5433,682,808,,81856
221808,4000,Female,GM0202,Arnhem,2022JJ00,2022,81856,,759,,763,,-4,7289,,2557,4732,6296,,729,-118,5567,993,987,,82843
221809,4000,Female,GM0202,Arnhem,2023JJ00,2023,82843,,841,,757,,84,7297,,2533,4764,6465,,809,-172,5656,832,948,,83791
221962,4000,Female,GM0106,Assen,2012JJ00,2012,34277,,352,,352,,0,1248,,109,1139,1330,,122,9,1208,-82,-82,,34195
221963,4000,Female,GM0106,Assen,2013JJ00,2013,34195,,317,,291,,26,1280,,160,1120,1299,,111,9,1188,-19,6,,34201
221964,4000,Female,GM0106,Assen,2014JJ00,2014,34201,,343,,308,,35,1274,,141,1133,1360,,140,-25,1220,-86,-51,,34150
221965,4000,Female,GM0106,Assen,2015JJ00,2015,34150,,292,,334,,-42,1339,,161,1178,1411,,107,-15,1304,-72,-116,,34034
221966,4000,Female,GM0106,Assen,2016JJ00,2016,34034,,296,,322,,-26,1718,,210,1508,1537,,116,-9,1421,181,149,,34183
221967,4000,Female,GM0106,Assen,2017JJ00,2017,34183,,287,,359,,-72,1788,,119,1669,1653,,73,-4,1580,135,60,,34243
221968,4000,Female,GM0106,Assen,2018JJ00,2018,34243,,255,,372,,-117,1826,,162,1664,1628,,114,-8,1514,198,77,,34320
221969,4000,Female,GM0106,Assen,2019JJ00,2019,34320,,257,,335,,-78,1921,,316,1605,1545,,102,0,1443,376,298,,34618
221970,4000,Female,GM0106,Assen,2020JJ00,2020,34618,,336,,361,,-25,1766,,130,1636,1602,,88,-20,1514,164,140,,34758
221971,4000,Female,GM0106,Assen,2021JJ00,2021,34758,,342,,320,,22,1828,,151,1677,1753,,126,-37,1627,75,95,,34853
221972,4000,Female,GM0106,Assen,2022JJ00,2022,34853,,293,,355,,-62,2025,,480,1545,1734,,149,-18,1585,291,227,,35080
221973,4000,Female,GM0106,Assen,2023JJ00,2023,35080,,282,,369,,-87,1952,,345,1607,1817,,207,-91,1610,135,45,,35125
222126,4000,Female,GM0743,Asten,2012JJ00,2012,7995,,51,,71,,-20,269,,53,216,287,,24,-1,263,-18,-37,,7958
222127,4000,Female,GM0743,Asten,2013JJ00,2013,7958,,47,,56,,-9,336,,75,261,301,,49,-10,252,35,26,,7984
222128,4000,Female,GM0743,Asten,2014JJ00,2014,7984,,73,,67,,6,374,,110,264,311,,40,-3,271,63,69,,8053
222129,4000,Female,GM0743,Asten,2015JJ00,2015,8053,,60,,70,,-10,365,,104,261,352,,65,-15,287,13,3,,8056
222130,4000,Female,GM0743,Asten,2016JJ00,2016,8056,,64,,70,,-6,425,,80,345,364,,78,-16,286,61,54,,8110
222131,4000,Female,GM0743,Asten,2017JJ00,2017,8110,,66,,65,,1,390,,74,316,403,,62,-11,341,-13,-13,,8097
222132,4000,Female,GM0743,Asten,2018JJ00,2018,8097,,69,,98,,-29,388,,63,325,337,,57,-12,280,51,21,,8118
222133,4000,Female,GM0743,Asten,2019JJ00,2019,8118,,77,,73,,4,393,,120,273,383,,82,-25,301,10,13,,8131
222134,4000,Female,GM0743,Asten,2020JJ00,2020,8131,,73,,78,,-5,416,,75,341,326,,68,-14,258,90,84,,8215
222135,4000,Female,GM0743,Asten,2021JJ00,2021,8215,,89,,84,,5,488,,90,398,337,,59,-21,278,151,158,,8373
222136,4000,Female,GM0743,Asten,2022JJ00,2022,8373,,71,,88,,-17,492,,149,343,382,,82,-16,300,110,93,,8466
222137,4000,Female,GM0743,Asten,2023JJ00,2023,8466,,81,,78,,3,416,,106,310,377,,102,-31,275,39,41,,8507
222618,4000,Female,GM0744,Baarle-Nassau,2012JJ00,2012,3298,,20,,25,,-5,117,,30,87,118,,27,0,91,-1,-6,,3292
222619,4000,Female,GM0744,Baarle-Nassau,2013JJ00,2013,3292,,21,,36,,-15,130,,44,86,151,,40,-4,111,-21,-38,,3254
222620,4000,Female,GM0744,Baarle-Nassau,2014JJ00,2014,3254,,24,,38,,-14,141,,32,109,137,,30,1,107,4,-8,,3246
222621,4000,Female,GM0744,Baarle-Nassau,2015JJ00,2015,3246,,32,,31,,1,146,,38,108,125,,23,2,102,21,20,,3266
222622,4000,Female,GM0744,Baarle-Nassau,2016JJ00,2016,3266,,27,,28,,-1,168,,33,135,157,,27,-2,130,11,10,,3276
222623,4000,Female,GM0744,Baarle-Nassau,2017JJ00,2017,3276,,30,,29,,1,224,,46,178,150,,23,3,127,74,76,,3352
222624,4000,Female,GM0744,Baarle-Nassau,2018JJ00,2018,3352,,22,,27,,-5,192,,43,149,168,,27,-3,141,24,18,,3370
222625,4000,Female,GM0744,Baarle-Nassau,2019JJ00,2019,3370,,36,,30,,6,194,,41,153,169,,26,0,143,25,32,,3402
222626,4000,Female,GM0744,Baarle-Nassau,2020JJ00,2020,3402,,25,,35,,-10,213,,32,181,167,,40,-3,127,46,36,,3438
222627,4000,Female,GM0744,Baarle-Nassau,2021JJ00,2021,3438,,24,,44,,-20,174,,24,150,155,,30,3,125,19,-1,,3437
222628,4000,Female,GM0744,Baarle-Nassau,2022JJ00,2022,3437,,26,,31,,-5,210,,40,170,128,,15,-3,113,82,77,,3514
222629,4000,Female,GM0744,Baarle-Nassau,2023JJ00,2023,3514,,36,,42,,-6,196,,40,156,157,,49,-1,108,39,33,,3547
222700,4000,Female,GM0308,Baarn,2012JJ00,2012,12643,,104,,177,,-73,559,,59,500,526,,48,1,478,33,-41,,12602
222701,4000,Female,GM0308,Baarn,2013JJ00,2013,12602,,86,,136,,-50,586,,58,528,539,,58,-2,481,47,-3,,12599
222702,4000,Female,GM0308,Baarn,2014JJ00,2014,12599,,114,,165,,-51,733,,86,647,633,,63,-3,570,100,46,,12645
222703,4000,Female,GM0308,Baarn,2015JJ00,2015,12645,,88,,143,,-55,719,,79,640,614,,64,3,550,105,50,,12695
222704,4000,Female,GM0308,Baarn,2016JJ00,2016,12695,,119,,177,,-58,694,,91,603,640,,68,-5,572,54,-4,,12691
222705,4000,Female,GM0308,Baarn,2017JJ00,2017,12691,,85,,179,,-94,776,,114,662,659,,67,-2,592,117,23,,12714
222706,4000,Female,GM0308,Baarn,2018JJ00,2018,12714,,132,,162,,-30,653,,85,568,557,,58,0,499,96,68,,12782
222707,4000,Female,GM0308,Baarn,2019JJ00,2019,12782,,111,,175,,-64,712,,92,620,591,,61,-6,530,121,57,,12839
222708,4000,Female,GM0308,Baarn,2020JJ00,2020,12839,,91,,172,,-81,688,,77,611,693,,44,-1,649,-5,-85,,12754
222709,4000,Female,GM0308,Baarn,2021JJ00,2021,12754,,120,,212,,-92,790,,74,716,632,,51,-1,581,158,66,,12820
222710,4000,Female,GM0308,Baarn,2022JJ00,2022,12820,,99,,209,,-110,778,,155,623,615,,72,3,543,163,53,,12873
222711,4000,Female,GM0308,Baarn,2023JJ00,2023,12873,,101,,170,,-69,713,,90,623,654,,73,0,581,59,-9,,12864
223110,4000,Female,GM0489,Barendrecht,2012JJ00,2012,23824,,256,,134,,122,1045,,71,974,947,,86,-13,861,98,222,,24046
223111,4000,Female,GM0489,Barendrecht,2013JJ00,2013,24046,,236,,153,,83,922,,65,857,1004,,108,-11,896,-82,-1,,24045
223112,4000,Female,GM0489,Barendrecht,2014JJ00,2014,24045,,234,,130,,104,973,,95,878,1024,,100,-11,924,-51,56,,24101
223113,4000,Female,GM0489,Barendrecht,2015JJ00,2015,24101,,244,,154,,90,1173,,112,1061,1070,,83,-5,987,103,190,,24291
223114,4000,Female,GM0489,Barendrecht,2016JJ00,2016,24291,,229,,144,,85,1303,,87,1216,1198,,99,-14,1099,105,193,,24484
223115,4000,Female,GM0489,Barendrecht,2017JJ00,2017,24484,,204,,173,,31,1282,,113,1169,1191,,88,-17,1103,91,120,,24604
223116,4000,Female,GM0489,Barendrecht,2018JJ00,2018,24604,,220,,152,,68,1240,,111,1129,1238,,87,-7,1151,2,70,,24674
223117,4000,Female,GM0489,Barendrecht,2019JJ00,2019,24674,,188,,156,,32,1226,,111,1115,1207,,91,-20,1116,19,48,,24722
223118,4000,Female,GM0489,Barendrecht,2020JJ00,2020,24722,,190,,187,,3,1270,,111,1159,1282,,57,-2,1225,-12,-8,,24714
223119,4000,Female,GM0489,Barendrecht,2021JJ00,2021,24714,,229,,180,,49,1178,,81,1097,1207,,71,-9,1136,-29,17,,24731
223120,4000,Female,GM0489,Barendrecht,2022JJ00,2022,24731,,189,,170,,19,1266,,170,1096,1189,,89,4,1100,77,91,,24822
223121,4000,Female,GM0489,Barendrecht,2023JJ00,2023,24822,,191,,169,,22,1089,,118,971,1141,,88,-4,1053,-52,-39,,24783
223192,4000,Female,GM0203,Barneveld,2012JJ00,2012,26904,,374,,206,,168,893,,85,808,934,,70,-10,864,-41,129,,27033
223193,4000,Female,GM0203,Barneveld,2013JJ00,2013,27033,,378,,228,,150,844,,63,781,830,,51,1,779,14,164,,27197
223194,4000,Female,GM0203,Barneveld,2014JJ00,2014,27198,,403,,196,,207,1079,,80,999,958,,77,-8,881,121,335,,27533
223195,4000,Female,GM0203,Barneveld,2015JJ00,2015,27533,,402,,204,,198,1135,,84,1051,949,,61,3,888,186,385,,27918
223196,4000,Female,GM0203,Barneveld,2016JJ00,2016,27918,,396,,234,,162,1223,,73,1150,980,,61,9,919,243,402,,28320
223197,4000,Female,GM0203,Barneveld,2017JJ00,2017,28320,,412,,228,,184,1371,,117,1254,1055,,92,-11,963,316,500,,28820
223198,4000,Female,GM0203,Barneveld,2018JJ00,2018,28820,,369,,206,,163,1144,,91,1053,1076,,65,8,1011,68,234,,29054
223199,4000,Female,GM0203,Barneveld,2019JJ00,2019,29054,,397,,246,,151,1427,,96,1331,1044,,96,-6,948,383,532,,29586
223200,4000,Female,GM0203,Barneveld,2020JJ00,2020,29586,,426,,249,,177,1309,,109,1200,1012,,48,-7,964,297,474,,30060
223201,4000,Female,GM0203,Barneveld,2021JJ00,2021,30060,,430,,272,,158,1215,,97,1118,1117,,70,-13,1047,98,255,,30315
223202,4000,Female,GM0203,Barneveld,2022JJ00,2022,30315,,399,,269,,130,1522,,419,1103,1101,,133,-35,968,421,551,,30866
223203,4000,Female,GM0203,Barneveld,2023JJ00,2023,30866,,407,,239,,168,1418,,178,1240,1109,,124,-3,985,309,479,,31345
223684,4000,Female,GM0005,Bedum,2012JJ00,2012,5227,,53,,38,,15,205,,11,194,173,,0,2,173,32,46,,5273
223685,4000,Female,GM0005,Bedum,2013JJ00,2013,5273,,42,,43,,-1,208,,11,197,234,,12,0,222,-26,-27,,5246
223686,4000,Female,GM0005,Bedum,2014JJ00,2014,5246,,58,,41,,17,209,,14,195,256,,8,1,248,-47,-28,,5218
223687,4000,Female,GM0005,Bedum,2015JJ00,2015,5218,,45,,40,,5,235,,9,226,255,,13,1,242,-20,-15,,5203
223688,4000,Female,GM0005,Bedum,2016JJ00,2016,5203,,43,,45,,-2,270,,13,257,232,,6,3,226,38,35,,5238
223689,4000,Female,GM0005,Bedum,2017JJ00,2017,5238,,53,,57,,-4,246,,13,233,239,,11,1,228,7,2,,5240
223690,4000,Female,GM0005,Bedum,2018JJ00,2018,5240,,62,,56,,6,226,,9,217,199,,10,-2,189,27,36,,5276
223848,4000,Female,GM0888,Beek (L.),2012JJ00,2012,8458,,50,,66,,-16,347,,37,310,375,,22,-3,353,-28,-44,,8414
223849,4000,Female,GM0888,Beek (L.),2013JJ00,2013,8414,,54,,75,,-21,352,,34,318,366,,29,-6,337,-14,-35,,8379
223850,4000,Female,GM0888,Beek (L.),2014JJ00,2014,8379,,59,,80,,-21,363,,44,319,385,,33,2,352,-22,-44,,8335
223851,4000,Female,GM0888,Beek (L.),2015JJ00,2015,8335,,51,,72,,-21,348,,27,321,420,,37,-2,383,-72,-93,,8242
223852,4000,Female,GM0888,Beek (L.),2016JJ00,2016,8242,,56,,73,,-17,403,,48,355,479,,36,0,443,-76,-93,,8149
223853,4000,Female,GM0888,Beek (L.),2017JJ00,2017,8149,,53,,74,,-21,443,,36,407,428,,27,-1,401,15,-6,,8143
223854,4000,Female,GM0888,Beek (L.),2018JJ00,2018,8143,,56,,77,,-21,491,,46,445,458,,36,-2,422,33,12,,8155
223855,4000,Female,GM0888,Beek (L.),2019JJ00,2019,8155,,77,,83,,-6,396,,45,351,430,,36,1,394,-34,-39,,8116
223856,4000,Female,GM0888,Beek (L.),2020JJ00,2020,8116,,74,,97,,-23,468,,24,444,426,,38,-2,388,42,21,,8137
223857,4000,Female,GM0888,Beek (L.),2021JJ00,2021,8137,,71,,83,,-12,434,,38,396,442,,36,-2,406,-8,-19,,8118
223858,4000,Female,GM0888,Beek (L.),2022JJ00,2022,8118,,53,,91,,-38,633,,197,436,430,,59,-5,371,203,164,,8282
223859,4000,Female,GM0888,Beek (L.),2023JJ00,2023,8282,,69,,97,,-28,584,,164,420,499,,125,-15,374,85,58,,8340
224101,4000,Female,GM1954,Beekdaelen,2019JJ00,2019,17942,,135,,180,,-45,1103,,98,1005,892,,50,-1,842,211,164,,18106
224102,4000,Female,GM1954,Beekdaelen,2020JJ00,2020,18106,,125,,244,,-119,1082,,73,1009,944,,51,4,893,138,18,,18124
224103,4000,Female,GM1954,Beekdaelen,2021JJ00,2021,18124,,136,,264,,-128,1062,,68,994,1023,,83,-14,940,39,-89,,18035
224104,4000,Female,GM1954,Beekdaelen,2022JJ00,2022,18035,,115,,232,,-117,1061,,158,903,948,,116,-15,832,113,-5,,18030
224105,4000,Female,GM1954,Beekdaelen,2023JJ00,2023,18030,,159,,237,,-78,967,,113,854,937,,73,-11,864,30,-49,,17981
224176,4000,Female,GM0370,Beemster,2012JJ00,2012,4359,,30,,24,,6,208,,12,196,181,,14,-4,167,27,32,,4391
224177,4000,Female,GM0370,Beemster,2013JJ00,2013,4391,,39,,34,,5,242,,12,230,182,,8,-1,174,60,65,,4456
224178,4000,Female,GM0370,Beemster,2014JJ00,2014,4456,,36,,25,,11,202,,4,198,215,,15,2,200,-13,-2,,4454
224179,4000,Female,GM0370,Beemster,2015JJ00,2015,4454,,41,,32,,9,233,,12,221,207,,18,0,189,26,35,,4489
224180,4000,Female,GM0370,Beemster,2016JJ00,2016,4489,,52,,37,,15,367,,18,349,246,,15,0,231,121,136,,4625
224181,4000,Female,GM0370,Beemster,2017JJ00,2017,4625,,42,,29,,13,356,,13,343,199,,5,1,194,157,169,,4794
224182,4000,Female,GM0370,Beemster,2018JJ00,2018,4794,,41,,28,,13,345,,10,335,253,,10,0,243,92,105,,4899
224183,4000,Female,GM0370,Beemster,2019JJ00,2019,4899,,53,,32,,21,370,,19,351,271,,7,0,264,99,120,,5019
224184,4000,Female,GM0370,Beemster,2020JJ00,2020,5019,,46,,33,,13,294,,8,286,273,,13,0,260,21,34,,5053
224185,4000,Female,GM0370,Beemster,2021JJ00,2021,5053,,63,,31,,32,557,,17,540,268,,13,-2,255,289,313,,5366
224504,4000,Female,GM0889,Beesel,2012JJ00,2012,6822,,49,,54,,-5,212,,26,186,223,,18,0,205,-11,-16,,6806
224505,4000,Female,GM0889,Beesel,2013JJ00,2013,6806,,54,,66,,-12,180,,15,165,220,,5,1,215,-40,-52,,6754
224506,4000,Female,GM0889,Beesel,2014JJ00,2014,6754,,49,,46,,3,202,,20,182,256,,17,0,239,-54,-52,,6702
224507,4000,Female,GM0889,Beesel,2015JJ00,2015,6702,,46,,71,,-25,210,,26,184,236,,23,1,213,-26,-52,,6650
224508,4000,Female,GM0889,Beesel,2016JJ00,2016,6650,,50,,59,,-9,265,,25,240,268,,22,-1,246,-3,-13,,6637
224509,4000,Female,GM0889,Beesel,2017JJ00,2017,6637,,52,,71,,-19,296,,32,264,232,,15,-1,217,64,46,,6683
224510,4000,Female,GM0889,Beesel,2018JJ00,2018,6683,,51,,69,,-18,293,,25,268,245,,17,-1,228,48,29,,6712
224511,4000,Female,GM0889,Beesel,2019JJ00,2019,6712,,56,,64,,-8,243,,23,220,250,,22,0,228,-7,-15,,6697
224512,4000,Female,GM0889,Beesel,2020JJ00,2020,6697,,45,,65,,-20,252,,22,230,268,,22,-1,246,-16,-36,,6661
224513,4000,Female,GM0889,Beesel,2021JJ00,2021,6661,,55,,69,,-14,242,,29,213,215,,20,-1,195,27,14,,6675
224514,4000,Female,GM0889,Beesel,2022JJ00,2022,6675,,57,,65,,-8,267,,69,198,246,,23,-2,223,21,12,,6687
224515,4000,Female,GM0889,Beesel,2023JJ00,2023,6687,,54,,58,,-4,269,,46,223,295,,34,-4,261,-26,-31,,6656
224832,4000,Female,GM0007,Bellingwedde,2012JJ00,2012,4638,,34,,61,,-27,225,,24,201,339,,33,-24,306,-114,-143,,4495
224833,4000,Female,GM0007,Bellingwedde,2013JJ00,2013,4495,,24,,60,,-36,229,,18,211,218,,21,-4,197,11,-24,,4471
224834,4000,Female,GM0007,Bellingwedde,2014JJ00,2014,4471,,28,,63,,-35,413,,162,251,310,,8,6,302,103,68,,4539
224835,4000,Female,GM0007,Bellingwedde,2015JJ00,2015,4539,,33,,65,,-32,356,,106,250,430,,28,-4,402,-74,-105,,4434
224836,4000,Female,GM0007,Bellingwedde,2016JJ00,2016,4434,,32,,74,,-42,369,,82,287,377,,24,-3,353,-8,-49,,4385
224837,4000,Female,GM0007,Bellingwedde,2017JJ00,2017,4385,,32,,77,,-45,350,,39,311,330,,25,-8,305,20,-25,,4360
225410,4000,Female,GM1945,Berg en Dal,2016JJ00,2016,17384,,125,,238,,-113,930,,102,828,742,,55,1,687,188,77,,17461
225411,4000,Female,GM1945,Berg en Dal,2017JJ00,2017,17461,,124,,226,,-102,944,,88,856,823,,69,-1,754,121,18,,17479
225412,4000,Female,GM1945,Berg en Dal,2018JJ00,2018,17479,,115,,237,,-122,928,,88,840,818,,95,0,723,110,-15,,17464
225413,4000,Female,GM1945,Berg en Dal,2019JJ00,2019,17474,,143,,241,,-98,955,,92,863,759,,83,-4,676,196,96,,17570
225414,4000,Female,GM1945,Berg en Dal,2020JJ00,2020,17570,,152,,245,,-93,869,,84,785,773,,58,-1,715,96,-1,,17569
225415,4000,Female,GM1945,Berg en Dal,2021JJ00,2021,17569,,139,,238,,-99,836,,65,771,741,,68,-4,673,95,-3,,17566
225416,4000,Female,GM1945,Berg en Dal,2022JJ00,2022,17566,,127,,245,,-118,1102,,331,771,721,,87,-7,634,381,265,,17831
225417,4000,Female,GM1945,Berg en Dal,2023JJ00,2023,17831,,125,,270,,-145,1009,,158,851,783,,111,-28,672,226,74,,17905
225570,4000,Female,GM0491,Bergambacht,2012JJ00,2012,5020,,42,,34,,8,193,,18,175,175,,-3,7,178,18,26,,5046
225571,4000,Female,GM0491,Bergambacht,2013JJ00,2013,5046,,41,,50,,-9,226,,22,204,225,,12,-2,213,1,-8,,5038
225572,4000,Female,GM0491,Bergambacht,2014JJ00,2014,5038,,60,,36,,24,219,,15,204,209,,11,-1,198,10,96,,5134
225652,4000,Female,GM1724,Bergeijk,2012JJ00,2012,8936,,77,,63,,14,340,,47,293,316,,24,-3,292,24,39,,8975
225653,4000,Female,GM1724,Bergeijk,2013JJ00,2013,8975,,63,,57,,6,328,,38,290,308,,45,-3,263,20,26,,9001
225654,4000,Female,GM1724,Bergeijk,2014JJ00,2014,9001,,81,,70,,11,318,,65,253,367,,34,-1,333,-49,-37,,8964
225655,4000,Female,GM1724,Bergeijk,2015JJ00,2015,8964,,68,,75,,-7,389,,55,334,361,,44,-10,317,28,21,,8985
225656,4000,Female,GM1724,Bergeijk,2016JJ00,2016,8985,,72,,76,,-4,399,,57,342,376,,43,-3,333,23,18,,9003
225657,4000,Female,GM1724,Bergeijk,2017JJ00,2017,9003,,72,,76,,-4,425,,63,362,404,,39,-7,365,21,16,,9019
225658,4000,Female,GM1724,Bergeijk,2018JJ00,2018,9019,,76,,82,,-6,434,,63,371,395,,40,-1,355,39,32,,9051
225659,4000,Female,GM1724,Bergeijk,2019JJ00,2019,9051,,69,,62,,7,436,,64,372,408,,47,-4,361,28,38,,9089
225660,4000,Female,GM1724,Bergeijk,2020JJ00,2020,9089,,101,,92,,9,400,,48,352,347,,32,-2,315,53,60,,9149
225661,4000,Female,GM1724,Bergeijk,2021JJ00,2021,9149,,82,,77,,5,463,,52,411,410,,61,-8,349,53,57,,9206
225662,4000,Female,GM1724,Bergeijk,2022JJ00,2022,9206,,79,,78,,1,424,,94,330,344,,53,-6,291,80,83,,9289
225663,4000,Female,GM1724,Bergeijk,2023JJ00,2023,9289,,90,,83,,7,440,,100,340,369,,80,-10,289,71,76,,9365
225734,4000,Female,GM0893,Bergen (L.),2012JJ00,2012,6628,,50,,50,,0,237,,30,207,246,,30,0,216,-9,-9,,6619
225735,4000,Female,GM0893,Bergen (L.),2013JJ00,2013,6619,,47,,58,,-11,179,,21,158,192,,17,-2,175,-13,-24,,6595
225736,4000,Female,GM0893,Bergen (L.),2014JJ00,2014,6595,,62,,58,,4,216,,29,187,245,,21,0,224,-29,-24,,6571
225737,4000,Female,GM0893,Bergen (L.),2015JJ00,2015,6571,,66,,78,,-12,245,,22,223,229,,32,-3,197,16,5,,6576
225738,4000,Female,GM0893,Bergen (L.),2016JJ00,2016,6576,,45,,67,,-22,241,,21,220,233,,16,2,217,8,-13,,6563
225739,4000,Female,GM0893,Bergen (L.),2017JJ00,2017,6563,,52,,62,,-10,252,,29,223,252,,17,0,235,0,-11,,6552
225740,4000,Female,GM0893,Bergen (L.),2018JJ00,2018,6552,,40,,60,,-20,255,,25,230,222,,9,1,213,33,13,,6565
225741,4000,Female,GM0893,Bergen (L.),2019JJ00,2019,6565,,46,,71,,-25,279,,42,237,281,,26,-1,255,-2,-27,,6538
225742,4000,Female,GM0893,Bergen (L.),2020JJ00,2020,6538,,38,,63,,-25,276,,34,242,248,,16,-1,232,28,2,,6540
225743,4000,Female,GM0893,Bergen (L.),2021JJ00,2021,6540,,54,,64,,-10,261,,38,223,283,,19,2,264,-22,-33,,6507
225744,4000,Female,GM0893,Bergen (L.),2022JJ00,2022,6507,,45,,61,,-16,285,,44,241,261,,31,-1,230,24,8,,6515
225745,4000,Female,GM0893,Bergen (L.),2023JJ00,2023,6515,,47,,68,,-21,284,,40,244,260,,16,-1,244,24,3,,6518
225816,4000,Female,GM0373,Bergen (NH.),2012JJ00,2012,15812,,84,,230,,-146,645,,95,550,660,,118,-4,542,-15,-160,,15652
225817,4000,Female,GM0373,Bergen (NH.),2013JJ00,2013,15652,,73,,230,,-157,694,,106,588,666,,88,-3,578,28,-130,,15522
225818,4000,Female,GM0373,Bergen (NH.),2014JJ00,2014,15522,,78,,201,,-123,773,,133,640,660,,81,1,579,113,-11,,15511
225819,4000,Female,GM0373,Bergen (NH.),2015JJ00,2015,15511,,70,,212,,-142,825,,135,690,718,,89,-3,629,107,-37,,15474
225820,4000,Female,GM0373,Bergen (NH.),2016JJ00,2016,15474,,79,,221,,-142,881,,130,751,756,,73,2,683,125,-15,,15459
225821,4000,Female,GM0373,Bergen (NH.),2017JJ00,2017,15459,,70,,233,,-163,876,,106,770,699,,66,1,633,177,13,,15472
225822,4000,Female,GM0373,Bergen (NH.),2018JJ00,2018,15472,,78,,207,,-129,849,,119,730,686,,70,0,616,163,35,,15507
225823,4000,Female,GM0373,Bergen (NH.),2019JJ00,2019,15507,,72,,223,,-151,803,,127,676,719,,52,0,667,84,-67,,15440
225824,4000,Female,GM0373,Bergen (NH.),2020JJ00,2020,15440,,70,,249,,-179,877,,93,784,739,,75,0,664,138,-42,,15398
225825,4000,Female,GM0373,Bergen (NH.),2021JJ00,2021,15398,,75,,206,,-131,812,,106,706,647,,51,0,596,165,35,,15433
225826,4000,Female,GM0373,Bergen (NH.),2022JJ00,2022,15433,,65,,242,,-177,1068,,295,773,627,,85,4,542,441,265,,15698
225827,4000,Female,GM0373,Bergen (NH.),2023JJ00,2023,15698,,86,,232,,-146,841,,130,711,812,,128,-9,684,29,-118,,15580
225898,4000,Female,GM0748,Bergen op Zoom,2012JJ00,2012,33468,,292,,296,,-4,1114,,221,893,1036,,181,-28,855,78,75,,33543
225899,4000,Female,GM0748,Bergen op Zoom,2013JJ00,2013,33543,,305,,319,,-14,1095,,238,857,1084,,186,-31,898,11,-5,,33538
225900,4000,Female,GM0748,Bergen op Zoom,2014JJ00,2014,33538,,299,,323,,-24,1144,,193,951,1138,,201,-22,937,6,-19,,33519
225901,4000,Female,GM0748,Bergen op Zoom,2015JJ00,2015,33519,,302,,342,,-40,1173,,209,964,1185,,232,-36,953,-12,-57,,33462
225902,4000,Female,GM0748,Bergen op Zoom,2016JJ00,2016,33462,,316,,360,,-44,1211,,200,1011,1208,,210,-23,998,3,-43,,33419
225903,4000,Female,GM0748,Bergen op Zoom,2017JJ00,2017,33419,,291,,360,,-69,1362,,221,1141,1232,,174,-26,1058,130,57,,33476
225904,4000,Female,GM0748,Bergen op Zoom,2018JJ00,2018,33476,,294,,347,,-53,1426,,258,1168,1187,,182,-10,1005,239,183,,33659
225905,4000,Female,GM0748,Bergen op Zoom,2019JJ00,2019,33659,,298,,320,,-22,1529,,291,1238,1137,,181,-8,956,392,370,,34029
225906,4000,Female,GM0748,Bergen op Zoom,2020JJ00,2020,34029,,300,,397,,-97,1328,,252,1076,1279,,150,-14,1129,49,-54,,33975
225907,4000,Female,GM0748,Bergen op Zoom,2021JJ00,2021,33975,,315,,392,,-77,1438,,269,1169,1186,,183,-29,1003,252,174,,34149
225908,4000,Female,GM0748,Bergen op Zoom,2022JJ00,2022,34149,,284,,353,,-69,1684,,504,1180,1146,,225,-29,921,538,466,,34615
225909,4000,Female,GM0748,Bergen op Zoom,2023JJ00,2023,34615,,290,,391,,-101,1702,,423,1279,1224,,241,-13,983,478,376,,34991
226554,4000,Female,GM1859,Berkelland,2012JJ00,2012,22289,,175,,184,,-9,617,,60,557,661,,36,-3,625,-44,-53,,22236
226555,4000,Female,GM1859,Berkelland,2013JJ00,2013,22236,,167,,181,,-14,605,,43,562,637,,32,-1,605,-32,-39,,22197
226556,4000,Female,GM1859,Berkelland,2014JJ00,2014,22197,,152,,174,,-22,597,,61,536,704,,43,-3,661,-107,-135,,22062
226557,4000,Female,GM1859,Berkelland,2015JJ00,2015,22062,,160,,185,,-25,736,,96,640,659,,41,-3,618,77,51,,22113
226558,4000,Female,GM1859,Berkelland,2016JJ00,2016,22113,,170,,216,,-46,669,,74,595,722,,30,5,692,-53,-99,,22014
226559,4000,Female,GM1859,Berkelland,2017JJ00,2017,22014,,158,,221,,-63,751,,42,709,761,,39,-2,722,-10,-72,,21942
226560,4000,Female,GM1859,Berkelland,2018JJ00,2018,21942,,181,,228,,-47,725,,62,663,707,,35,-4,672,18,-29,,21913
226561,4000,Female,GM1859,Berkelland,2019JJ00,2019,21913,,165,,212,,-47,726,,85,641,740,,61,2,679,-14,-63,,21850
226562,4000,Female,GM1859,Berkelland,2020JJ00,2020,21850,,144,,241,,-97,782,,73,709,640,,31,-1,609,142,47,,21897
226563,4000,Female,GM1859,Berkelland,2021JJ00,2021,21897,,170,,247,,-77,712,,43,669,650,,29,4,621,62,-17,,21880
226564,4000,Female,GM1859,Berkelland,2022JJ00,2022,21880,,151,,264,,-113,867,,170,697,688,,65,-8,623,179,66,,21946
226565,4000,Female,GM1859,Berkelland,2023JJ00,2023,21946,,170,,247,,-77,806,,147,659,767,,73,-17,694,39,-37,,21909
226882,4000,Female,GM1721,Bernheze,2012JJ00,2012,14779,,130,,124,,6,527,,66,461,578,,35,-6,543,-51,-43,,14736
226883,4000,Female,GM1721,Bernheze,2013JJ00,2013,14736,,131,,123,,8,543,,79,464,560,,41,-1,519,-17,-8,,14728
226884,4000,Female,GM1721,Bernheze,2014JJ00,2014,14728,,116,,144,,-28,599,,64,535,579,,52,-7,527,20,-10,,14718
226885,4000,Female,GM1721,Bernheze,2015JJ00,2015,14718,,120,,130,,-10,709,,67,642,618,,48,-13,570,91,81,,14799
226886,4000,Female,GM1721,Bernheze,2016JJ00,2016,14799,,128,,126,,2,767,,64,703,571,,31,-7,540,196,195,,14994
226887,4000,Female,GM1721,Bernheze,2017JJ00,2017,14994,,138,,144,,-6,852,,99,753,679,,44,-9,635,173,164,,15158
226888,4000,Female,GM1721,Bernheze,2018JJ00,2018,15158,,141,,156,,-15,777,,97,680,641,,53,-7,588,136,119,,15277
226889,4000,Female,GM1721,Bernheze,2019JJ00,2019,15277,,139,,149,,-10,813,,108,705,625,,69,-21,556,188,177,,15454
226890,4000,Female,GM1721,Bernheze,2020JJ00,2020,15454,,162,,188,,-26,816,,103,713,648,,57,-8,591,168,142,,15596
226891,4000,Female,GM1721,Bernheze,2021JJ00,2021,15596,,129,,177,,-48,907,,94,813,797,,85,-16,712,110,63,,15659
226892,4000,Female,GM1721,Bernheze,2022JJ00,2022,15659,,146,,154,,-8,1006,,243,763,670,,128,-18,542,336,328,,15987
226893,4000,Female,GM1721,Bernheze,2023JJ00,2023,15987,,131,,167,,-36,854,,213,641,720,,101,-19,619,134,98,,16085
226964,4000,Female,GM0568,Bernisse,2012JJ00,2012,6182,,52,,43,,9,194,,14,180,198,,19,0,179,-4,4,,6186
226965,4000,Female,GM0568,Bernisse,2013JJ00,2013,6186,,58,,31,,27,198,,16,182,208,,5,1,203,-10,16,,6202
226966,4000,Female,GM0568,Bernisse,2014JJ00,2014,6202,,41,,47,,-6,157,,17,140,224,,10,1,214,-67,-19,,6183
227046,4000,Female,GM0753,Best,2012JJ00,2012,14339,,112,,104,,8,480,,97,383,542,,53,-10,489,-62,-54,,14285
227047,4000,Female,GM0753,Best,2013JJ00,2013,14285,,126,,97,,29,466,,66,400,502,,53,3,449,-36,-6,,14279
227048,4000,Female,GM0753,Best,2014JJ00,2014,14279,,116,,112,,4,545,,91,454,506,,72,-7,434,39,42,,14321
227049,4000,Female,GM0753,Best,2015JJ00,2015,14321,,125,,95,,30,597,,85,512,508,,49,2,459,89,117,,14438
227050,4000,Female,GM0753,Best,2016JJ00,2016,14438,,111,,113,,-2,642,,85,557,512,,53,-7,459,130,129,,14567
227051,4000,Female,GM0753,Best,2017JJ00,2017,14567,,133,,96,,37,730,,158,572,603,,66,-6,537,127,165,,14732
227052,4000,Female,GM0753,Best,2018JJ00,2018,14732,,143,,101,,42,742,,124,618,617,,66,-20,551,125,162,,14894
227053,4000,Female,GM0753,Best,2019JJ00,2019,14894,,132,,113,,19,678,,142,536,630,,80,-17,550,48,66,,14960
227054,4000,Female,GM0753,Best,2020JJ00,2020,14960,,136,,121,,15,839,,121,718,668,,93,-15,575,171,185,,15145
227055,4000,Female,GM0753,Best,2021JJ00,2021,15145,,166,,108,,58,856,,118,738,695,,87,-17,608,161,221,,15366
227056,4000,Female,GM0753,Best,2022JJ00,2022,15366,,126,,133,,-7,798,,203,595,674,,107,-11,567,124,119,,15485
227057,4000,Female,GM0753,Best,2023JJ00,2023,15485,,143,,116,,27,823,,210,613,714,,116,-9,598,109,131,,15616
227210,4000,Female,GM0209,Beuningen,2012JJ00,2012,12747,,98,,79,,19,455,,37,418,528,,28,1,500,-73,-56,,12691
227211,4000,Female,GM0209,Beuningen,2013JJ00,2013,12691,,112,,91,,21,498,,35,463,553,,23,-4,530,-55,-33,,12658
227212,4000,Female,GM0209,Beuningen,2014JJ00,2014,12658,,111,,82,,29,502,,44,458,558,,26,0,532,-56,-27,,12631
227213,4000,Female,GM0209,Beuningen,2015JJ00,2015,12631,,117,,82,,35,606,,35,571,615,,30,1,585,-9,29,,12660
227214,4000,Female,GM0209,Beuningen,2016JJ00,2016,12660,,112,,87,,25,694,,45,649,651,,31,1,620,43,67,,12727
227215,4000,Female,GM0209,Beuningen,2017JJ00,2017,12727,,110,,109,,1,835,,53,782,649,,18,2,631,186,188,,12915
227216,4000,Female,GM0209,Beuningen,2018JJ00,2018,12915,,131,,106,,25,644,,41,603,625,,33,-3,592,19,43,,12958
227217,4000,Female,GM0209,Beuningen,2019JJ00,2019,12958,,105,,115,,-10,578,,43,535,567,,32,-1,535,11,0,,12958
227218,4000,Female,GM0209,Beuningen,2020JJ00,2020,12958,,123,,98,,25,698,,53,645,567,,16,0,551,131,155,,13113
227219,4000,Female,GM0209,Beuningen,2021JJ00,2021,13113,,108,,112,,-4,597,,31,566,571,,35,0,536,26,20,,13133
227220,4000,Female,GM0209,Beuningen,2022JJ00,2022,13133,,135,,132,,3,741,,174,567,541,,40,-4,501,200,203,,13336
227221,4000,Female,GM0209,Beuningen,2023JJ00,2023,13336,,106,,140,,-34,649,,55,594,565,,55,-12,510,84,52,,13388
227374,4000,Female,GM0375,Beverwijk,2012JJ00,2012,20125,,223,,198,,25,1044,,150,894,983,,109,-29,874,61,84,,20209
227375,4000,Female,GM0375,Beverwijk,2013JJ00,2013,20209,,211,,160,,51,940,,172,768,960,,144,-22,816,-20,30,,20239
227376,4000,Female,GM0375,Beverwijk,2014JJ00,2014,20239,,247,,177,,70,979,,157,822,1024,,142,-20,882,-45,23,,20262
227377,4000,Female,GM0375,Beverwijk,2015JJ00,2015,20262,,216,,208,,8,1153,,171,982,1131,,156,-52,975,22,27,,20289
227378,4000,Female,GM0375,Beverwijk,2016JJ00,2016,20289,,199,,186,,13,1231,,166,1065,1146,,107,-29,1039,85,98,,20387
227379,4000,Female,GM0375,Beverwijk,2017JJ00,2017,20387,,229,,212,,17,1249,,162,1087,1075,,151,-35,924,174,192,,20579
227380,4000,Female,GM0375,Beverwijk,2018JJ00,2018,20579,,221,,235,,-14,1137,,200,937,1107,,158,-26,949,30,15,,20594
227381,4000,Female,GM0375,Beverwijk,2019JJ00,2019,20594,,218,,239,,-21,1213,,193,1020,1065,,156,-16,909,148,126,,20720
227382,4000,Female,GM0375,Beverwijk,2020JJ00,2020,20720,,225,,226,,-1,1241,,169,1072,1147,,121,2,1026,94,91,,20811
227383,4000,Female,GM0375,Beverwijk,2021JJ00,2021,20811,,222,,226,,-4,1200,,156,1044,1080,,113,-18,967,120,113,,20924
227384,4000,Female,GM0375,Beverwijk,2022JJ00,2022,20924,,226,,225,,1,1447,,287,1160,1126,,143,-28,983,321,320,,21244
227385,4000,Female,GM0375,Beverwijk,2023JJ00,2023,21244,,202,,243,,-41,1200,,280,920,1169,,168,-40,1001,31,-9,,21235
227702,4000,Female,GM0063,het Bildt,2012JJ00,2012,5261,,53,,35,,18,256,,85,171,327,,28,-13,299,-71,-53,,5208
227703,4000,Female,GM0063,het Bildt,2013JJ00,2013,5208,,46,,39,,7,314,,169,145,343,,26,-12,317,-29,-18,,5190
227704,4000,Female,GM0063,het Bildt,2014JJ00,2014,5190,,59,,43,,16,391,,185,206,417,,33,-11,384,-26,-10,,5180
227705,4000,Female,GM0063,het Bildt,2015JJ00,2015,5180,,42,,48,,-6,415,,167,248,398,,26,-11,372,17,7,,5187
227706,4000,Female,GM0063,het Bildt,2016JJ00,2016,5187,,49,,58,,-9,379,,99,280,401,,13,-2,388,-22,-29,,5158
227707,4000,Female,GM0063,het Bildt,2017JJ00,2017,5158,,42,,60,,-18,420,,61,359,397,,47,-18,350,23,8,,5166
227784,4000,Female,GM0310,De Bilt,2012JJ00,2012,22098,,172,,303,,-131,1183,,138,1045,1112,,126,-15,986,71,-58,,22040
227785,4000,Female,GM0310,De Bilt,2013JJ00,2013,22040,,139,,297,,-158,1257,,132,1125,1117,,112,-1,1005,140,-17,,22023
227786,4000,Female,GM0310,De Bilt,2014JJ00,2014,22023,,149,,262,,-113,1381,,133,1248,1226,,114,-10,1112,155,44,,22067
227787,4000,Female,GM0310,De Bilt,2015JJ00,2015,22067,,172,,314,,-142,1516,,138,1378,1293,,127,-4,1166,223,83,,22150
227788,4000,Female,GM0310,De Bilt,2016JJ00,2016,22150,,157,,300,,-143,1606,,132,1474,1294,,95,2,1199,312,170,,22320
227789,4000,Female,GM0310,De Bilt,2017JJ00,2017,22320,,182,,257,,-75,1436,,153,1283,1316,,91,4,1225,120,43,,22363
227790,4000,Female,GM0310,De Bilt,2018JJ00,2018,22363,,152,,294,,-142,1379,,182,1197,1334,,106,-8,1228,45,-97,,22266
227791,4000,Female,GM0310,De Bilt,2019JJ00,2019,22266,,173,,287,,-114,1508,,199,1309,1275,,130,-16,1145,233,119,,22385
227792,4000,Female,GM0310,De Bilt,2020JJ00,2020,22385,,195,,304,,-109,1579,,149,1430,1373,,95,-4,1278,206,96,,22481
227793,4000,Female,GM0310,De Bilt,2021JJ00,2021,22481,,201,,278,,-77,1430,,137,1293,1280,,91,-2,1189,150,75,,22556
227794,4000,Female,GM0310,De Bilt,2022JJ00,2022,22556,,199,,300,,-101,1521,,318,1203,1211,,134,-3,1077,310,207,,22763
227795,4000,Female,GM0310,De Bilt,2023JJ00,2023,22763,,166,,354,,-188,1435,,220,1215,1399,,143,-5,1256,36,-155,,22608
227948,4000,Female,GM0585,Binnenmaas,2012JJ00,2012,14629,,134,,128,,6,557,,84,473,610,,41,-2,569,-53,-45,,14584
227949,4000,Female,GM0585,Binnenmaas,2013JJ00,2013,14584,,112,,131,,-19,502,,51,451,571,,33,-9,538,-69,-88,,14496
227950,4000,Female,GM0585,Binnenmaas,2014JJ00,2014,14496,,128,,124,,4,511,,37,474,535,,25,-1,510,-24,-20,,14476
227951,4000,Female,GM0585,Binnenmaas,2015JJ00,2015,14476,,110,,107,,3,551,,70,481,522,,39,-5,483,29,32,,14508
227952,4000,Female,GM0585,Binnenmaas,2016JJ00,2016,14508,,124,,130,,-6,819,,103,716,639,,22,4,617,180,175,,14683
227953,4000,Female,GM0585,Binnenmaas,2017JJ00,2017,14683,,133,,132,,1,857,,25,832,851,,51,-14,800,6,6,,14689
227954,4000,Female,GM0585,Binnenmaas,2018JJ00,2018,14689,,116,,158,,-42,692,,35,657,544,,30,1,514,148,102,,14791
228030,4000,Female,GM1728,Bladel,2012JJ00,2012,9615,,73,,85,,-12,364,,65,299,305,,34,-4,271,59,48,,9663
228031,4000,Female,GM1728,Bladel,2013JJ00,2013,9663,,95,,80,,15,447,,72,375,348,,25,2,323,99,116,,9779
228032,4000,Female,GM1728,Bladel,2014JJ00,2014,9779,,74,,88,,-14,378,,58,320,354,,37,-6,317,24,7,,9786
228033,4000,Female,GM1728,Bladel,2015JJ00,2015,9786,,97,,110,,-13,409,,62,347,350,,34,-3,316,59,47,,9833
228034,4000,Female,GM1728,Bladel,2016JJ00,2016,9833,,84,,81,,3,466,,60,406,414,,40,-7,374,52,53,,9886
228035,4000,Female,GM1728,Bladel,2017JJ00,2017,9886,,93,,106,,-13,461,,49,412,409,,37,-5,372,52,38,,9924
228036,4000,Female,GM1728,Bladel,2018JJ00,2018,9924,,92,,100,,-8,409,,58,351,379,,38,-6,341,30,24,,9948
228037,4000,Female,GM1728,Bladel,2019JJ00,2019,9948,,76,,88,,-12,470,,67,403,361,,31,1,330,109,94,,10042
228038,4000,Female,GM1728,Bladel,2020JJ00,2020,10042,,97,,106,,-9,450,,60,390,381,,35,-3,346,69,58,,10100
228039,4000,Female,GM1728,Bladel,2021JJ00,2021,10100,,83,,91,,-8,502,,64,438,400,,45,-5,355,102,93,,10193
228040,4000,Female,GM1728,Bladel,2022JJ00,2022,10193,,92,,101,,-9,532,,112,420,374,,55,-5,319,158,151,,10344
228041,4000,Female,GM1728,Bladel,2023JJ00,2023,10344,,80,,107,,-27,420,,98,322,435,,60,-6,375,-15,-44,,10300
228276,4000,Female,GM0376,Blaricum,2012JJ00,2012,4670,,26,,37,,-11,325,,39,286,269,,38,-6,231,56,45,,4715
228277,4000,Female,GM0376,Blaricum,2013JJ00,2013,4715,,38,,44,,-6,286,,39,247,295,,32,-2,263,-9,-16,,4699
228278,4000,Female,GM0376,Blaricum,2014JJ00,2014,4699,,32,,36,,-4,413,,45,368,288,,36,-6,252,125,124,,4823
228279,4000,Female,GM0376,Blaricum,2015JJ00,2015,4823,,38,,47,,-9,458,,45,413,309,,33,0,276,149,141,,4964
228280,4000,Female,GM0376,Blaricum,2016JJ00,2016,4964,,43,,44,,-1,589,,49,540,313,,49,-2,264,276,274,,5238
228281,4000,Female,GM0376,Blaricum,2017JJ00,2017,5238,,63,,41,,22,675,,57,618,394,,43,-4,351,281,302,,5540
228282,4000,Female,GM0376,Blaricum,2018JJ00,2018,5540,,73,,44,,29,537,,62,475,357,,53,-2,304,180,207,,5747
228283,4000,Female,GM0376,Blaricum,2019JJ00,2019,5747,,64,,32,,32,522,,56,466,401,,46,-4,355,121,174,,5921
228284,4000,Female,GM0376,Blaricum,2020JJ00,2020,5921,,72,,45,,27,586,,71,515,430,,47,-1,383,156,182,,6103
228285,4000,Female,GM0376,Blaricum,2021JJ00,2021,6103,,62,,54,,8,628,,51,577,431,,61,-1,370,197,203,,6306
228286,4000,Female,GM0376,Blaricum,2022JJ00,2022,6306,,49,,53,,-4,520,,136,384,422,,68,0,354,98,92,,6398
228287,4000,Female,GM0376,Blaricum,2023JJ00,2023,6398,,54,,53,,1,613,,116,497,448,,81,-1,367,165,165,,6563
228522,4000,Female,GM0377,Bloemendaal,2012JJ00,2012,11562,,59,,172,,-113,819,,117,702,607,,101,-13,506,212,97,,11659
228523,4000,Female,GM0377,Bloemendaal,2013JJ00,2013,11659,,50,,173,,-123,677,,97,580,644,,94,-7,550,33,-89,,11570
228524,4000,Female,GM0377,Bloemendaal,2014JJ00,2014,11570,,69,,173,,-104,947,,140,807,754,,87,-7,667,193,88,,11658
228525,4000,Female,GM0377,Bloemendaal,2015JJ00,2015,11658,,45,,163,,-118,940,,112,828,880,,99,-3,781,60,-54,,11604
228526,4000,Female,GM0377,Bloemendaal,2016JJ00,2016,11604,,57,,158,,-101,1154,,182,972,816,,117,-16,699,338,237,,11841
228527,4000,Female,GM0377,Bloemendaal,2017JJ00,2017,11841,,75,,173,,-98,1121,,162,959,834,,125,-10,709,287,186,,12027
228528,4000,Female,GM0377,Bloemendaal,2018JJ00,2018,12027,,66,,165,,-99,1010,,145,865,846,,125,-4,721,164,62,,12089
228529,4000,Female,GM0377,Bloemendaal,2019JJ00,2019,12089,,62,,164,,-102,1016,,163,853,816,,120,-6,696,200,98,,12187
228530,4000,Female,GM0377,Bloemendaal,2020JJ00,2020,12187,,51,,168,,-117,902,,118,784,872,,94,1,778,30,-89,,12098
228531,4000,Female,GM0377,Bloemendaal,2021JJ00,2021,12098,,68,,192,,-124,1072,,126,946,797,,103,-6,694,275,151,,12249
228532,4000,Female,GM0377,Bloemendaal,2022JJ00,2022,12249,,75,,201,,-126,1124,,295,829,855,,147,-6,708,269,139,,12388
228533,4000,Female,GM0377,Bloemendaal,2023JJ00,2023,12388,,44,,176,,-132,927,,151,776,860,,128,-1,732,67,-66,,12322
228768,4000,Female,GM0055,Boarnsterhim,2012JJ00,2012,9659,,100,,74,,26,485,,32,453,446,,41,-7,405,39,67,,9726
228769,4000,Female,GM0055,Boarnsterhim,2013JJ00,2013,9726,,81,,80,,1,442,,31,411,446,,27,-5,419,-4,-5,,9721
229014,4000,Female,GM1901,Bodegraven-Reeuwijk,2012JJ00,2012,16395,,165,,103,,62,506,,62,444,537,,67,-10,470,-31,31,,16426
229015,4000,Female,GM1901,Bodegraven-Reeuwijk,2013JJ00,2013,16426,,150,,97,,53,573,,85,488,549,,47,1,502,24,76,,16502
229016,4000,Female,GM1901,Bodegraven-Reeuwijk,2014JJ00,2014,16502,,169,,110,,59,625,,76,549,544,,55,-5,489,81,142,,16644
229017,4000,Female,GM1901,Bodegraven-Reeuwijk,2015JJ00,2015,16644,,166,,115,,51,649,,56,593,621,,42,-3,579,28,77,,16721
229018,4000,Female,GM1901,Bodegraven-Reeuwijk,2016JJ00,2016,16721,,190,,131,,59,758,,88,670,704,,42,-5,662,54,111,,16832
229019,4000,Female,GM1901,Bodegraven-Reeuwijk,2017JJ00,2017,16832,,209,,118,,91,758,,95,663,724,,41,-7,683,34,124,,16956
229020,4000,Female,GM1901,Bodegraven-Reeuwijk,2018JJ00,2018,16956,,179,,124,,55,886,,77,809,661,,37,3,624,225,278,,17234
229021,4000,Female,GM1901,Bodegraven-Reeuwijk,2019JJ00,2019,17234,,188,,133,,55,832,,89,743,674,,49,-7,625,158,211,,17445
229022,4000,Female,GM1901,Bodegraven-Reeuwijk,2020JJ00,2020,17445,,209,,150,,59,845,,82,763,722,,34,-2,688,123,182,,17627
229023,4000,Female,GM1901,Bodegraven-Reeuwijk,2021JJ00,2021,17627,,228,,142,,86,808,,66,742,656,,57,0,599,152,237,,17864
229024,4000,Female,GM1901,Bodegraven-Reeuwijk,2022JJ00,2022,17864,,202,,155,,47,1002,,252,750,693,,66,-13,627,309,356,,18220
229025,4000,Female,GM1901,Bodegraven-Reeuwijk,2023JJ00,2023,18220,,200,,149,,51,916,,175,741,849,,101,-20,748,67,116,,18336
229096,4000,Female,GM0755,Boekel,2012JJ00,2012,4872,,54,,40,,14,179,,22,157,145,,16,0,129,34,48,,4920
229097,4000,Female,GM0755,Boekel,2013JJ00,2013,4920,,49,,35,,14,180,,22,158,188,,3,2,185,-8,7,,4927
229098,4000,Female,GM0755,Boekel,2014JJ00,2014,4927,,52,,39,,13,166,,25,141,166,,9,0,157,0,13,,4940
229099,4000,Female,GM0755,Boekel,2015JJ00,2015,4940,,51,,41,,10,274,,40,234,197,,13,-3,184,77,87,,5027
229100,4000,Female,GM0755,Boekel,2016JJ00,2016,5027,,44,,45,,-1,256,,18,238,194,,21,-1,173,62,61,,5088
229101,4000,Female,GM0755,Boekel,2017JJ00,2017,5088,,49,,40,,9,242,,25,217,219,,14,-1,205,23,32,,5120
229102,4000,Female,GM0755,Boekel,2018JJ00,2018,5120,,47,,43,,4,283,,26,257,220,,22,-3,198,63,66,,5186
229103,4000,Female,GM0755,Boekel,2019JJ00,2019,5186,,49,,44,,5,269,,26,243,172,,10,1,162,97,102,,5288
229104,4000,Female,GM0755,Boekel,2020JJ00,2020,5288,,64,,61,,3,284,,20,264,200,,19,-3,181,84,87,,5375
229105,4000,Female,GM0755,Boekel,2021JJ00,2021,5375,,52,,48,,4,261,,25,236,241,,21,-6,220,20,24,,5399
229106,4000,Female,GM0755,Boekel,2022JJ00,2022,5399,,50,,54,,-4,263,,56,207,210,,28,-7,182,53,50,,5449
229107,4000,Female,GM0755,Boekel,2023JJ00,2023,5449,,64,,43,,21,277,,41,236,237,,30,-6,207,40,61,,5510
229178,4000,Female,GM0009,Ten Boer,2012JJ00,2012,3733,,39,,51,,-12,176,,9,167,151,,13,0,138,25,13,,3746
229179,4000,Female,GM0009,Ten Boer,2013JJ00,2013,3746,,40,,41,,-1,165,,5,160,160,,13,0,147,5,3,,3749
229180,4000,Female,GM0009,Ten Boer,2014JJ00,2014,3749,,34,,49,,-15,174,,9,165,156,,1,2,155,18,4,,3753
229181,4000,Female,GM0009,Ten Boer,2015JJ00,2015,3753,,36,,50,,-14,155,,12,143,200,,11,1,189,-45,-61,,3692
229182,4000,Female,GM0009,Ten Boer,2016JJ00,2016,3692,,34,,54,,-20,200,,7,193,191,,11,-5,180,9,-11,,3681
229183,4000,Female,GM0009,Ten Boer,2017JJ00,2017,3681,,23,,44,,-21,246,,4,242,232,,8,0,224,14,-5,,3676
229184,4000,Female,GM0009,Ten Boer,2018JJ00,2018,3676,,32,,67,,-35,232,,11,221,199,,1,2,198,33,-3,,3673
229670,4000,Female,GM1681,Borger-Odoorn,2012JJ00,2012,12965,,85,,131,,-46,544,,25,519,637,,33,-4,604,-93,-141,,12824
229671,4000,Female,GM1681,Borger-Odoorn,2013JJ00,2013,12824,,90,,106,,-16,607,,40,567,582,,21,1,561,25,9,,12833
229672,4000,Female,GM1681,Borger-Odoorn,2014JJ00,2014,12833,,94,,120,,-26,580,,21,559,621,,35,0,586,-41,-67,,12766
229673,4000,Female,GM1681,Borger-Odoorn,2015JJ00,2015,12766,,80,,138,,-58,605,,35,570,636,,27,-5,609,-31,-87,,12679
229674,4000,Female,GM1681,Borger-Odoorn,2016JJ00,2016,12679,,108,,136,,-28,747,,31,716,690,,43,-1,647,57,30,,12709
229675,4000,Female,GM1681,Borger-Odoorn,2017JJ00,2017,12709,,89,,143,,-54,750,,29,721,701,,27,2,674,49,-4,,12705
229676,4000,Female,GM1681,Borger-Odoorn,2018JJ00,2018,12705,,89,,123,,-34,744,,38,706,745,,32,-1,713,-1,-36,,12669
229677,4000,Female,GM1681,Borger-Odoorn,2019JJ00,2019,12669,,100,,128,,-28,834,,55,779,731,,30,-1,701,103,76,,12745
229678,4000,Female,GM1681,Borger-Odoorn,2020JJ00,2020,12745,,103,,137,,-34,846,,41,805,770,,29,2,741,76,41,,12786
229679,4000,Female,GM1681,Borger-Odoorn,2021JJ00,2021,12786,,99,,136,,-37,721,,25,696,660,,25,-6,635,61,23,,12809
229680,4000,Female,GM1681,Borger-Odoorn,2022JJ00,2022,12809,,93,,162,,-69,844,,132,712,669,,60,-18,609,175,106,,12915
229681,4000,Female,GM1681,Borger-Odoorn,2023JJ00,2023,12915,,107,,151,,-44,776,,112,664,695,,41,2,654,81,38,,12953
229916,4000,Female,GM0147,Borne,2012JJ00,2012,10786,,118,,89,,29,506,,33,473,399,,40,-16,359,107,137,,10923
229917,4000,Female,GM0147,Borne,2013JJ00,2013,10923,,105,,106,,-1,445,,30,415,380,,37,2,343,65,64,,10987
229918,4000,Female,GM0147,Borne,2014JJ00,2014,10987,,102,,83,,19,447,,27,420,410,,33,-7,377,37,57,,11044
229919,4000,Female,GM0147,Borne,2015JJ00,2015,11044,,110,,111,,-1,623,,174,449,536,,35,-9,501,87,86,,11130
229920,4000,Female,GM0147,Borne,2016JJ00,2016,11130,,117,,108,,9,803,,119,684,561,,33,-3,528,242,254,,11384
229921,4000,Female,GM0147,Borne,2017JJ00,2017,11384,,118,,96,,22,747,,44,703,541,,26,-5,515,206,229,,11613
229922,4000,Female,GM0147,Borne,2018JJ00,2018,11613,,123,,96,,27,522,,35,487,512,,33,-3,479,10,36,,11649
229923,4000,Female,GM0147,Borne,2019JJ00,2019,11649,,117,,99,,18,519,,37,482,521,,34,-8,487,-2,19,,11668
229924,4000,Female,GM0147,Borne,2020JJ00,2020,11668,,128,,114,,14,644,,32,612,450,,21,-2,429,194,207,,11875
229925,4000,Female,GM0147,Borne,2021JJ00,2021,11875,,128,,116,,12,632,,28,604,472,,21,-1,451,160,169,,12044
229926,4000,Female,GM0147,Borne,2022JJ00,2022,12044,,125,,123,,2,848,,271,577,518,,69,-19,449,330,332,,12376
229927,4000,Female,GM0147,Borne,2023JJ00,2023,12376,,98,,104,,-6,593,,64,529,574,,47,-5,527,19,14,,12390
229998,4000,Female,GM0654,Borsele,2012JJ00,2012,11185,,122,,61,,61,433,,47,386,453,,30,-13,423,-20,36,,11221
229999,4000,Female,GM0654,Borsele,2013JJ00,2013,11221,,111,,82,,29,385,,31,354,466,,30,0,436,-81,-51,,11170
230000,4000,Female,GM0654,Borsele,2014JJ00,2014,11170,,113,,79,,34,468,,46,422,521,,42,-4,479,-53,-19,,11151
230001,4000,Female,GM0654,Borsele,2015JJ00,2015,11151,,136,,79,,57,450,,40,410,492,,41,-2,451,-42,18,,11169
230002,4000,Female,GM0654,Borsele,2016JJ00,2016,11169,,108,,78,,30,531,,35,496,513,,35,-6,478,18,48,,11217
230003,4000,Female,GM0654,Borsele,2017JJ00,2017,11217,,103,,102,,1,559,,36,523,587,,33,2,554,-28,-27,,11190
230004,4000,Female,GM0654,Borsele,2018JJ00,2018,11190,,119,,73,,46,582,,56,526,573,,40,-4,533,9,53,,11243
230005,4000,Female,GM0654,Borsele,2019JJ00,2019,11243,,110,,85,,25,503,,44,459,580,,41,-4,539,-77,-53,,11190
230006,4000,Female,GM0654,Borsele,2020JJ00,2020,11190,,120,,90,,30,518,,48,470,495,,25,4,470,23,53,,11243
230007,4000,Female,GM0654,Borsele,2021JJ00,2021,11243,,109,,104,,5,501,,41,460,501,,37,-6,464,0,5,,11248
230008,4000,Female,GM0654,Borsele,2022JJ00,2022,11248,,108,,95,,13,642,,125,517,505,,55,-6,450,137,149,,11397
230009,4000,Female,GM0654,Borsele,2023JJ00,2023,11397,,109,,107,,2,558,,81,477,580,,53,-2,527,-22,-19,,11378
230162,4000,Female,GM0499,Boskoop,2012JJ00,2012,7562,,63,,65,,-2,316,,44,272,250,,28,-1,222,66,63,,7625
230163,4000,Female,GM0499,Boskoop,2013JJ00,2013,7625,,71,,56,,15,255,,47,208,293,,41,1,252,-38,-23,,7602
230326,4000,Female,GM0756,Boxmeer,2012JJ00,2012,14205,,82,,115,,-33,514,,64,450,546,,46,2,500,-32,-68,,14137
230327,4000,Female,GM0756,Boxmeer,2013JJ00,2013,14137,,102,,121,,-19,488,,52,436,529,,70,-3,459,-41,-60,,14077
230328,4000,Female,GM0756,Boxmeer,2014JJ00,2014,14077,,100,,122,,-22,622,,147,475,568,,46,0,522,54,32,,14109
230329,4000,Female,GM0756,Boxmeer,2015JJ00,2015,14109,,91,,146,,-55,937,,415,522,874,,65,-2,809,63,7,,14116
230330,4000,Female,GM0756,Boxmeer,2016JJ00,2016,14116,,115,,127,,-12,950,,230,720,812,,57,-2,755,138,124,,14240
230331,4000,Female,GM0756,Boxmeer,2017JJ00,2017,14240,,118,,153,,-35,844,,95,749,730,,65,-21,665,114,71,,14311
230332,4000,Female,GM0756,Boxmeer,2018JJ00,2018,14311,,129,,137,,-8,887,,130,757,700,,68,-12,632,187,181,,14492
230333,4000,Female,GM0756,Boxmeer,2019JJ00,2019,14492,,122,,129,,-7,791,,114,677,660,,90,-33,570,131,119,,14611
230334,4000,Female,GM0756,Boxmeer,2020JJ00,2020,14611,,123,,157,,-34,856,,93,763,711,,67,-5,644,145,108,,14719
230335,4000,Female,GM0756,Boxmeer,2021JJ00,2021,14719,,139,,160,,-21,824,,82,742,760,,54,-1,706,64,55,,14774
230408,4000,Female,GM0757,Boxtel,2012JJ00,2012,15296,,135,,140,,-5,549,,91,458,500,,48,-6,452,49,44,,15340
230409,4000,Female,GM0757,Boxtel,2013JJ00,2013,15340,,127,,135,,-8,529,,77,452,601,,77,-3,524,-72,-80,,15260
230410,4000,Female,GM0757,Boxtel,2014JJ00,2014,15260,,147,,146,,1,601,,80,521,586,,55,-15,531,15,17,,15277
230411,4000,Female,GM0757,Boxtel,2015JJ00,2015,15277,,112,,171,,-59,641,,96,545,579,,60,-4,519,62,3,,15280
230412,4000,Female,GM0757,Boxtel,2016JJ00,2016,15280,,139,,150,,-11,731,,96,635,572,,73,-12,499,159,144,,15424
230413,4000,Female,GM0757,Boxtel,2017JJ00,2017,15424,,128,,148,,-20,697,,105,592,629,,74,-6,555,68,48,,15472
230414,4000,Female,GM0757,Boxtel,2018JJ00,2018,15472,,133,,169,,-36,628,,125,503,610,,52,-17,558,18,-19,,15453
230415,4000,Female,GM0757,Boxtel,2019JJ00,2019,15453,,119,,162,,-43,602,,130,472,575,,65,-9,510,27,-16,,15437
230416,4000,Female,GM0757,Boxtel,2020JJ00,2020,15437,,123,,178,,-55,687,,130,557,647,,62,-16,585,40,-17,,15420
230417,4000,Female,GM0757,Boxtel,2021JJ00,2021,16529,,158,,180,,-22,780,,125,655,650,,78,-21,572,130,106,,16635
230418,4000,Female,GM0757,Boxtel,2022JJ00,2022,16635,,136,,204,,-68,1029,,273,756,678,,120,-34,558,351,286,,16921
230419,4000,Female,GM0757,Boxtel,2023JJ00,2023,16921,,121,,196,,-75,918,,154,764,725,,108,-30,617,193,117,,17038
230654,4000,Female,GM0758,Breda,2012JJ00,2012,90424,,956,,805,,151,4854,,978,3876,4336,,811,-144,3525,518,686,,91110
230655,4000,Female,GM0758,Breda,2013JJ00,2013,91110,,899,,850,,49,5051,,968,4083,4390,,839,-110,3551,661,718,,91828
230656,4000,Female,GM0758,Breda,2014JJ00,2014,91828,,959,,824,,135,5199,,1000,4199,4846,,913,-154,3933,353,489,,92317
230657,4000,Female,GM0758,Breda,2015JJ00,2015,92317,,935,,870,,65,5437,,1235,4202,5295,,881,-118,4414,142,203,,92520
230658,4000,Female,GM0758,Breda,2016JJ00,2016,92520,,904,,858,,46,5538,,1166,4372,5395,,890,-133,4505,143,190,,92710
230659,4000,Female,GM0758,Breda,2017JJ00,2017,92710,,890,,887,,3,5811,,1125,4686,5383,,894,-128,4489,428,410,,93120
230660,4000,Female,GM0758,Breda,2018JJ00,2018,93120,,888,,852,,36,5311,,1278,4033,5120,,934,-92,4186,191,217,,93337
230661,4000,Female,GM0758,Breda,2019JJ00,2019,93337,,876,,910,,-34,5273,,1280,3993,5068,,939,-158,4129,205,163,,93500
230662,4000,Female,GM0758,Breda,2020JJ00,2020,93500,,836,,954,,-118,5035,,1064,3971,4901,,791,-97,4110,134,20,,93520
230663,4000,Female,GM0758,Breda,2021JJ00,2021,93520,,899,,908,,-9,5013,,1166,3847,4817,,750,-42,4067,196,189,,93709
230664,4000,Female,GM0758,Breda,2022JJ00,2022,93709,,843,,925,,-82,5812,,1827,3985,4926,,1021,-118,3905,886,802,,94511
230665,4000,Female,GM0758,Breda,2023JJ00,2023,94511,,788,,932,,-144,6212,,1691,4521,5252,,1087,-127,4165,960,815,,95326
231146,4000,Female,GM0501,Brielle,2012JJ00,2012,8158,,77,,78,,-1,463,,51,412,301,,29,0,272,162,161,,8319
231147,4000,Female,GM0501,Brielle,2013JJ00,2013,8319,,68,,84,,-16,346,,46,300,328,,30,-2,298,18,2,,8321
231148,4000,Female,GM0501,Brielle,2014JJ00,2014,8321,,62,,76,,-14,448,,61,387,350,,34,1,316,98,86,,8407
231149,4000,Female,GM0501,Brielle,2015JJ00,2015,8407,,59,,88,,-29,437,,46,391,340,,31,-1,309,97,70,,8477
231150,4000,Female,GM0501,Brielle,2016JJ00,2016,8477,,68,,93,,-25,513,,66,447,393,,44,-4,349,120,96,,8573
231151,4000,Female,GM0501,Brielle,2017JJ00,2017,8573,,64,,89,,-25,512,,50,462,404,,36,-2,368,108,85,,8658
231152,4000,Female,GM0501,Brielle,2018JJ00,2018,8658,,63,,69,,-6,519,,50,469,427,,34,1,393,92,87,,8745
231153,4000,Female,GM0501,Brielle,2019JJ00,2019,8745,,62,,83,,-21,459,,62,397,414,,32,0,382,45,22,,8767
231154,4000,Female,GM0501,Brielle,2020JJ00,2020,8767,,93,,64,,29,527,,64,463,475,,34,-6,441,52,80,,8847
231155,4000,Female,GM0501,Brielle,2021JJ00,2021,8847,,74,,96,,-22,577,,56,521,435,,27,-6,408,142,121,,8968
231156,4000,Female,GM0501,Brielle,2022JJ00,2022,8968,,67,,102,,-35,563,,114,449,411,,56,-13,355,152,158,,9126
231474,4000,Female,GM1876,Bronckhorst,2012JJ00,2012,18843,,138,,178,,-40,585,,33,552,648,,22,1,626,-63,-103,,18740
231475,4000,Female,GM1876,Bronckhorst,2013JJ00,2013,18740,,120,,171,,-51,559,,34,525,690,,35,2,655,-131,-180,,18560
231476,4000,Female,GM1876,Bronckhorst,2014JJ00,2014,18560,,118,,179,,-61,631,,45,586,677,,30,-2,647,-46,-107,,18453
231477,4000,Female,GM1876,Bronckhorst,2015JJ00,2015,18453,,106,,159,,-53,647,,60,587,735,,34,-1,701,-88,-141,,18312
231478,4000,Female,GM1876,Bronckhorst,2016JJ00,2016,18312,,106,,182,,-76,773,,53,720,751,,51,-1,700,22,-52,,18260
231479,4000,Female,GM1876,Bronckhorst,2017JJ00,2017,18260,,119,,166,,-47,833,,47,786,817,,27,1,790,16,-32,,18228
231480,4000,Female,GM1876,Bronckhorst,2018JJ00,2018,18228,,119,,173,,-54,718,,45,673,735,,34,-1,701,-17,-70,,18158
231481,4000,Female,GM1876,Bronckhorst,2019JJ00,2019,18158,,126,,168,,-42,738,,40,698,753,,36,1,717,-15,-58,,18100
231482,4000,Female,GM1876,Bronckhorst,2020JJ00,2020,18100,,130,,218,,-88,841,,52,789,774,,36,-4,738,67,-20,,18080
231483,4000,Female,GM1876,Bronckhorst,2021JJ00,2021,18080,,117,,233,,-116,770,,44,726,692,,40,-2,652,78,-40,,18040
231484,4000,Female,GM1876,Bronckhorst,2022JJ00,2022,18040,,110,,203,,-93,940,,206,734,729,,71,-3,658,211,117,,18157
231485,4000,Female,GM1876,Bronckhorst,2023JJ00,2023,18157,,113,,200,,-87,751,,118,633,740,,69,-3,671,11,-74,,18083
231720,4000,Female,GM0213,Brummen,2012JJ00,2012,10808,,78,,116,,-38,403,,19,384,428,,20,0,408,-25,-63,,10745
231721,4000,Female,GM0213,Brummen,2013JJ00,2013,10745,,78,,113,,-35,424,,33,391,431,,32,-1,399,-7,-42,,10703
231722,4000,Female,GM0213,Brummen,2014JJ00,2014,10703,,83,,95,,-12,375,,37,338,458,,30,-4,428,-83,-94,,10609
231723,4000,Female,GM0213,Brummen,2015JJ00,2015,10609,,80,,109,,-29,424,,30,394,400,,18,6,382,24,-4,,10605
231724,4000,Female,GM0213,Brummen,2016JJ00,2016,10605,,73,,98,,-25,471,,41,430,491,,21,-6,470,-20,-44,,10561
231725,4000,Female,GM0213,Brummen,2017JJ00,2017,10561,,72,,117,,-45,493,,33,460,518,,36,-3,482,-25,-71,,10490
231726,4000,Female,GM0213,Brummen,2018JJ00,2018,10490,,77,,124,,-47,501,,25,476,493,,19,-5,474,8,-40,,10450
231727,4000,Female,GM0213,Brummen,2019JJ00,2019,10450,,90,,106,,-16,502,,22,480,460,,19,-3,441,42,25,,10475
231728,4000,Female,GM0213,Brummen,2020JJ00,2020,10475,,84,,115,,-31,545,,30,515,480,,18,-2,462,65,35,,10510
231729,4000,Female,GM0213,Brummen,2021JJ00,2021,10510,,73,,119,,-46,532,,26,506,475,,26,-3,449,57,12,,10522
231730,4000,Female,GM0213,Brummen,2022JJ00,2022,10522,,68,,121,,-53,562,,89,473,373,,29,-2,344,189,135,,10657
231731,4000,Female,GM0213,Brummen,2023JJ00,2023,10657,,78,,128,,-50,562,,46,516,441,,49,-3,392,121,71,,10728
231802,4000,Female,GM0899,Brunssum,2012JJ00,2012,14966,,107,,166,,-59,687,,72,615,654,,51,0,603,33,-26,,14940
231803,4000,Female,GM0899,Brunssum,2013JJ00,2013,14940,,94,,202,,-108,655,,71,584,646,,60,4,586,9,-98,,14842
231804,4000,Female,GM0899,Brunssum,2014JJ00,2014,14842,,100,,198,,-98,612,,67,545,688,,60,-10,628,-76,-174,,14668
231805,4000,Female,GM0899,Brunssum,2015JJ00,2015,14668,,100,,205,,-105,722,,69,653,708,,60,1,648,14,-91,,14577
231806,4000,Female,GM0899,Brunssum,2016JJ00,2016,14577,,95,,191,,-96,660,,51,609,655,,45,-4,610,5,-92,,14485
231807,4000,Female,GM0899,Brunssum,2017JJ00,2017,14485,,110,,193,,-83,757,,64,693,737,,58,-2,679,20,-62,,14423
231808,4000,Female,GM0899,Brunssum,2018JJ00,2018,14423,,96,,220,,-124,707,,74,633,708,,64,1,644,-1,-126,,14297
231809,4000,Female,GM0899,Brunssum,2019JJ00,2019,14297,,91,,181,,-90,691,,92,599,783,,63,-8,720,-92,-182,,14115
231810,4000,Female,GM0899,Brunssum,2020JJ00,2020,14115,,103,,196,,-93,743,,65,678,717,,52,-5,665,26,-69,,14046
231811,4000,Female,GM0899,Brunssum,2021JJ00,2021,14046,,101,,215,,-114,808,,61,747,708,,52,-4,656,100,-15,,14031
231812,4000,Female,GM0899,Brunssum,2022JJ00,2022,14031,,111,,198,,-87,888,,155,733,751,,77,-14,674,137,52,,14083
231813,4000,Female,GM0899,Brunssum,2023JJ00,2023,14083,,107,,200,,-93,750,,108,642,631,,89,-3,542,119,24,,14107
232130,4000,Female,GM0312,Bunnik,2012JJ00,2012,7310,,50,,42,,8,398,,22,376,347,,26,-3,321,51,59,,7369
232131,4000,Female,GM0312,Bunnik,2013JJ00,2013,7369,,65,,46,,19,360,,24,336,356,,30,-2,326,4,24,,7393
232132,4000,Female,GM0312,Bunnik,2014JJ00,2014,7393,,52,,54,,-2,429,,42,387,402,,29,-1,373,27,25,,7418
232133,4000,Female,GM0312,Bunnik,2015JJ00,2015,7418,,66,,51,,15,443,,40,403,407,,19,-3,388,36,51,,7469
232134,4000,Female,GM0312,Bunnik,2016JJ00,2016,7469,,65,,51,,14,520,,25,495,353,,20,1,333,167,182,,7651
232135,4000,Female,GM0312,Bunnik,2017JJ00,2017,7651,,66,,59,,7,439,,32,407,413,,32,-3,381,26,33,,7684
232136,4000,Female,GM0312,Bunnik,2018JJ00,2018,7684,,65,,64,,1,435,,33,402,447,,24,-4,423,-12,-10,,7674
232137,4000,Female,GM0312,Bunnik,2019JJ00,2019,7674,,56,,53,,3,413,,49,364,426,,21,4,405,-13,-9,,7665
232138,4000,Female,GM0312,Bunnik,2020JJ00,2020,7665,,72,,63,,9,515,,29,486,443,,28,-4,415,72,80,,7745
232139,4000,Female,GM0312,Bunnik,2021JJ00,2021,7745,,76,,62,,14,523,,39,484,400,,22,-2,378,123,136,,7881
232140,4000,Female,GM0312,Bunnik,2022JJ00,2022,7881,,68,,52,,16,587,,104,483,369,,28,2,341,218,233,,8114
232141,4000,Female,GM0312,Bunnik,2023JJ00,2023,8114,,70,,67,,3,473,,49,424,437,,42,-5,395,36,43,,8157
232212,4000,Female,GM0313,Bunschoten,2012JJ00,2012,10082,,145,,58,,87,178,,44,134,213,,32,-5,181,-35,52,,10134
232213,4000,Female,GM0313,Bunschoten,2013JJ00,2013,10134,,116,,67,,49,224,,99,125,178,,23,-3,155,46,95,,10229
232214,4000,Female,GM0313,Bunschoten,2014JJ00,2014,10229,,133,,61,,72,285,,107,178,259,,80,-8,179,26,97,,10326
232215,4000,Female,GM0313,Bunschoten,2015JJ00,2015,10326,,140,,56,,84,258,,68,190,240,,76,-11,164,18,102,,10428
232216,4000,Female,GM0313,Bunschoten,2016JJ00,2016,10428,,125,,67,,58,327,,127,200,284,,61,-2,223,43,99,,10527
232217,4000,Female,GM0313,Bunschoten,2017JJ00,2017,10527,,140,,64,,76,297,,80,217,254,,45,-10,209,43,119,,10646
232218,4000,Female,GM0313,Bunschoten,2018JJ00,2018,10646,,132,,55,,77,378,,102,276,288,,74,-6,214,90,166,,10812
232219,4000,Female,GM0313,Bunschoten,2019JJ00,2019,10812,,149,,59,,90,367,,117,250,300,,56,-9,244,67,156,,10968
232220,4000,Female,GM0313,Bunschoten,2020JJ00,2020,10968,,142,,94,,48,310,,79,231,280,,57,-14,223,30,77,,11045
232221,4000,Female,GM0313,Bunschoten,2021JJ00,2021,11045,,130,,86,,44,363,,71,292,265,,34,-1,231,98,141,,11186
232222,4000,Female,GM0313,Bunschoten,2022JJ00,2022,11186,,129,,83,,46,407,,167,240,339,,101,-6,238,68,113,,11299
232223,4000,Female,GM0313,Bunschoten,2023JJ00,2023,11299,,112,,87,,25,342,,97,245,337,,78,-10,259,5,30,,11329
232294,4000,Female,GM0214,Buren,2012JJ00,2012,12965,,119,,96,,23,534,,47,487,559,,30,-5,529,-25,-2,,12963
232295,4000,Female,GM0214,Buren,2013JJ00,2013,12963,,105,,96,,9,566,,58,508,509,,30,3,479,57,67,,13030
232296,4000,Female,GM0214,Buren,2014JJ00,2014,13030,,112,,96,,16,606,,53,553,594,,47,-12,547,12,26,,13056
232297,4000,Female,GM0214,Buren,2015JJ00,2015,13056,,108,,109,,-1,637,,67,570,598,,32,-2,566,39,37,,13093
232298,4000,Female,GM0214,Buren,2016JJ00,2016,13093,,116,,100,,16,714,,49,665,689,,31,5,658,25,43,,13136
232299,4000,Female,GM0214,Buren,2017JJ00,2017,13136,,103,,91,,12,743,,55,688,744,,36,1,708,-1,10,,13146
232300,4000,Female,GM0214,Buren,2018JJ00,2018,13146,,141,,90,,51,714,,51,663,658,,24,6,634,56,108,,13254
232301,4000,Female,GM0214,Buren,2019JJ00,2019,13254,,94,,109,,-15,770,,64,706,683,,40,-4,643,87,70,,13324
232302,4000,Female,GM0214,Buren,2020JJ00,2020,13324,,126,,122,,4,832,,64,768,738,,45,-7,693,94,99,,13423
232303,4000,Female,GM0214,Buren,2021JJ00,2021,13423,,135,,128,,7,736,,56,680,666,,40,-8,626,70,75,,13498
232304,4000,Female,GM0214,Buren,2022JJ00,2022,13498,,130,,115,,15,1029,,260,769,737,,89,-28,648,292,310,,13808
232305,4000,Female,GM0214,Buren,2023JJ00,2023,13808,,129,,117,,12,796,,186,610,792,,116,-36,676,4,12,,13820
232458,4000,Female,GM0381,Bussum,2012JJ00,2012,17113,,137,,185,,-48,1016,,145,871,1001,,100,-10,901,15,-33,,17080
232459,4000,Female,GM0381,Bussum,2013JJ00,2013,17080,,149,,206,,-57,1074,,140,934,1047,,133,-13,914,27,-29,,17051
232460,4000,Female,GM0381,Bussum,2014JJ00,2014,17051,,139,,202,,-63,1340,,156,1184,1173,,156,-13,1017,167,103,,17154
232461,4000,Female,GM0381,Bussum,2015JJ00,2015,17154,,146,,215,,-69,1372,,155,1217,1221,,124,-11,1097,151,88,,17242
232868,4000,Female,GM0502,Capelle aan den IJssel,2012JJ00,2012,34199,,341,,303,,38,1830,,261,1569,1940,,252,-21,1688,-110,-67,,34132
232869,4000,Female,GM0502,Capelle aan den IJssel,2013JJ00,2013,34132,,335,,317,,18,1948,,238,1710,1891,,314,-69,1577,57,73,,34205
232870,4000,Female,GM0502,Capelle aan den IJssel,2014JJ00,2014,34205,,356,,287,,69,2001,,270,1731,1928,,260,-43,1668,73,143,,34348
232871,4000,Female,GM0502,Capelle aan den IJssel,2015JJ00,2015,34348,,348,,330,,18,2076,,266,1810,2109,,316,-97,1793,-33,-14,,34334
232872,4000,Female,GM0502,Capelle aan den IJssel,2016JJ00,2016,34334,,369,,308,,61,2097,,265,1832,2150,,315,-98,1835,-53,7,,34341
232873,4000,Female,GM0502,Capelle aan den IJssel,2017JJ00,2017,34341,,338,,347,,-9,2285,,274,2011,2123,,248,-35,1875,162,158,,34499
232874,4000,Female,GM0502,Capelle aan den IJssel,2018JJ00,2018,34499,,327,,337,,-10,2153,,318,1835,2090,,254,-53,1836,63,48,,34547
232875,4000,Female,GM0502,Capelle aan den IJssel,2019JJ00,2019,34547,,315,,336,,-21,2216,,369,1847,2122,,231,-52,1891,94,70,,34617
232876,4000,Female,GM0502,Capelle aan den IJssel,2020JJ00,2020,34617,,343,,410,,-67,2348,,292,2056,2146,,199,-10,1947,202,132,,34749
232877,4000,Female,GM0502,Capelle aan den IJssel,2021JJ00,2021,34749,,330,,350,,-20,2238,,359,1879,2311,,239,-27,2072,-73,-92,,34657
232878,4000,Female,GM0502,Capelle aan den IJssel,2022JJ00,2022,34657,,286,,347,,-61,2598,,645,1953,2338,,287,-31,2051,260,200,,34857
232879,4000,Female,GM0502,Capelle aan den IJssel,2023JJ00,2023,34857,,305,,360,,-55,2585,,568,2017,2340,,282,-18,2058,245,189,,35046
232950,4000,Female,GM0383,Castricum,2012JJ00,2012,17621,,105,,165,,-60,553,,59,494,556,,53,-16,503,-3,-63,,17558
232951,4000,Female,GM0383,Castricum,2013JJ00,2013,17558,,118,,162,,-44,564,,45,519,586,,36,-2,550,-22,-66,,17492
232952,4000,Female,GM0383,Castricum,2014JJ00,2014,17492,,131,,166,,-35,688,,62,626,627,,40,0,587,61,28,,17520
232953,4000,Female,GM0383,Castricum,2015JJ00,2015,17520,,120,,166,,-46,791,,48,743,608,,41,0,567,183,139,,17659
232954,4000,Female,GM0383,Castricum,2016JJ00,2016,17659,,128,,189,,-61,1047,,76,971,682,,62,0,620,365,303,,17962
232955,4000,Female,GM0383,Castricum,2017JJ00,2017,17962,,141,,201,,-60,959,,52,907,742,,64,-5,678,217,156,,18118
232956,4000,Female,GM0383,Castricum,2018JJ00,2018,18118,,119,,184,,-65,712,,66,646,627,,67,-4,560,85,20,,18138
232957,4000,Female,GM0383,Castricum,2019JJ00,2019,18138,,142,,180,,-38,776,,71,705,643,,41,1,602,133,94,,18232
232958,4000,Female,GM0383,Castricum,2020JJ00,2020,18232,,150,,216,,-66,882,,77,805,769,,42,2,727,113,48,,18280
232959,4000,Female,GM0383,Castricum,2021JJ00,2021,18280,,151,,168,,-17,861,,56,805,745,,52,0,693,116,99,,18379
232960,4000,Female,GM0383,Castricum,2022JJ00,2022,18379,,142,,204,,-62,857,,134,723,732,,71,-2,661,125,63,,18442
232961,4000,Female,GM0383,Castricum,2023JJ00,2023,18442,,147,,217,,-70,820,,70,750,742,,71,-6,671,78,4,,18446
233196,4000,Female,GM0109,Coevorden,2012JJ00,2012,17967,,150,,176,,-26,863,,187,676,851,,74,-28,777,12,-12,,17955
233197,4000,Female,GM0109,Coevorden,2013JJ00,2013,17955,,157,,181,,-24,957,,226,731,881,,80,-26,801,76,54,,18009
233198,4000,Female,GM0109,Coevorden,2014JJ00,2014,18009,,136,,215,,-79,828,,207,621,920,,72,-21,848,-92,-163,,17846
233199,4000,Female,GM0109,Coevorden,2015JJ00,2015,17846,,137,,213,,-76,899,,202,697,935,,71,-21,864,-36,-108,,17738
233200,4000,Female,GM0109,Coevorden,2016JJ00,2016,17738,,151,,219,,-68,848,,151,697,828,,61,-12,767,20,-46,,17692
233201,4000,Female,GM0109,Coevorden,2017JJ00,2017,17692,,145,,193,,-48,1058,,89,969,970,,53,0,917,88,41,,17733
233202,4000,Female,GM0109,Coevorden,2018JJ00,2018,17733,,129,,232,,-103,1043,,100,943,893,,50,-2,843,150,47,,17780
233203,4000,Female,GM0109,Coevorden,2019JJ00,2019,17780,,143,,211,,-68,965,,65,900,971,,104,-30,867,-6,-76,,17704
233204,4000,Female,GM0109,Coevorden,2020JJ00,2020,17704,,134,,246,,-112,959,,65,894,859,,51,-8,808,100,-13,,17691
233205,4000,Female,GM0109,Coevorden,2021JJ00,2021,17691,,137,,242,,-105,990,,50,940,826,,43,-7,783,164,58,,17749
233206,4000,Female,GM0109,Coevorden,2022JJ00,2022,17749,,128,,229,,-101,1012,,209,803,835,,73,1,762,177,74,,17823
233207,4000,Female,GM0109,Coevorden,2023JJ00,2023,17823,,123,,219,,-96,960,,100,860,936,,102,-6,834,24,-73,,17750
233360,4000,Female,GM1706,Cranendonck,2012JJ00,2012,10094,,87,,74,,13,306,,67,239,343,,52,-3,291,-37,-23,,10071
233361,4000,Female,GM1706,Cranendonck,2013JJ00,2013,10071,,83,,94,,-11,341,,58,283,319,,53,1,266,22,10,,10081
233362,4000,Female,GM1706,Cranendonck,2014JJ00,2014,10081,,79,,84,,-5,448,,144,304,319,,53,-8,266,129,124,,10205
233363,4000,Female,GM1706,Cranendonck,2015JJ00,2015,10205,,93,,89,,4,533,,257,276,503,,39,2,464,30,36,,10241
233364,4000,Female,GM1706,Cranendonck,2016JJ00,2016,10241,,89,,85,,4,1550,,1035,515,1527,,58,-5,1469,23,31,,10272
233365,4000,Female,GM1706,Cranendonck,2017JJ00,2017,10272,,89,,116,,-27,1597,,1256,341,1711,,63,-12,1648,-114,-143,,10129
233366,4000,Female,GM1706,Cranendonck,2018JJ00,2018,10129,,73,,98,,-25,607,,321,286,551,,52,1,499,56,30,,10159
233367,4000,Female,GM1706,Cranendonck,2019JJ00,2019,10159,,77,,93,,-16,1350,,929,421,1014,,53,7,961,336,323,,10482
233368,4000,Female,GM1706,Cranendonck,2020JJ00,2020,10482,,88,,120,,-32,1281,,892,389,1390,,50,6,1340,-109,-136,,10346
233369,4000,Female,GM1706,Cranendonck,2021JJ00,2021,10346,,70,,128,,-58,1768,,1446,322,1848,,42,7,1806,-80,-123,,10223
233370,4000,Female,GM1706,Cranendonck,2022JJ00,2022,10223,,77,,116,,-39,3064,,2656,408,2949,,90,1,2859,115,93,,10316
233371,4000,Female,GM1706,Cranendonck,2023JJ00,2023,10316,,77,,113,,-36,3754,,3307,447,3780,,64,-8,3716,-26,-50,,10266
233442,4000,Female,GM0611,Cromstrijen,2012JJ00,2012,6435,,50,,45,,5,215,,14,201,224,,23,-6,201,-9,-4,,6431
233443,4000,Female,GM0611,Cromstrijen,2013JJ00,2013,6431,,54,,62,,-8,217,,12,205,233,,17,-1,216,-16,-24,,6407
233444,4000,Female,GM0611,Cromstrijen,2014JJ00,2014,6407,,52,,56,,-4,254,,20,234,247,,17,-5,230,7,3,,6410
233445,4000,Female,GM0611,Cromstrijen,2015JJ00,2015,6410,,58,,50,,8,251,,20,231,249,,20,-1,229,2,12,,6422
233446,4000,Female,GM0611,Cromstrijen,2016JJ00,2016,6422,,54,,53,,1,287,,12,275,258,,5,3,253,29,30,,6452
233447,4000,Female,GM0611,Cromstrijen,2017JJ00,2017,6452,,47,,64,,-17,307,,19,288,264,,14,-2,250,43,27,,6479
233448,4000,Female,GM0611,Cromstrijen,2018JJ00,2018,6479,,46,,59,,-13,311,,16,295,262,,13,-3,249,49,34,,6513
233524,4000,Female,GM1684,Cuijk,2012JJ00,2012,12320,,105,,90,,15,465,,53,412,411,,58,-9,353,54,69,,12389
233525,4000,Female,GM1684,Cuijk,2013JJ00,2013,12389,,113,,89,,24,394,,46,348,400,,43,3,357,-6,18,,12407
233526,4000,Female,GM1684,Cuijk,2014JJ00,2014,12407,,90,,84,,6,415,,45,370,497,,63,3,434,-82,-76,,12331
233527,4000,Female,GM1684,Cuijk,2015JJ00,2015,12331,,114,,89,,25,475,,52,423,452,,59,-11,393,23,48,,12379
233528,4000,Female,GM1684,Cuijk,2016JJ00,2016,12379,,117,,121,,-4,484,,70,414,473,,36,-6,437,11,7,,12386
233529,4000,Female,GM1684,Cuijk,2017JJ00,2017,12386,,112,,93,,19,611,,57,554,512,,37,1,475,99,117,,12503
233530,4000,Female,GM1684,Cuijk,2018JJ00,2018,12503,,108,,115,,-7,562,,56,506,541,,58,-1,483,21,15,,12518
233531,4000,Female,GM1684,Cuijk,2019JJ00,2019,12518,,88,,106,,-18,592,,62,530,512,,55,-6,457,80,59,,12577
233532,4000,Female,GM1684,Cuijk,2020JJ00,2020,12577,,99,,136,,-37,648,,82,566,473,,39,-5,434,175,138,,12715
233533,4000,Female,GM1684,Cuijk,2021JJ00,2021,12715,,122,,113,,9,595,,75,520,461,,41,-2,420,134,138,,12853
233688,4000,Female,GM0216,Culemborg,2012JJ00,2012,13945,,123,,98,,25,500,,61,439,532,,54,6,478,-32,-8,,13937
233689,4000,Female,GM0216,Culemborg,2013JJ00,2013,13937,,125,,114,,11,494,,64,430,535,,71,-7,464,-41,-29,,13908
233690,4000,Female,GM0216,Culemborg,2014JJ00,2014,13908,,138,,107,,31,547,,71,476,590,,45,4,545,-43,-10,,13898
233691,4000,Female,GM0216,Culemborg,2015JJ00,2015,13898,,123,,130,,-7,616,,68,548,595,,68,-5,527,21,15,,13913
233692,4000,Female,GM0216,Culemborg,2016JJ00,2016,13913,,120,,124,,-4,691,,52,639,595,,50,9,545,96,90,,14003
233693,4000,Female,GM0216,Culemborg,2017JJ00,2017,14003,,119,,103,,16,798,,64,734,593,,42,-8,551,205,223,,14226
233694,4000,Female,GM0216,Culemborg,2018JJ00,2018,14226,,138,,133,,5,780,,76,704,606,,36,-6,570,174,182,,14408
233695,4000,Female,GM0216,Culemborg,2019JJ00,2019,14408,,131,,132,,-1,810,,103,707,636,,30,2,606,174,173,,14581
233696,4000,Female,GM0216,Culemborg,2020JJ00,2020,14581,,140,,119,,21,752,,60,692,666,,44,-8,622,86,103,,14684
233697,4000,Female,GM0216,Culemborg,2021JJ00,2021,14684,,173,,138,,35,751,,75,676,643,,48,-4,595,108,142,,14826
233698,4000,Female,GM0216,Culemborg,2022JJ00,2022,14826,,148,,153,,-5,821,,103,718,663,,61,1,602,158,152,,14978
233699,4000,Female,GM0216,Culemborg,2023JJ00,2023,14978,,145,,101,,44,781,,102,679,684,,49,-3,635,97,140,,15118
233852,4000,Female,GM0148,Dalfsen,2012JJ00,2012,13499,,143,,82,,61,454,,40,414,430,,28,0,402,24,85,,13584
233853,4000,Female,GM0148,Dalfsen,2013JJ00,2013,13584,,147,,99,,48,501,,39,462,473,,29,-4,444,28,74,,13658
233854,4000,Female,GM0148,Dalfsen,2014JJ00,2014,13658,,130,,113,,17,498,,32,466,508,,36,-9,472,-10,8,,13666
233855,4000,Female,GM0148,Dalfsen,2015JJ00,2015,13666,,146,,115,,31,570,,39,531,489,,38,-2,451,81,112,,13778
233856,4000,Female,GM0148,Dalfsen,2016JJ00,2016,13778,,142,,101,,41,567,,32,535,536,,47,-6,489,31,72,,13850
233857,4000,Female,GM0148,Dalfsen,2017JJ00,2017,13850,,147,,122,,25,661,,37,624,576,,27,0,549,85,113,,13963
233858,4000,Female,GM0148,Dalfsen,2018JJ00,2018,13963,,129,,109,,20,676,,47,629,555,,25,1,530,121,141,,14104
233859,4000,Female,GM0148,Dalfsen,2019JJ00,2019,14104,,129,,110,,19,569,,30,539,547,,33,-2,514,22,42,,14146
233860,4000,Female,GM0148,Dalfsen,2020JJ00,2020,14146,,123,,123,,0,701,,50,651,550,,34,-2,516,151,152,,14298
233861,4000,Female,GM0148,Dalfsen,2021JJ00,2021,14298,,128,,131,,-3,614,,31,583,499,,47,1,452,115,113,,14411
233862,4000,Female,GM0148,Dalfsen,2022JJ00,2022,14411,,125,,127,,-2,815,,287,528,562,,111,-1,451,253,251,,14662
233863,4000,Female,GM0148,Dalfsen,2023JJ00,2023,14662,,113,,125,,-12,688,,113,575,647,,76,-2,571,41,29,,14691
234016,4000,Female,GM1891,Dantumadiel,2012JJ00,2012,9618,,95,,100,,-5,278,,10,268,345,,16,0,329,-67,-72,,9546
234017,4000,Female,GM1891,Dantumadiel,2013JJ00,2013,9546,,90,,105,,-15,317,,9,308,358,,5,0,353,-41,-57,,9489
234018,4000,Female,GM1891,Dantumadiel,2014JJ00,2014,9489,,94,,123,,-29,356,,12,344,313,,17,-2,296,43,15,,9504
234019,4000,Female,GM1891,Dantumadiel,2015JJ00,2015,9504,,94,,95,,-1,338,,8,330,360,,10,1,350,-22,-23,,9481
234020,4000,Female,GM1891,Dantumadiel,2016JJ00,2016,9481,,73,,105,,-32,365,,19,346,407,,13,-1,394,-42,-75,,9406
234021,4000,Female,GM1891,Dantumadiel,2017JJ00,2017,9406,,98,,125,,-27,389,,21,368,378,,10,0,368,11,-17,,9389
234022,4000,Female,GM1891,Dantumadiel,2018JJ00,2018,9389,,109,,126,,-17,421,,11,410,384,,17,-4,367,37,19,,9408
234023,4000,Female,GM1891,Dantumadiel,2019JJ00,2019,9408,,91,,101,,-10,411,,20,391,419,,7,2,412,-8,-17,,9391
234024,4000,Female,GM1891,Dantumadiel,2020JJ00,2020,9391,,85,,99,,-14,404,,16,388,366,,5,0,361,38,23,,9414
234025,4000,Female,GM1891,Dantumadiel,2021JJ00,2021,9414,,81,,134,,-53,404,,15,389,355,,10,0,345,49,-4,,9410
234026,4000,Female,GM1891,Dantumadiel,2022JJ00,2022,9410,,96,,116,,-20,535,,108,427,369,,32,-2,337,166,146,,9556
234027,4000,Female,GM1891,Dantumadiel,2023JJ00,2023,9556,,92,,105,,-13,429,,90,339,466,,42,0,424,-37,-50,,9506
234180,4000,Female,GM0503,Delft,2012JJ00,2012,46375,,423,,381,,42,3366,,1172,2194,3320,,1027,-320,2293,46,87,,46462
234181,4000,Female,GM0503,Delft,2013JJ00,2013,46462,,486,,410,,76,3426,,1182,2244,3308,,971,-216,2337,118,191,,46653
234182,4000,Female,GM0503,Delft,2014JJ00,2014,46653,,430,,369,,61,3811,,1302,2509,3528,,1040,-221,2488,283,342,,46995
234183,4000,Female,GM0503,Delft,2015JJ00,2015,46995,,444,,372,,72,3853,,1441,2412,3818,,1173,-348,2645,35,101,,47096
234184,4000,Female,GM0503,Delft,2016JJ00,2016,47096,,506,,389,,117,4213,,1535,2678,4025,,1136,-277,2889,188,290,,47386
234185,4000,Female,GM0503,Delft,2017JJ00,2017,47386,,423,,366,,57,4519,,1652,2867,4149,,1186,-239,2963,370,419,,47805
234186,4000,Female,GM0503,Delft,2018JJ00,2018,47805,,436,,388,,48,4563,,1791,2772,4091,,1170,-148,2921,472,527,,48332
234187,4000,Female,GM0503,Delft,2019JJ00,2019,48332,,463,,377,,86,4696,,1847,2849,4245,,1147,-162,3098,451,530,,48862
234188,4000,Female,GM0503,Delft,2020JJ00,2020,48862,,431,,402,,29,4521,,1423,3098,4480,,1286,-241,3194,41,62,,48924
234189,4000,Female,GM0503,Delft,2021JJ00,2021,48924,,440,,408,,32,4995,,1738,3257,4623,,1020,-141,3603,372,400,,49324
234190,4000,Female,GM0503,Delft,2022JJ00,2022,49324,,406,,434,,-28,5168,,2125,3043,4422,,1050,-92,3372,746,710,,50034
234191,4000,Female,GM0503,Delft,2023JJ00,2023,50034,,393,,387,,6,6060,,1906,4154,4635,,1128,-107,3507,1425,1435,,51469
234262,4000,Female,GM0010,Delfzijl,2012JJ00,2012,13150,,103,,175,,-72,515,,143,372,603,,69,-24,534,-88,-157,,12993
234263,4000,Female,GM0010,Delfzijl,2013JJ00,2013,12993,,92,,160,,-68,549,,136,413,641,,79,-27,562,-92,-158,,12835
234264,4000,Female,GM0010,Delfzijl,2014JJ00,2014,12835,,117,,171,,-54,587,,188,399,729,,45,-9,684,-142,-197,,12638
234265,4000,Female,GM0010,Delfzijl,2015JJ00,2015,12638,,96,,181,,-85,689,,211,478,746,,63,-10,683,-57,-141,,12497
234266,4000,Female,GM0010,Delfzijl,2016JJ00,2016,12497,,119,,159,,-40,749,,140,609,800,,47,-16,753,-51,-92,,12405
234267,4000,Female,GM0010,Delfzijl,2017JJ00,2017,12405,,113,,150,,-37,766,,83,683,743,,52,-18,691,23,-17,,12388
234268,4000,Female,GM0010,Delfzijl,2018JJ00,2018,12388,,72,,173,,-101,685,,131,554,665,,43,-5,622,20,-80,,12308
234269,4000,Female,GM0010,Delfzijl,2019JJ00,2019,12308,,104,,148,,-44,713,,128,585,727,,54,-17,673,-14,-59,,12249
234270,4000,Female,GM0010,Delfzijl,2020JJ00,2020,12249,,70,,143,,-73,666,,107,559,648,,40,-4,608,18,-55,,12194
234426,4000,Female,GM0762,Deurne,2012JJ00,2012,15762,,131,,116,,15,552,,38,514,565,,42,-1,523,-13,1,,15763
234427,4000,Female,GM0762,Deurne,2013JJ00,2013,15763,,136,,104,,32,562,,60,502,591,,38,-2,553,-29,2,,15765
234428,4000,Female,GM0762,Deurne,2014JJ00,2014,15765,,148,,130,,18,616,,76,540,584,,53,1,531,32,51,,15816
234429,4000,Female,GM0762,Deurne,2015JJ00,2015,15816,,138,,137,,1,596,,81,515,573,,56,-5,517,23,24,,15840
234430,4000,Female,GM0762,Deurne,2016JJ00,2016,15840,,153,,139,,14,605,,86,519,598,,55,-6,543,7,22,,15862
234431,4000,Female,GM0762,Deurne,2017JJ00,2017,15862,,134,,161,,-27,709,,78,631,589,,44,-11,545,120,95,,15957
234432,4000,Female,GM0762,Deurne,2018JJ00,2018,15957,,157,,154,,3,643,,60,583,542,,68,-9,474,101,103,,16060
234433,4000,Female,GM0762,Deurne,2019JJ00,2019,16060,,154,,164,,-10,578,,57,521,522,,51,-6,471,56,47,,16107
234434,4000,Female,GM0762,Deurne,2020JJ00,2020,16107,,147,,161,,-14,530,,66,464,515,,46,-1,469,15,2,,16109
234435,4000,Female,GM0762,Deurne,2021JJ00,2021,16109,,169,,190,,-21,623,,72,551,526,,35,0,491,97,76,,16185
234436,4000,Female,GM0762,Deurne,2022JJ00,2022,16185,,124,,167,,-43,679,,150,529,477,,59,-6,418,202,160,,16345
234437,4000,Female,GM0762,Deurne,2023JJ00,2023,16345,,137,,168,,-31,683,,133,550,537,,72,-14,465,146,118,,16463
234508,4000,Female,GM0150,Deventer,2012JJ00,2012,50120,,585,,470,,115,2001,,515,1486,2199,,388,-90,1811,-198,-84,,50036
234509,4000,Female,GM0150,Deventer,2013JJ00,2013,50036,,561,,459,,102,2040,,504,1536,2317,,451,-132,1866,-277,-171,,49865
234510,4000,Female,GM0150,Deventer,2014JJ00,2014,49865,,527,,455,,72,2233,,534,1699,2320,,410,-87,1910,-87,-13,,49852
234511,4000,Female,GM0150,Deventer,2015JJ00,2015,49852,,489,,446,,43,2349,,522,1827,2307,,373,-54,1934,42,79,,49931
234512,4000,Female,GM0150,Deventer,2016JJ00,2016,49931,,530,,419,,111,2542,,556,1986,2350,,331,-78,2019,192,300,,50231
234513,4000,Female,GM0150,Deventer,2017JJ00,2017,50231,,472,,456,,16,2645,,431,2214,2520,,313,-69,2207,125,145,,50376
234514,4000,Female,GM0150,Deventer,2018JJ00,2018,50376,,495,,459,,36,2469,,496,1973,2347,,277,-43,2070,122,151,,50527
234515,4000,Female,GM0150,Deventer,2019JJ00,2019,50527,,467,,501,,-34,2657,,556,2101,2188,,335,-29,1853,469,429,,50956
234516,4000,Female,GM0150,Deventer,2020JJ00,2020,50956,,467,,517,,-50,2469,,375,2094,2173,,218,-12,1955,296,248,,51204
234517,4000,Female,GM0150,Deventer,2021JJ00,2021,51204,,457,,510,,-53,2352,,360,1992,2248,,256,-37,1992,104,46,,51250
234518,4000,Female,GM0150,Deventer,2022JJ00,2022,51250,,502,,525,,-23,2840,,795,2045,2136,,271,-46,1865,704,677,,51927
234519,4000,Female,GM0150,Deventer,2023JJ00,2023,51927,,478,,513,,-35,2644,,592,2052,2367,,395,-113,1972,277,232,,52159
234672,4000,Female,GM0384,Diemen,2012JJ00,2012,12890,,123,,87,,36,1197,,295,902,1133,,240,-27,893,64,102,,12992
234673,4000,Female,GM0384,Diemen,2013JJ00,2013,12992,,117,,96,,21,1569,,328,1241,1270,,313,-77,957,299,323,,13315
234674,4000,Female,GM0384,Diemen,2014JJ00,2014,13315,,103,,110,,-7,1649,,344,1305,1353,,323,-28,1030,296,291,,13606
234675,4000,Female,GM0384,Diemen,2015JJ00,2015,13606,,122,,99,,23,1550,,349,1201,1498,,334,-72,1164,52,68,,13674
234676,4000,Female,GM0384,Diemen,2016JJ00,2016,13674,,143,,98,,45,1840,,454,1386,1541,,317,-38,1224,299,347,,14021
234677,4000,Female,GM0384,Diemen,2017JJ00,2017,14021,,131,,118,,13,1911,,456,1455,1551,,289,-30,1262,360,375,,14396
234678,4000,Female,GM0384,Diemen,2018JJ00,2018,14396,,148,,93,,55,2070,,538,1532,1581,,342,-32,1239,489,537,,14933
234679,4000,Female,GM0384,Diemen,2019JJ00,2019,14933,,146,,113,,33,2446,,813,1633,1676,,319,-22,1357,770,798,,15731
234680,4000,Female,GM0384,Diemen,2020JJ00,2020,15731,,159,,112,,47,2405,,638,1767,2184,,477,-35,1707,221,266,,15997
234681,4000,Female,GM0384,Diemen,2021JJ00,2021,15997,,165,,108,,57,2444,,860,1584,2272,,405,-50,1867,172,228,,16225
234682,4000,Female,GM0384,Diemen,2022JJ00,2022,16225,,164,,126,,38,2943,,1230,1713,2436,,606,-87,1830,507,539,,16764
234683,4000,Female,GM0384,Diemen,2023JJ00,2023,16764,,168,,136,,32,2265,,780,1485,2177,,482,-64,1695,88,116,,16880
235092,4000,Female,GM1980,Dijk en Waard,2022JJ00,2022,43690,,404,,373,,31,2603,,546,2057,1951,,243,-55,1708,652,678,,44368
235093,4000,Female,GM1980,Dijk en Waard,2023JJ00,2023,44368,,440,,335,,105,2542,,425,2117,2032,,316,-139,1716,510,618,,44986
235164,4000,Female,GM1774,Dinkelland,2012JJ00,2012,12826,,103,,114,,-11,375,,42,333,369,,18,8,351,6,-6,,12820
235165,4000,Female,GM1774,Dinkelland,2013JJ00,2013,12820,,87,,129,,-42,289,,27,262,365,,29,1,336,-76,-118,,12702
235166,4000,Female,GM1774,Dinkelland,2014JJ00,2014,12702,,116,,111,,5,417,,50,367,400,,34,-1,366,17,23,,12725
235167,4000,Female,GM1774,Dinkelland,2015JJ00,2015,12725,,112,,123,,-11,534,,129,405,446,,28,-2,418,88,77,,12802
235168,4000,Female,GM1774,Dinkelland,2016JJ00,2016,12802,,91,,128,,-37,541,,92,449,474,,26,1,448,67,30,,12832
235169,4000,Female,GM1774,Dinkelland,2017JJ00,2017,12832,,113,,138,,-25,523,,34,489,455,,45,-5,410,68,42,,12874
235170,4000,Female,GM1774,Dinkelland,2018JJ00,2018,12874,,99,,138,,-39,488,,42,446,405,,24,-1,381,83,44,,12918
235171,4000,Female,GM1774,Dinkelland,2019JJ00,2019,12918,,97,,121,,-24,439,,46,393,385,,31,-4,354,54,30,,12948
235172,4000,Female,GM1774,Dinkelland,2020JJ00,2020,12948,,137,,164,,-27,478,,47,431,396,,22,-1,374,82,53,,13001
235173,4000,Female,GM1774,Dinkelland,2021JJ00,2021,13001,,130,,155,,-25,421,,28,393,410,,21,-1,389,11,-15,,12986
235174,4000,Female,GM1774,Dinkelland,2022JJ00,2022,12986,,126,,148,,-22,506,,158,348,404,,60,-2,344,102,79,,13065
235175,4000,Female,GM1774,Dinkelland,2023JJ00,2023,13065,,144,,170,,-26,492,,84,408,490,,44,-7,446,2,-23,,13042
235492,4000,Female,GM0504,Dirksland,2012JJ00,2012,4239,,38,,39,,-1,146,,8,138,147,,0,3,147,-1,12,,4251
235656,4000,Female,GM0221,Doesburg,2012JJ00,2012,5942,,39,,64,,-25,268,,17,251,292,,16,1,276,-24,-49,,5893
235657,4000,Female,GM0221,Doesburg,2013JJ00,2013,5893,,46,,43,,3,219,,25,194,279,,21,-5,258,-60,-57,,5836
235658,4000,Female,GM0221,Doesburg,2014JJ00,2014,5836,,49,,60,,-11,247,,22,225,260,,32,-6,228,-13,-24,,5812
235659,4000,Female,GM0221,Doesburg,2015JJ00,2015,5812,,42,,49,,-7,280,,9,271,273,,21,1,252,7,-1,,5811
235660,4000,Female,GM0221,Doesburg,2016JJ00,2016,5811,,25,,56,,-31,314,,27,287,297,,19,-2,278,17,-14,,5797
235661,4000,Female,GM0221,Doesburg,2017JJ00,2017,5797,,38,,64,,-26,344,,24,320,325,,20,0,305,19,-8,,5789
235662,4000,Female,GM0221,Doesburg,2018JJ00,2018,5789,,28,,46,,-18,248,,24,224,329,,18,-1,311,-81,-99,,5690
235663,4000,Female,GM0221,Doesburg,2019JJ00,2019,5690,,30,,40,,-10,273,,33,240,286,,17,-4,269,-13,-23,,5667
235664,4000,Female,GM0221,Doesburg,2020JJ00,2020,5667,,37,,73,,-36,353,,35,318,304,,6,1,298,49,13,,5680
235665,4000,Female,GM0221,Doesburg,2021JJ00,2021,5680,,34,,62,,-28,280,,23,257,255,,10,0,245,25,-3,,5677
235666,4000,Female,GM0221,Doesburg,2022JJ00,2022,5677,,29,,69,,-40,332,,37,295,288,,25,-4,263,44,4,,5681
235667,4000,Female,GM0221,Doesburg,2023JJ00,2023,5681,,49,,76,,-27,336,,59,277,319,,28,-1,291,17,-10,,5671
235738,4000,Female,GM0222,Doetinchem,2012JJ00,2012,28398,,287,,276,,11,1143,,99,1044,1004,,87,-19,917,139,150,,28548
235739,4000,Female,GM0222,Doetinchem,2013JJ00,2013,28548,,237,,249,,-12,1122,,62,1060,1152,,89,-2,1063,-30,-42,,28506
235740,4000,Female,GM0222,Doetinchem,2014JJ00,2014,28506,,291,,245,,46,1134,,86,1048,1108,,97,-12,1011,26,68,,28574
235741,4000,Female,GM0222,Doetinchem,2015JJ00,2015,28574,,268,,303,,-35,1186,,100,1086,1096,,88,-11,1008,90,55,,28629
235742,4000,Female,GM0222,Doetinchem,2016JJ00,2016,28629,,258,,277,,-19,1737,,513,1224,1539,,103,-7,1436,198,180,,28809
235743,4000,Female,GM0222,Doetinchem,2017JJ00,2017,28809,,258,,287,,-29,1451,,104,1347,1283,,87,3,1196,168,139,,28948
235744,4000,Female,GM0222,Doetinchem,2018JJ00,2018,28948,,259,,321,,-62,1297,,98,1199,1186,,60,1,1126,111,49,,28997
235745,4000,Female,GM0222,Doetinchem,2019JJ00,2019,28997,,265,,271,,-6,1419,,112,1307,1195,,57,5,1138,224,213,,29210
235746,4000,Female,GM0222,Doetinchem,2020JJ00,2020,29210,,246,,284,,-38,1364,,107,1257,1186,,73,-12,1113,178,141,,29351
235747,4000,Female,GM0222,Doetinchem,2021JJ00,2021,29351,,252,,322,,-70,1330,,100,1230,1132,,70,2,1062,198,133,,29484
235748,4000,Female,GM0222,Doetinchem,2022JJ00,2022,29484,,257,,304,,-47,1534,,254,1280,1146,,123,-10,1023,388,336,,29820
235749,4000,Female,GM0222,Doetinchem,2023JJ00,2023,29820,,245,,325,,-80,1357,,172,1185,1148,,94,-8,1054,209,128,,29948
235984,4000,Female,GM0766,Dongen,2012JJ00,2012,12706,,115,,107,,8,440,,44,396,363,,39,-4,324,77,86,,12792
235985,4000,Female,GM0766,Dongen,2013JJ00,2013,12792,,107,,108,,-1,391,,51,340,431,,48,-2,383,-40,-41,,12751
235986,4000,Female,GM0766,Dongen,2014JJ00,2014,12751,,110,,99,,11,421,,38,383,415,,32,-4,383,6,19,,12770
235987,4000,Female,GM0766,Dongen,2015JJ00,2015,12770,,107,,142,,-35,502,,43,459,465,,52,0,413,37,2,,12772
235988,4000,Female,GM0766,Dongen,2016JJ00,2016,12772,,94,,120,,-26,510,,54,456,476,,35,3,441,34,8,,12780
235989,4000,Female,GM0766,Dongen,2017JJ00,2017,12780,,134,,124,,10,626,,37,589,516,,45,-3,471,110,121,,12901
235990,4000,Female,GM0766,Dongen,2018JJ00,2018,12901,,129,,132,,-3,569,,57,512,443,,26,2,417,126,121,,13022
235991,4000,Female,GM0766,Dongen,2019JJ00,2019,13022,,130,,140,,-10,558,,54,504,443,,37,-3,406,115,105,,13127
235992,4000,Female,GM0766,Dongen,2020JJ00,2020,13127,,123,,156,,-33,604,,56,548,550,,42,0,508,54,22,,13149
235993,4000,Female,GM0766,Dongen,2021JJ00,2021,13149,,128,,167,,-39,537,,61,476,432,,43,-4,389,105,66,,13215
235994,4000,Female,GM0766,Dongen,2022JJ00,2022,13215,,135,,170,,-35,947,,376,571,525,,107,-21,418,422,387,,13602
235995,4000,Female,GM0766,Dongen,2023JJ00,2023,13602,,142,,137,,5,576,,82,494,600,,155,-11,445,-24,-21,,13581
236066,4000,Female,GM0058,Dongeradeel,2012JJ00,2012,12094,,153,,112,,41,330,,19,311,387,,25,-3,362,-57,-16,,12078
236067,4000,Female,GM0058,Dongeradeel,2013JJ00,2013,12078,,118,,106,,12,374,,30,344,387,,19,1,368,-13,-1,,12077
236068,4000,Female,GM0058,Dongeradeel,2014JJ00,2014,12077,,119,,125,,-6,332,,21,311,422,,25,1,397,-90,-97,,11980
236069,4000,Female,GM0058,Dongeradeel,2015JJ00,2015,11980,,130,,111,,19,366,,30,336,407,,14,1,393,-41,-22,,11958
236070,4000,Female,GM0058,Dongeradeel,2016JJ00,2016,11958,,110,,107,,3,438,,32,406,444,,31,-2,413,-6,-4,,11954
236071,4000,Female,GM0058,Dongeradeel,2017JJ00,2017,11954,,122,,122,,0,403,,20,383,451,,20,0,431,-48,-47,,11907
236072,4000,Female,GM0058,Dongeradeel,2018JJ00,2018,11907,,122,,120,,2,434,,38,396,413,,21,-3,392,21,28,,11935
236394,4000,Female,GM0505,Dordrecht,2012JJ00,2012,60309,,674,,592,,82,2279,,514,1765,2586,,531,-109,2055,-307,-226,,60083
236395,4000,Female,GM0505,Dordrecht,2013JJ00,2013,60083,,650,,596,,54,2296,,506,1790,2300,,412,-1,1888,-4,54,,60137
236396,4000,Female,GM0505,Dordrecht,2014JJ00,2014,60137,,681,,522,,159,2308,,451,1857,2351,,447,-79,1904,-43,116,,60253
236397,4000,Female,GM0505,Dordrecht,2015JJ00,2015,60253,,633,,563,,70,2312,,432,1880,2423,,409,-60,2014,-111,-34,,60219
236398,4000,Female,GM0505,Dordrecht,2016JJ00,2016,60219,,586,,616,,-30,2266,,380,1886,2410,,330,-40,2080,-144,-172,,60047
236399,4000,Female,GM0505,Dordrecht,2017JJ00,2017,60047,,595,,590,,5,2473,,436,2037,2669,,392,-67,2277,-196,-198,,59849
236400,4000,Female,GM0505,Dordrecht,2018JJ00,2018,59849,,601,,560,,41,2614,,516,2098,2522,,393,-95,2129,92,134,,59983
236401,4000,Female,GM0505,Dordrecht,2019JJ00,2019,59983,,553,,553,,0,2622,,563,2059,2364,,316,-25,2048,258,257,,60240
236402,4000,Female,GM0505,Dordrecht,2020JJ00,2020,60240,,569,,630,,-61,2506,,480,2026,2585,,268,-32,2317,-79,-144,,60096
236403,4000,Female,GM0505,Dordrecht,2021JJ00,2021,60096,,643,,678,,-35,2764,,459,2305,2593,,331,-32,2262,171,136,,60232
236404,4000,Female,GM0505,Dordrecht,2022JJ00,2022,60232,,586,,635,,-49,3467,,1255,2212,2485,,440,-75,2045,982,938,,61170
236405,4000,Female,GM0505,Dordrecht,2023JJ00,2023,61170,,568,,608,,-40,3149,,746,2403,2744,,538,-183,2206,405,356,,61526
236476,4000,Female,GM0498,Drechterland,2012JJ00,2012,9504,,89,,86,,3,435,,52,383,433,,34,-8,399,2,5,,9509
236477,4000,Female,GM0498,Drechterland,2013JJ00,2013,9509,,81,,73,,8,405,,46,359,409,,37,0,372,-4,4,,9513
236478,4000,Female,GM0498,Drechterland,2014JJ00,2014,9513,,82,,71,,11,468,,79,389,459,,51,1,408,9,22,,9535
236479,4000,Female,GM0498,Drechterland,2015JJ00,2015,9535,,86,,70,,16,514,,67,447,477,,35,-5,442,37,54,,9589
236480,4000,Female,GM0498,Drechterland,2016JJ00,2016,9589,,98,,93,,5,505,,54,451,550,,50,-10,500,-45,-40,,9549
236481,4000,Female,GM0498,Drechterland,2017JJ00,2017,9549,,91,,77,,14,530,,53,477,506,,46,-1,460,24,36,,9585
236482,4000,Female,GM0498,Drechterland,2018JJ00,2018,9585,,94,,74,,20,560,,55,505,484,,33,-5,451,76,93,,9678
236483,4000,Female,GM0498,Drechterland,2019JJ00,2019,9678,,84,,70,,14,551,,46,505,514,,34,-2,480,37,51,,9729
236484,4000,Female,GM0498,Drechterland,2020JJ00,2020,9729,,101,,84,,17,563,,68,495,505,,34,-4,471,58,74,,9803
236485,4000,Female,GM0498,Drechterland,2021JJ00,2021,9803,,97,,76,,21,530,,55,475,457,,45,-3,412,73,95,,9898
236486,4000,Female,GM0498,Drechterland,2022JJ00,2022,9898,,77,,93,,-16,749,,195,554,540,,97,-3,443,209,195,,10093
236487,4000,Female,GM0498,Drechterland,2023JJ00,2023,10093,,78,,90,,-12,623,,99,524,552,,93,-21,459,71,60,,10153
237050,4000,Female,GM1719,Drimmelen,2012JJ00,2012,13329,,103,,106,,-3,416,,53,363,391,,33,-4,358,25,23,,13352
237051,4000,Female,GM1719,Drimmelen,2013JJ00,2013,13352,,116,,119,,-3,400,,48,352,387,,28,7,359,13,10,,13362
237052,4000,Female,GM1719,Drimmelen,2014JJ00,2014,13362,,101,,116,,-15,444,,68,376,442,,47,-6,395,2,-14,,13348
237053,4000,Female,GM1719,Drimmelen,2015JJ00,2015,13348,,92,,125,,-33,512,,79,433,446,,34,1,412,66,33,,13381
237054,4000,Female,GM1719,Drimmelen,2016JJ00,2016,13381,,108,,139,,-31,543,,75,468,496,,51,-4,445,47,16,,13397
237055,4000,Female,GM1719,Drimmelen,2017JJ00,2017,13397,,115,,120,,-5,650,,96,554,548,,66,-4,482,102,98,,13495
237056,4000,Female,GM1719,Drimmelen,2018JJ00,2018,13495,,107,,127,,-20,593,,137,456,509,,87,-4,422,84,65,,13560
237057,4000,Female,GM1719,Drimmelen,2019JJ00,2019,13560,,113,,113,,0,653,,157,496,576,,122,-15,454,77,78,,13638
237058,4000,Female,GM1719,Drimmelen,2020JJ00,2020,13638,,109,,142,,-33,651,,165,486,569,,106,-13,463,82,48,,13686
237059,4000,Female,GM1719,Drimmelen,2021JJ00,2021,13686,,121,,125,,-4,728,,199,529,640,,192,-5,448,88,83,,13769
237060,4000,Female,GM1719,Drimmelen,2022JJ00,2022,13769,,119,,139,,-20,891,,307,584,618,,180,-3,438,273,252,,14021
237061,4000,Female,GM1719,Drimmelen,2023JJ00,2023,14021,,129,,123,,6,807,,221,586,705,,199,-15,506,102,107,,14128
237132,4000,Female,GM0303,Dronten,2012JJ00,2012,19947,,220,,115,,105,1095,,337,758,1095,,110,-15,985,0,108,,20055
237133,4000,Female,GM0303,Dronten,2013JJ00,2013,20055,,168,,112,,56,1173,,449,724,1335,,311,-168,1024,-162,-103,,19952
237134,4000,Female,GM0303,Dronten,2014JJ00,2014,19952,,219,,98,,121,1175,,462,713,1308,,161,-40,1147,-133,-5,,19947
237135,4000,Female,GM0303,Dronten,2015JJ00,2015,19947,,191,,125,,66,1423,,547,876,1351,,150,-52,1201,72,144,,20091
237136,4000,Female,GM0303,Dronten,2016JJ00,2016,20091,,202,,123,,79,1459,,390,1069,1388,,127,-2,1261,71,153,,20244
237137,4000,Female,GM0303,Dronten,2017JJ00,2017,20244,,177,,140,,37,1285,,177,1108,1288,,143,-47,1145,-3,38,,20282
237138,4000,Female,GM0303,Dronten,2018JJ00,2018,20282,,191,,147,,44,1300,,251,1049,1277,,140,-40,1137,23,64,,20346
237139,4000,Female,GM0303,Dronten,2019JJ00,2019,20346,,178,,144,,34,1501,,364,1137,1161,,127,-24,1034,340,377,,20723
237140,4000,Female,GM0303,Dronten,2020JJ00,2020,20723,,190,,164,,26,1391,,190,1201,1194,,99,-15,1095,197,226,,20949
237141,4000,Female,GM0303,Dronten,2021JJ00,2021,20949,,219,,156,,63,1688,,306,1382,1356,,177,-36,1179,332,392,,21341
237142,4000,Female,GM0303,Dronten,2022JJ00,2022,21341,,214,,156,,58,1687,,427,1260,1329,,238,-62,1091,358,409,,21750
237143,4000,Female,GM0303,Dronten,2023JJ00,2023,21750,,193,,152,,41,1548,,213,1335,1342,,242,-37,1100,206,242,,21992
237296,4000,Female,GM0225,Druten,2012JJ00,2012,9157,,76,,71,,5,309,,37,272,306,,28,-2,278,3,9,,9166
237297,4000,Female,GM0225,Druten,2013JJ00,2013,9166,,76,,55,,21,319,,19,300,329,,28,-6,301,-10,11,,9177
237298,4000,Female,GM0225,Druten,2014JJ00,2014,9177,,68,,66,,2,376,,37,339,362,,23,0,339,14,18,,9195
237299,4000,Female,GM0225,Druten,2015JJ00,2015,9195,,71,,79,,-8,419,,31,388,345,,23,-2,322,74,65,,9260
237300,4000,Female,GM0225,Druten,2016JJ00,2016,9260,,78,,72,,6,420,,31,389,368,,23,-5,345,52,58,,9318
237301,4000,Female,GM0225,Druten,2017JJ00,2017,9318,,69,,67,,2,461,,21,440,403,,23,-6,380,58,58,,9376
237302,4000,Female,GM0225,Druten,2018JJ00,2018,9376,,85,,92,,-7,428,,32,396,372,,24,-3,348,56,48,,9424
237303,4000,Female,GM0225,Druten,2019JJ00,2019,9424,,70,,66,,4,475,,26,449,421,,23,-4,398,54,57,,9481
237304,4000,Female,GM0225,Druten,2020JJ00,2020,9481,,77,,84,,-7,475,,34,441,461,,20,0,441,14,6,,9487
237305,4000,Female,GM0225,Druten,2021JJ00,2021,9487,,96,,94,,2,434,,33,401,359,,16,-4,343,75,77,,9564
237306,4000,Female,GM0225,Druten,2022JJ00,2022,9564,,85,,104,,-19,542,,148,394,385,,39,-10,346,157,138,,9702
237307,4000,Female,GM0225,Druten,2023JJ00,2023,9702,,86,,98,,-12,485,,70,415,427,,39,-7,388,58,41,,9743
237542,4000,Female,GM0226,Duiven,2012JJ00,2012,13011,,94,,71,,23,537,,34,503,535,,32,-4,503,2,25,,13036
237543,4000,Female,GM0226,Duiven,2013JJ00,2013,13036,,93,,94,,-1,514,,30,484,537,,36,-7,501,-23,-23,,13013
237544,4000,Female,GM0226,Duiven,2014JJ00,2014,13013,,106,,93,,13,532,,33,499,584,,23,2,561,-52,-41,,12972
237545,4000,Female,GM0226,Duiven,2015JJ00,2015,12972,,113,,86,,27,489,,38,451,562,,28,-5,534,-73,-47,,12925
237546,4000,Female,GM0226,Duiven,2016JJ00,2016,12925,,90,,93,,-3,629,,43,586,681,,34,-8,647,-52,-55,,12870
237547,4000,Female,GM0226,Duiven,2017JJ00,2017,12870,,98,,101,,-3,681,,46,635,669,,37,-4,632,12,7,,12877
237548,4000,Female,GM0226,Duiven,2018JJ00,2018,12877,,97,,96,,1,603,,47,556,662,,33,-11,629,-59,-61,,12816
237549,4000,Female,GM0226,Duiven,2019JJ00,2019,12816,,103,,100,,3,579,,31,548,684,,33,-5,651,-105,-100,,12716
237550,4000,Female,GM0226,Duiven,2020JJ00,2020,12716,,106,,112,,-6,620,,59,561,666,,29,-4,637,-46,-53,,12663
237551,4000,Female,GM0226,Duiven,2021JJ00,2021,12663,,109,,115,,-6,600,,37,563,630,,32,-1,598,-30,-37,,12626
237552,4000,Female,GM0226,Duiven,2022JJ00,2022,12626,,96,,91,,5,604,,60,544,629,,55,-1,574,-25,-21,,12605
237553,4000,Female,GM0226,Duiven,2023JJ00,2023,12605,,101,,88,,13,604,,116,488,643,,63,-14,580,-39,-25,,12580
238116,4000,Female,GM1711,Echt-Susteren,2012JJ00,2012,16069,,121,,150,,-29,634,,149,485,639,,78,-7,561,-5,-32,,16037
238117,4000,Female,GM1711,Echt-Susteren,2013JJ00,2013,16037,,118,,164,,-46,686,,141,545,706,,94,-15,612,-20,-64,,15973
238118,4000,Female,GM1711,Echt-Susteren,2014JJ00,2014,15973,,108,,172,,-64,730,,192,538,711,,76,-11,635,19,-42,,15931
238119,4000,Female,GM1711,Echt-Susteren,2015JJ00,2015,15931,,111,,213,,-102,847,,236,611,761,,75,0,686,86,-15,,15916
238120,4000,Female,GM1711,Echt-Susteren,2016JJ00,2016,15916,,110,,170,,-60,722,,143,579,763,,72,-1,691,-41,-98,,15818
238121,4000,Female,GM1711,Echt-Susteren,2017JJ00,2017,15818,,117,,194,,-77,809,,124,685,768,,76,-7,692,41,-36,,15782
238122,4000,Female,GM1711,Echt-Susteren,2018JJ00,2018,15782,,97,,176,,-79,764,,151,613,692,,91,-19,601,72,-12,,15770
238123,4000,Female,GM1711,Echt-Susteren,2019JJ00,2019,15770,,114,,190,,-76,830,,178,652,739,,83,-1,656,91,17,,15787
238124,4000,Female,GM1711,Echt-Susteren,2020JJ00,2020,15787,,111,,194,,-83,809,,110,699,661,,76,-2,585,148,66,,15853
238125,4000,Female,GM1711,Echt-Susteren,2021JJ00,2021,15853,,118,,219,,-101,796,,106,690,701,,93,-15,608,95,-5,,15848
238126,4000,Female,GM1711,Echt-Susteren,2022JJ00,2022,15848,,123,,223,,-100,973,,219,754,783,,115,-19,668,190,89,,15937
238127,4000,Female,GM1711,Echt-Susteren,2023JJ00,2023,15937,,128,,209,,-81,756,,112,644,626,,91,-1,535,130,49,,15986
238280,4000,Female,GM0385,Edam-Volendam,2012JJ00,2012,14332,,155,,109,,46,246,,36,210,223,,31,-4,192,23,69,,14401
238281,4000,Female,GM0385,Edam-Volendam,2013JJ00,2013,14401,,113,,101,,12,303,,40,263,244,,39,-5,205,59,70,,14471
238282,4000,Female,GM0385,Edam-Volendam,2014JJ00,2014,14471,,129,,77,,52,257,,35,222,227,,28,-3,199,30,81,,14552
238283,4000,Female,GM0385,Edam-Volendam,2015JJ00,2015,14552,,137,,94,,43,295,,30,265,264,,29,-5,235,31,78,,14630
238284,4000,Female,GM0385,Edam-Volendam,2016JJ00,2016,17773,,144,,136,,8,520,,63,457,414,,38,-3,376,106,116,,17889
238285,4000,Female,GM0385,Edam-Volendam,2017JJ00,2017,17889,,132,,124,,8,499,,46,453,436,,57,-11,379,63,71,,17960
238286,4000,Female,GM0385,Edam-Volendam,2018JJ00,2018,17960,,190,,151,,39,471,,64,407,409,,46,-7,363,62,100,,18060
238287,4000,Female,GM0385,Edam-Volendam,2019JJ00,2019,18060,,145,,160,,-15,465,,61,404,410,,29,-8,381,55,40,,18100
238288,4000,Female,GM0385,Edam-Volendam,2020JJ00,2020,18100,,136,,153,,-17,521,,51,470,469,,51,-4,418,52,35,,18135
238289,4000,Female,GM0385,Edam-Volendam,2021JJ00,2021,18135,,182,,148,,34,537,,56,481,485,,49,-3,436,52,85,,18220
238290,4000,Female,GM0385,Edam-Volendam,2022JJ00,2022,18220,,137,,151,,-14,595,,244,351,420,,83,-4,337,175,162,,18382
238291,4000,Female,GM0385,Edam-Volendam,2023JJ00,2023,18382,,152,,157,,-5,509,,66,443,441,,63,-7,378,68,64,,18446
238362,4000,Female,GM0228,Ede,2012JJ00,2012,55392,,687,,445,,242,2566,,366,2200,2253,,169,-8,2084,313,554,,55946
238363,4000,Female,GM0228,Ede,2013JJ00,2013,55946,,618,,396,,222,2501,,341,2160,2313,,260,-19,2053,188,409,,56355
238364,4000,Female,GM0228,Ede,2014JJ00,2014,56355,,653,,447,,206,2750,,327,2423,2520,,269,-21,2251,230,430,,56785
238365,4000,Female,GM0228,Ede,2015JJ00,2015,56785,,632,,453,,179,2698,,379,2319,2542,,271,-40,2271,156,341,,57126
238366,4000,Female,GM0228,Ede,2016JJ00,2016,57126,,652,,488,,164,2824,,292,2532,2602,,276,-35,2326,222,381,,57507
238367,4000,Female,GM0228,Ede,2017JJ00,2017,57507,,628,,459,,169,2978,,320,2658,2658,,248,-30,2410,320,486,,57993
238368,4000,Female,GM0228,Ede,2018JJ00,2018,57993,,644,,472,,172,3037,,351,2686,2668,,309,-34,2359,369,542,,58535
238369,4000,Female,GM0228,Ede,2019JJ00,2019,58535,,662,,464,,198,2954,,392,2562,2530,,245,-20,2285,424,619,,59154
238370,4000,Female,GM0228,Ede,2020JJ00,2020,59154,,732,,492,,240,2944,,308,2636,2535,,211,-11,2324,409,642,,59796
238371,4000,Female,GM0228,Ede,2021JJ00,2021,59796,,770,,533,,237,2933,,341,2592,2539,,202,0,2337,394,635,,60431
238372,4000,Female,GM0228,Ede,2022JJ00,2022,60431,,691,,505,,186,3323,,762,2561,2556,,325,-38,2231,767,955,,61386
238373,4000,Female,GM0228,Ede,2023JJ00,2023,61386,,680,,489,,191,3440,,533,2907,2793,,400,-75,2393,647,836,,62222
238526,4000,Female,GM0317,Eemnes,2012JJ00,2012,4459,,35,,25,,10,168,,14,154,209,,15,-2,194,-41,-31,,4428
238527,4000,Female,GM0317,Eemnes,2013JJ00,2013,4428,,33,,25,,8,154,,9,145,151,,12,-1,139,3,11,,4439
238528,4000,Female,GM0317,Eemnes,2014JJ00,2014,4439,,29,,25,,4,197,,16,181,191,,27,-1,164,6,9,,4448
238529,4000,Female,GM0317,Eemnes,2015JJ00,2015,4448,,29,,18,,11,243,,11,232,214,,13,-1,201,29,40,,4488
238530,4000,Female,GM0317,Eemnes,2016JJ00,2016,4488,,40,,25,,15,281,,15,266,219,,10,5,209,62,77,,4565
238531,4000,Female,GM0317,Eemnes,2017JJ00,2017,4565,,31,,28,,3,319,,27,292,255,,20,-2,235,64,69,,4634
238532,4000,Female,GM0317,Eemnes,2018JJ00,2018,4634,,27,,24,,3,225,,19,206,250,,15,3,235,-25,-22,,4612
238533,4000,Female,GM0317,Eemnes,2019JJ00,2019,4612,,35,,38,,-3,302,,27,275,235,,10,1,225,67,64,,4676
238534,4000,Female,GM0317,Eemnes,2020JJ00,2020,4676,,56,,31,,25,315,,13,302,246,,9,-1,237,69,94,,4770
238535,4000,Female,GM0317,Eemnes,2021JJ00,2021,4770,,50,,37,,13,284,,23,261,252,,15,0,237,32,45,,4815
238536,4000,Female,GM0317,Eemnes,2022JJ00,2022,4815,,36,,32,,4,358,,79,279,279,,27,0,252,79,84,,4899
238537,4000,Female,GM0317,Eemnes,2023JJ00,2023,4899,,38,,27,,11,336,,31,305,263,,24,0,239,73,82,,4981
238617,4000,Female,GM1979,Eemsdelta,2021JJ00,2021,22746,,212,,306,,-94,968,,137,831,991,,77,-6,914,-23,-117,,22629
238618,4000,Female,GM1979,Eemsdelta,2022JJ00,2022,22629,,168,,297,,-129,1323,,247,1076,1176,,93,-15,1083,147,22,,22651
238619,4000,Female,GM1979,Eemsdelta,2023JJ00,2023,22651,,203,,285,,-82,1036,,143,893,1179,,92,-5,1087,-143,-226,,22425
238690,4000,Female,GM1651,Eemsmond,2012JJ00,2012,7980,,53,,77,,-24,246,,24,222,336,,21,-8,315,-90,-114,,7866
238691,4000,Female,GM1651,Eemsmond,2013JJ00,2013,7866,,64,,74,,-10,224,,36,188,296,,18,-1,278,-72,-82,,7784
238692,4000,Female,GM1651,Eemsmond,2014JJ00,2014,7784,,71,,71,,0,246,,24,222,287,,18,0,269,-41,-41,,7743
238693,4000,Female,GM1651,Eemsmond,2015JJ00,2015,7743,,82,,61,,21,287,,36,251,286,,14,1,272,1,22,,7765
238694,4000,Female,GM1651,Eemsmond,2016JJ00,2016,7765,,55,,83,,-28,293,,43,250,348,,32,-3,316,-55,-83,,7682
238695,4000,Female,GM1651,Eemsmond,2017JJ00,2017,7682,,56,,76,,-20,315,,33,282,361,,18,-3,343,-46,-66,,7616
238696,4000,Female,GM1651,Eemsmond,2018JJ00,2018,7616,,64,,68,,-4,279,,31,248,364,,16,-1,348,-85,-88,,7528
238854,4000,Female,GM0770,Eersel,2012JJ00,2012,8946,,81,,76,,5,341,,31,310,321,,22,0,299,20,25,,8971
238855,4000,Female,GM0770,Eersel,2013JJ00,2013,8971,,88,,76,,12,354,,47,307,343,,23,1,320,11,24,,8995
238856,4000,Female,GM0770,Eersel,2014JJ00,2014,8995,,83,,73,,10,394,,44,350,340,,28,-4,312,54,64,,9059
238857,4000,Female,GM0770,Eersel,2015JJ00,2015,9059,,78,,86,,-8,485,,54,431,362,,38,1,324,123,115,,9174
238858,4000,Female,GM0770,Eersel,2016JJ00,2016,9174,,73,,98,,-25,429,,39,390,435,,42,-6,393,-6,-31,,9143
238859,4000,Female,GM0770,Eersel,2017JJ00,2017,9143,,88,,74,,14,510,,58,452,375,,28,-6,347,135,148,,9291
238860,4000,Female,GM0770,Eersel,2018JJ00,2018,9291,,89,,83,,6,561,,52,509,422,,30,-3,392,139,145,,9436
238861,4000,Female,GM0770,Eersel,2019JJ00,2019,9436,,79,,84,,-5,476,,39,437,379,,22,-4,357,97,92,,9528
238862,4000,Female,GM0770,Eersel,2020JJ00,2020,9528,,85,,88,,-3,502,,51,451,384,,28,-4,356,118,115,,9643
238863,4000,Female,GM0770,Eersel,2021JJ00,2021,9643,,110,,88,,22,556,,46,510,417,,33,-4,384,139,162,,9805
238864,4000,Female,GM0770,Eersel,2022JJ00,2022,9805,,99,,85,,14,526,,140,386,425,,56,-2,369,101,114,,9919
238865,4000,Female,GM0770,Eersel,2023JJ00,2023,9919,,87,,98,,-11,515,,108,407,426,,47,-12,379,89,79,,9998
239510,4000,Female,GM1903,Eijsden-Margraten,2012JJ00,2012,12496,,78,,115,,-37,541,,72,469,468,,68,-11,400,73,37,,12533
239511,4000,Female,GM1903,Eijsden-Margraten,2013JJ00,2013,12533,,96,,106,,-10,504,,70,434,545,,60,2,485,-41,-53,,12480
239512,4000,Female,GM1903,Eijsden-Margraten,2014JJ00,2014,12480,,98,,121,,-23,546,,62,484,484,,53,-6,431,62,41,,12521
239513,4000,Female,GM1903,Eijsden-Margraten,2015JJ00,2015,12521,,100,,116,,-16,653,,76,577,544,,60,-3,484,109,92,,12613
239514,4000,Female,GM1903,Eijsden-Margraten,2016JJ00,2016,12613,,116,,130,,-14,683,,91,592,581,,78,-6,503,102,90,,12703
239515,4000,Female,GM1903,Eijsden-Margraten,2017JJ00,2017,12703,,112,,131,,-19,733,,85,648,643,,76,-6,567,90,71,,12774
239516,4000,Female,GM1903,Eijsden-Margraten,2018JJ00,2018,12774,,104,,108,,-4,653,,96,557,609,,78,-14,531,44,41,,12815
239517,4000,Female,GM1903,Eijsden-Margraten,2019JJ00,2019,12815,,118,,108,,10,662,,90,572,619,,88,-1,531,43,50,,12865
239518,4000,Female,GM1903,Eijsden-Margraten,2020JJ00,2020,12865,,120,,139,,-19,704,,68,636,628,,66,-1,562,76,56,,12921
239519,4000,Female,GM1903,Eijsden-Margraten,2021JJ00,2021,12921,,121,,134,,-13,613,,65,548,603,,87,-1,516,10,-2,,12919
239520,4000,Female,GM1903,Eijsden-Margraten,2022JJ00,2022,12919,,128,,121,,7,705,,156,549,643,,124,-4,519,62,69,,12988
239521,4000,Female,GM1903,Eijsden-Margraten,2023JJ00,2023,12988,,107,,140,,-33,667,,116,551,611,,79,1,532,56,28,,13016
239592,4000,Female,GM0772,Eindhoven,2012JJ00,2012,106482,,1177,,1017,,160,6191,,1820,4371,5730,,1396,-298,4334,461,619,,107101
239593,4000,Female,GM0772,Eindhoven,2013JJ00,2013,107101,,1141,,985,,156,6777,,2037,4740,5880,,1440,-185,4440,897,1052,,108153
239594,4000,Female,GM0772,Eindhoven,2014JJ00,2014,108153,,1232,,935,,297,7051,,2085,4966,6332,,1585,-233,4747,719,1022,,109175
239595,4000,Female,GM0772,Eindhoven,2015JJ00,2015,109175,,1061,,1005,,56,7520,,2656,4864,7052,,1636,-197,5416,468,528,,109703
239596,4000,Female,GM0772,Eindhoven,2016JJ00,2016,109703,,1124,,994,,130,7928,,2646,5282,7190,,1826,-278,5364,738,858,,110561
239597,4000,Female,GM0772,Eindhoven,2017JJ00,2017,110561,,1074,,972,,102,8556,,2897,5659,7679,,1694,-179,5985,877,972,,111533
239598,4000,Female,GM0772,Eindhoven,2018JJ00,2018,111533,,1103,,1048,,55,8529,,3405,5124,7616,,1779,-172,5837,913,952,,112485
239599,4000,Female,GM0772,Eindhoven,2019JJ00,2019,112485,,1096,,1019,,77,8773,,3729,5044,7720,,1804,-195,5916,1053,1130,,113615
239600,4000,Female,GM0772,Eindhoven,2020JJ00,2020,113615,,1058,,1128,,-70,8525,,2962,5563,8018,,1715,-129,6303,507,425,,114040
239601,4000,Female,GM0772,Eindhoven,2021JJ00,2021,114040,,1210,,1153,,57,8886,,3646,5240,8108,,1629,-90,6479,778,831,,114871
239602,4000,Female,GM0772,Eindhoven,2022JJ00,2022,114871,,1087,,1084,,3,10598,,5595,5003,8149,,1914,-132,6235,2449,2443,,117314
239603,4000,Female,GM0772,Eindhoven,2023JJ00,2023,117314,,1026,,1054,,-28,9658,,4436,5222,8507,,1998,-171,6509,1151,1122,,118436
239674,4000,Female,GM0230,Elburg,2012JJ00,2012,11311,,129,,77,,52,411,,22,389,401,,22,-1,379,10,62,,11373
239675,4000,Female,GM0230,Elburg,2013JJ00,2013,11373,,123,,79,,44,419,,42,377,399,,20,-2,379,20,64,,11437
239676,4000,Female,GM0230,Elburg,2014JJ00,2014,11437,,141,,87,,54,449,,41,408,414,,31,-7,383,35,89,,11526
239677,4000,Female,GM0230,Elburg,2015JJ00,2015,11526,,124,,89,,35,449,,60,389,450,,21,-1,429,-1,33,,11559
239678,4000,Female,GM0230,Elburg,2016JJ00,2016,11559,,124,,95,,29,448,,23,425,478,,29,-4,449,-30,-1,,11558
239679,4000,Female,GM0230,Elburg,2017JJ00,2017,11558,,125,,103,,22,496,,27,469,481,,27,-2,454,15,37,,11595
239680,4000,Female,GM0230,Elburg,2018JJ00,2018,11595,,122,,102,,20,526,,29,497,570,,31,-4,539,-44,-25,,11570
239681,4000,Female,GM0230,Elburg,2019JJ00,2019,11570,,116,,97,,19,484,,32,452,468,,14,1,454,16,36,,11606
239682,4000,Female,GM0230,Elburg,2020JJ00,2020,11606,,118,,111,,7,587,,44,543,533,,18,0,515,54,61,,11667
239683,4000,Female,GM0230,Elburg,2021JJ00,2021,11667,,130,,112,,18,576,,35,541,450,,29,-4,421,126,142,,11809
239684,4000,Female,GM0230,Elburg,2022JJ00,2022,11809,,124,,105,,19,639,,186,453,469,,61,-15,408,170,188,,11997
239685,4000,Female,GM0230,Elburg,2023JJ00,2023,11997,,114,,103,,11,457,,58,399,539,,71,-10,468,-82,-72,,11925
240248,4000,Female,GM0114,Emmen,2012JJ00,2012,54923,,505,,575,,-70,1690,,300,1390,1814,,279,-92,1535,-124,-193,,54730
240249,4000,Female,GM0114,Emmen,2013JJ00,2013,54730,,482,,572,,-90,1594,,267,1327,1653,,221,-50,1432,-59,-151,,54579
240250,4000,Female,GM0114,Emmen,2014JJ00,2014,54579,,461,,544,,-83,1501,,249,1252,1613,,232,-60,1381,-112,-203,,54376
240251,4000,Female,GM0114,Emmen,2015JJ00,2015,54376,,421,,590,,-169,1676,,269,1407,1678,,255,-90,1423,-2,-182,,54194
240252,4000,Female,GM0114,Emmen,2016JJ00,2016,54194,,421,,582,,-161,1696,,261,1435,1702,,209,-48,1493,-6,-165,,54029
240253,4000,Female,GM0114,Emmen,2017JJ00,2017,54029,,466,,590,,-124,1802,,203,1599,1842,,159,-27,1683,-40,-168,,53861
240254,4000,Female,GM0114,Emmen,2018JJ00,2018,53861,,423,,579,,-156,1837,,246,1591,1711,,160,-17,1551,126,-37,,53824
240255,4000,Female,GM0114,Emmen,2019JJ00,2019,53824,,434,,624,,-190,1853,,277,1576,1755,,193,-32,1562,98,-113,,53711
240256,4000,Female,GM0114,Emmen,2020JJ00,2020,53711,,454,,593,,-139,1806,,201,1605,1636,,149,-24,1487,170,17,,53728
240257,4000,Female,GM0114,Emmen,2021JJ00,2021,53728,,461,,671,,-210,2172,,222,1950,1631,,194,-61,1437,541,314,,54042
240258,4000,Female,GM0114,Emmen,2022JJ00,2022,54042,,446,,736,,-290,2447,,624,1823,1720,,235,-70,1485,727,422,,54464
240259,4000,Female,GM0114,Emmen,2023JJ00,2023,54464,,457,,659,,-202,2310,,551,1759,1858,,349,-90,1509,452,229,,54693
240494,4000,Female,GM0388,Enkhuizen,2012JJ00,2012,9139,,84,,77,,7,430,,59,371,448,,44,1,404,-18,-10,,9129
240495,4000,Female,GM0388,Enkhuizen,2013JJ00,2013,9129,,88,,93,,-5,439,,57,382,426,,34,-2,392,13,9,,9138
240496,4000,Female,GM0388,Enkhuizen,2014JJ00,2014,9138,,79,,84,,-5,440,,72,368,456,,37,2,419,-16,-21,,9117
240497,4000,Female,GM0388,Enkhuizen,2015JJ00,2015,9117,,93,,87,,6,430,,65,365,409,,43,-4,366,21,30,,9147
240498,4000,Female,GM0388,Enkhuizen,2016JJ00,2016,9147,,90,,75,,15,487,,81,406,463,,47,-4,416,24,38,,9185
240499,4000,Female,GM0388,Enkhuizen,2017JJ00,2017,9185,,80,,75,,5,447,,58,389,451,,63,-2,388,-4,1,,9186
240500,4000,Female,GM0388,Enkhuizen,2018JJ00,2018,9186,,82,,100,,-18,466,,69,397,412,,31,-5,381,54,36,,9222
240501,4000,Female,GM0388,Enkhuizen,2019JJ00,2019,9222,,76,,66,,10,496,,82,414,461,,54,-6,407,35,43,,9265
240502,4000,Female,GM0388,Enkhuizen,2020JJ00,2020,9265,,90,,104,,-14,482,,68,414,461,,57,-8,404,21,7,,9272
240503,4000,Female,GM0388,Enkhuizen,2021JJ00,2021,9272,,95,,101,,-6,461,,58,403,467,,42,-3,425,-6,-14,,9258
240504,4000,Female,GM0388,Enkhuizen,2022JJ00,2022,9258,,91,,84,,7,634,,201,433,473,,61,-13,412,161,169,,9427
240505,4000,Female,GM0388,Enkhuizen,2023JJ00,2023,9427,,77,,103,,-26,524,,112,412,504,,79,-11,425,20,-6,,9421
240576,4000,Female,GM0153,Enschede,2012JJ00,2012,77827,,808,,723,,85,3828,,1154,2674,3561,,1051,-180,2510,267,351,,78178
240577,4000,Female,GM0153,Enschede,2013JJ00,2013,78178,,801,,700,,101,3649,,1091,2558,3764,,1145,-178,2619,-115,-18,,78160
240578,4000,Female,GM0153,Enschede,2014JJ00,2014,78160,,743,,744,,-1,3742,,1125,2617,3764,,1052,-177,2712,-22,-18,,78142
240579,4000,Female,GM0153,Enschede,2015JJ00,2015,78142,,723,,820,,-97,3697,,1142,2555,3806,,1120,-174,2686,-109,-210,,77932
240580,4000,Female,GM0153,Enschede,2016JJ00,2016,77932,,738,,781,,-43,3879,,1195,2684,4114,,1147,-239,2967,-235,-280,,77652
240581,4000,Female,GM0153,Enschede,2017JJ00,2017,77652,,710,,754,,-44,4002,,1332,2670,4003,,1043,-136,2960,-1,-44,,77608
240582,4000,Female,GM0153,Enschede,2018JJ00,2018,77608,,715,,738,,-23,3938,,1418,2520,3688,,938,-29,2750,250,230,,77838
240583,4000,Female,GM0153,Enschede,2019JJ00,2019,77838,,672,,775,,-103,4361,,1621,2740,3972,,1132,-180,2840,389,263,,78101
240584,4000,Female,GM0153,Enschede,2020JJ00,2020,78101,,614,,814,,-200,4065,,1397,2668,3896,,1023,-135,2873,169,-47,,78054
240585,4000,Female,GM0153,Enschede,2021JJ00,2021,78054,,727,,852,,-125,4201,,1689,2512,3758,,951,-146,2807,443,314,,78368
240586,4000,Female,GM0153,Enschede,2022JJ00,2022,78368,,660,,852,,-192,4585,,2099,2486,4047,,1121,-123,2926,538,341,,78709
240587,4000,Female,GM0153,Enschede,2023JJ00,2023,78709,,640,,816,,-176,4656,,1905,2751,4466,,1322,-257,3144,190,17,,78726
240658,4000,Female,GM0232,Epe,2012JJ00,2012,16472,,126,,149,,-23,486,,68,418,525,,50,-15,475,-39,-61,,16411
240659,4000,Female,GM0232,Epe,2013JJ00,2013,16411,,139,,154,,-15,493,,60,433,525,,38,0,487,-32,-46,,16365
240660,4000,Female,GM0232,Epe,2014JJ00,2014,16365,,122,,149,,-27,513,,48,465,557,,41,0,516,-44,-70,,16295
240661,4000,Female,GM0232,Epe,2015JJ00,2015,16295,,127,,182,,-55,619,,69,550,540,,52,-2,488,79,24,,16319
240662,4000,Female,GM0232,Epe,2016JJ00,2016,16319,,129,,178,,-49,741,,55,686,606,,35,8,571,135,87,,16406
240663,4000,Female,GM0232,Epe,2017JJ00,2017,16406,,141,,184,,-43,769,,44,725,591,,32,-6,559,178,134,,16540
240664,4000,Female,GM0232,Epe,2018JJ00,2018,16540,,140,,194,,-54,750,,56,694,579,,38,-11,541,171,116,,16656
240665,4000,Female,GM0232,Epe,2019JJ00,2019,16656,,128,,169,,-41,625,,42,583,555,,26,3,529,70,31,,16687
240666,4000,Female,GM0232,Epe,2020JJ00,2020,16687,,140,,216,,-76,677,,57,620,644,,31,-2,613,33,-41,,16646
240667,4000,Female,GM0232,Epe,2021JJ00,2021,16646,,150,,196,,-46,704,,63,641,649,,52,-10,597,55,8,,16654
240668,4000,Female,GM0232,Epe,2022JJ00,2022,16654,,126,,194,,-68,729,,174,555,616,,71,-9,545,113,45,,16699
240669,4000,Female,GM0232,Epe,2023JJ00,2023,16699,,120,,187,,-67,629,,78,551,623,,88,-13,535,6,-63,,16636
240740,4000,Female,GM0233,Ermelo,2012JJ00,2012,13261,,97,,111,,-14,601,,44,557,614,,36,7,578,-13,-27,,13234
240741,4000,Female,GM0233,Ermelo,2013JJ00,2013,13234,,107,,127,,-20,589,,40,549,641,,18,6,623,-52,-72,,13162
240742,4000,Female,GM0233,Ermelo,2014JJ00,2014,13162,,120,,136,,-16,723,,44,679,629,,18,2,611,94,80,,13242
240743,4000,Female,GM0233,Ermelo,2015JJ00,2015,13242,,104,,142,,-38,783,,66,717,628,,41,0,587,155,116,,13358
240744,4000,Female,GM0233,Ermelo,2016JJ00,2016,13358,,111,,140,,-29,729,,45,684,645,,36,-1,609,84,54,,13412
240745,4000,Female,GM0233,Ermelo,2017JJ00,2017,13412,,116,,135,,-19,715,,52,663,626,,32,1,594,89,70,,13482
240746,4000,Female,GM0233,Ermelo,2018JJ00,2018,13482,,112,,175,,-63,810,,78,732,711,,34,3,677,99,39,,13521
240747,4000,Female,GM0233,Ermelo,2019JJ00,2019,13521,,130,,155,,-25,775,,56,719,687,,33,4,654,88,61,,13582
240748,4000,Female,GM0233,Ermelo,2020JJ00,2020,13582,,112,,176,,-64,705,,50,655,643,,15,3,628,62,-3,,13579
240749,4000,Female,GM0233,Ermelo,2021JJ00,2021,13579,,127,,172,,-45,771,,59,712,623,,41,-2,582,148,105,,13684
240750,4000,Female,GM0233,Ermelo,2022JJ00,2022,13684,,106,,170,,-64,857,,143,714,644,,70,-3,574,213,149,,13833
240751,4000,Female,GM0233,Ermelo,2023JJ00,2023,13833,,129,,160,,-31,853,,109,744,618,,62,1,556,235,206,,14039
241232,4000,Female,GM0777,Etten-Leur,2012JJ00,2012,21245,,223,,187,,36,843,,107,736,757,,98,-10,659,86,122,,21367
241233,4000,Female,GM0777,Etten-Leur,2013JJ00,2013,21367,,194,,171,,23,761,,101,660,764,,66,5,698,-3,22,,21389
241234,4000,Female,GM0777,Etten-Leur,2014JJ00,2014,21389,,212,,164,,48,842,,138,704,810,,105,-21,705,32,82,,21471
241235,4000,Female,GM0777,Etten-Leur,2015JJ00,2015,21471,,210,,193,,17,996,,128,868,800,,94,-4,706,196,211,,21682
241236,4000,Female,GM0777,Etten-Leur,2016JJ00,2016,21682,,225,,210,,15,964,,136,828,875,,116,-11,759,89,102,,21784
241237,4000,Female,GM0777,Etten-Leur,2017JJ00,2017,21784,,215,,172,,43,1155,,94,1061,924,,80,-2,844,231,276,,22060
241238,4000,Female,GM0777,Etten-Leur,2018JJ00,2018,22060,,207,,212,,-5,979,,119,860,835,,71,-2,764,144,137,,22197
241239,4000,Female,GM0777,Etten-Leur,2019JJ00,2019,22197,,205,,202,,3,943,,133,810,947,,129,-20,818,-4,1,,22198
241240,4000,Female,GM0777,Etten-Leur,2020JJ00,2020,22198,,175,,196,,-21,944,,101,843,894,,93,-7,801,50,30,,22228
241241,4000,Female,GM0777,Etten-Leur,2021JJ00,2021,22228,,208,,202,,6,1039,,139,900,897,,106,-9,791,142,146,,22374
241242,4000,Female,GM0777,Etten-Leur,2022JJ00,2022,22374,,200,,240,,-40,1165,,272,893,929,,165,-8,764,236,197,,22571
241243,4000,Female,GM0777,Etten-Leur,2023JJ00,2023,22571,,177,,239,,-62,1312,,225,1087,923,,205,-22,718,389,327,,22898
241642,4000,Female,GM1722,Ferwerderadiel,2012JJ00,2012,4305,,57,,37,,20,188,,13,175,180,,7,1,173,8,27,,4332
241643,4000,Female,GM1722,Ferwerderadiel,2013JJ00,2013,4332,,45,,34,,11,160,,12,148,183,,13,-1,170,-23,-12,,4320
241644,4000,Female,GM1722,Ferwerderadiel,2014JJ00,2014,4320,,42,,33,,9,146,,17,129,208,,11,-3,197,-62,-53,,4267
241645,4000,Female,GM1722,Ferwerderadiel,2015JJ00,2015,4267,,53,,43,,10,172,,11,161,200,,10,-1,190,-28,-18,,4249
241646,4000,Female,GM1722,Ferwerderadiel,2016JJ00,2016,4249,,47,,38,,9,207,,20,187,203,,9,-1,194,4,13,,4262
241647,4000,Female,GM1722,Ferwerderadiel,2017JJ00,2017,4262,,45,,44,,1,191,,4,187,208,,6,-3,202,-17,-15,,4247
241648,4000,Female,GM1722,Ferwerderadiel,2018JJ00,2018,4247,,32,,43,,-11,169,,12,157,209,,6,-2,203,-40,-52,,4195
241970,4000,Female,GM0070,Franekeradeel,2012JJ00,2012,10210,,122,,82,,40,357,,31,326,405,,35,-3,370,-48,-7,,10203
241971,4000,Female,GM0070,Franekeradeel,2013JJ00,2013,10203,,101,,83,,18,388,,41,347,433,,26,-2,407,-45,-28,,10175
241972,4000,Female,GM0070,Franekeradeel,2014JJ00,2014,10175,,107,,110,,-3,385,,35,350,437,,35,-4,402,-52,-56,,10119
241973,4000,Female,GM0070,Franekeradeel,2015JJ00,2015,10119,,92,,100,,-8,447,,53,394,496,,37,-1,459,-49,-57,,10062
241974,4000,Female,GM0070,Franekeradeel,2016JJ00,2016,10062,,87,,81,,6,461,,41,420,481,,28,-2,453,-20,-14,,10048
241975,4000,Female,GM0070,Franekeradeel,2017JJ00,2017,10048,,88,,107,,-19,485,,40,445,492,,25,2,467,-7,-29,,10019
242054,4000,Female,GM1921,De Friese Meren,2014JJ00,2014,25522,,229,,224,,5,834,,88,746,945,,69,-13,876,-111,-127,,25395
242055,4000,Female,GM1921,De Friese Meren,2015JJ00,2015,25395,,207,,231,,-24,908,,74,834,850,,65,1,785,58,38,,25433
242138,4000,Female,GM1940,De Fryske Marren,2016JJ00,2016,25433,,229,,240,,-11,1147,,112,1035,971,,63,-3,908,176,164,,25597
242139,4000,Female,GM1940,De Fryske Marren,2017JJ00,2017,25597,,204,,224,,-20,1254,,106,1148,1158,,84,-20,1074,96,77,,25674
242140,4000,Female,GM1940,De Fryske Marren,2018JJ00,2018,25674,,208,,252,,-44,1015,,110,905,1078,,73,-12,1005,-63,-104,,25570
242141,4000,Female,GM1940,De Fryske Marren,2019JJ00,2019,25570,,249,,251,,-2,1052,,107,945,998,,64,-3,934,54,54,,25624
242142,4000,Female,GM1940,De Fryske Marren,2020JJ00,2020,25624,,237,,235,,2,1085,,79,1006,991,,39,-2,952,94,98,,25722
242143,4000,Female,GM1940,De Fryske Marren,2021JJ00,2021,25722,,219,,306,,-87,1117,,99,1018,1169,,72,-2,1097,-52,-141,,25581
242144,4000,Female,GM1940,De Fryske Marren,2022JJ00,2022,25581,,217,,309,,-92,1330,,305,1025,1025,,107,-9,918,305,215,,25796
242145,4000,Female,GM1940,De Fryske Marren,2023JJ00,2023,25796,,224,,268,,-44,1115,,124,991,1126,,95,-9,1031,-11,-56,,25740
242298,4000,Female,GM0653,Gaasterlân-Sleat,2012JJ00,2012,5046,,54,,57,,-3,165,,16,149,170,,10,-2,160,-5,-8,,5038
242299,4000,Female,GM0653,Gaasterlân-Sleat,2013JJ00,2013,5038,,43,,52,,-9,168,,9,159,164,,9,0,155,4,-6,,5032
242626,4000,Female,GM0779,Geertruidenberg,2012JJ00,2012,10796,,104,,103,,1,363,,16,347,344,,16,0,328,19,20,,10816
242627,4000,Female,GM0779,Geertruidenberg,2013JJ00,2013,10816,,101,,100,,1,363,,23,340,323,,20,-6,303,40,40,,10856
242628,4000,Female,GM0779,Geertruidenberg,2014JJ00,2014,10856,,101,,105,,-4,370,,25,345,375,,34,-12,341,-5,-7,,10849
242629,4000,Female,GM0779,Geertruidenberg,2015JJ00,2015,10849,,124,,119,,5,418,,30,388,393,,28,1,365,25,30,,10879
242630,4000,Female,GM0779,Geertruidenberg,2016JJ00,2016,10879,,93,,112,,-19,403,,25,378,451,,24,-4,427,-48,-69,,10810
242631,4000,Female,GM0779,Geertruidenberg,2017JJ00,2017,10810,,83,,105,,-22,483,,29,454,450,,15,0,435,33,12,,10822
242632,4000,Female,GM0779,Geertruidenberg,2018JJ00,2018,10822,,106,,108,,-2,417,,29,388,399,,21,0,378,18,18,,10840
242633,4000,Female,GM0779,Geertruidenberg,2019JJ00,2019,10840,,95,,106,,-11,454,,30,424,438,,27,-4,411,16,4,,10844
242634,4000,Female,GM0779,Geertruidenberg,2020JJ00,2020,10844,,79,,105,,-26,582,,29,553,438,,32,1,406,144,118,,10962
242635,4000,Female,GM0779,Geertruidenberg,2021JJ00,2021,10962,,107,,125,,-18,487,,26,461,407,,15,-2,392,80,63,,11025
242636,4000,Female,GM0779,Geertruidenberg,2022JJ00,2022,11025,,91,,122,,-31,548,,134,414,441,,37,-10,404,107,78,,11103
242637,4000,Female,GM0779,Geertruidenberg,2023JJ00,2023,11103,,103,,136,,-33,404,,46,358,399,,44,-3,355,5,-29,,11074
242872,4000,Female,GM0236,Geldermalsen,2012JJ00,2012,13282,,110,,95,,15,400,,47,353,463,,27,-4,436,-63,-49,,13233
242873,4000,Female,GM0236,Geldermalsen,2013JJ00,2013,13233,,144,,89,,55,472,,43,429,475,,33,-1,442,-3,52,,13285
242874,4000,Female,GM0236,Geldermalsen,2014JJ00,2014,13285,,108,,94,,14,467,,38,429,483,,27,1,456,-16,-1,,13284
242875,4000,Female,GM0236,Geldermalsen,2015JJ00,2015,13284,,122,,107,,15,514,,52,462,527,,41,-1,486,-13,1,,13285
242876,4000,Female,GM0236,Geldermalsen,2016JJ00,2016,13285,,126,,88,,38,621,,38,583,535,,30,-3,505,86,123,,13408
242877,4000,Female,GM0236,Geldermalsen,2017JJ00,2017,13408,,115,,115,,0,747,,48,699,645,,35,-4,610,102,102,,13510
242878,4000,Female,GM0236,Geldermalsen,2018JJ00,2018,13510,,118,,123,,-5,678,,54,624,586,,32,0,554,92,94,,13604
243036,4000,Female,GM1771,Geldrop-Mierlo,2012JJ00,2012,19548,,169,,169,,0,757,,78,679,751,,71,-5,680,6,11,,19559
243037,4000,Female,GM1771,Geldrop-Mierlo,2013JJ00,2013,19559,,158,,176,,-18,801,,82,719,789,,93,-15,696,12,-4,,19555
243038,4000,Female,GM1771,Geldrop-Mierlo,2014JJ00,2014,19555,,175,,188,,-13,895,,88,807,859,,102,-16,757,36,24,,19579
243039,4000,Female,GM1771,Geldrop-Mierlo,2015JJ00,2015,19579,,168,,181,,-13,878,,73,805,840,,63,-8,777,38,26,,19605
243040,4000,Female,GM1771,Geldrop-Mierlo,2016JJ00,2016,19605,,142,,187,,-45,1011,,104,907,862,,71,-12,791,149,105,,19710
243041,4000,Female,GM1771,Geldrop-Mierlo,2017JJ00,2017,19710,,187,,191,,-4,1116,,94,1022,1036,,69,-5,967,80,77,,19787
243042,4000,Female,GM1771,Geldrop-Mierlo,2018JJ00,2018,19787,,182,,170,,12,1033,,84,949,877,,83,-4,794,156,166,,19953
243043,4000,Female,GM1771,Geldrop-Mierlo,2019JJ00,2019,19953,,164,,194,,-30,1005,,139,866,922,,77,-4,845,83,52,,20005
243044,4000,Female,GM1771,Geldrop-Mierlo,2020JJ00,2020,20005,,182,,216,,-34,1104,,118,986,942,,61,-5,881,162,127,,20132
243045,4000,Female,GM1771,Geldrop-Mierlo,2021JJ00,2021,20132,,184,,195,,-11,1002,,119,883,983,,70,-10,913,19,12,,20144
243046,4000,Female,GM1771,Geldrop-Mierlo,2022JJ00,2022,20144,,162,,203,,-41,1141,,290,851,989,,105,0,884,152,111,,20255
243047,4000,Female,GM1771,Geldrop-Mierlo,2023JJ00,2023,20255,,177,,182,,-5,1175,,197,978,986,,148,-26,838,189,184,,20439
243282,4000,Female,GM1652,Gemert-Bakel,2012JJ00,2012,14383,,151,,109,,42,521,,72,449,528,,54,-17,474,-7,37,,14420
243283,4000,Female,GM1652,Gemert-Bakel,2013JJ00,2013,14420,,154,,114,,40,536,,94,442,493,,42,-7,451,43,83,,14503
243284,4000,Female,GM1652,Gemert-Bakel,2014JJ00,2014,14503,,164,,116,,48,578,,85,493,538,,44,-9,494,40,89,,14592
243285,4000,Female,GM1652,Gemert-Bakel,2015JJ00,2015,14592,,153,,113,,40,606,,110,496,585,,50,-3,535,21,60,,14652
243286,4000,Female,GM1652,Gemert-Bakel,2016JJ00,2016,14652,,174,,114,,60,695,,113,582,557,,56,-12,501,138,200,,14852
243287,4000,Female,GM1652,Gemert-Bakel,2017JJ00,2017,14852,,152,,134,,18,773,,98,675,665,,55,-5,610,108,124,,14976
243288,4000,Female,GM1652,Gemert-Bakel,2018JJ00,2018,14976,,141,,134,,7,645,,98,547,597,,66,-19,531,48,55,,15031
243289,4000,Female,GM1652,Gemert-Bakel,2019JJ00,2019,15031,,135,,133,,2,694,,100,594,591,,72,-11,519,103,105,,15136
243290,4000,Female,GM1652,Gemert-Bakel,2020JJ00,2020,15136,,137,,116,,21,609,,85,524,592,,51,-14,541,17,38,,15174
243291,4000,Female,GM1652,Gemert-Bakel,2021JJ00,2021,15174,,181,,146,,35,702,,104,598,625,,65,-18,560,77,113,,15287
243292,4000,Female,GM1652,Gemert-Bakel,2022JJ00,2022,15287,,138,,136,,2,717,,194,523,529,,57,-17,472,188,189,,15476
243293,4000,Female,GM1652,Gemert-Bakel,2023JJ00,2023,15476,,149,,139,,10,628,,132,496,634,,83,-20,551,-6,4,,15480
243610,4000,Female,GM0907,Gennep,2012JJ00,2012,8499,,86,,75,,11,289,,35,254,326,,21,5,305,-37,-24,,8475
243611,4000,Female,GM0907,Gennep,2013JJ00,2013,8475,,98,,79,,19,301,,40,261,321,,23,4,298,-20,-1,,8474
243612,4000,Female,GM0907,Gennep,2014JJ00,2014,8474,,54,,61,,-7,300,,42,258,300,,18,1,282,0,-6,,8468
243613,4000,Female,GM0907,Gennep,2015JJ00,2015,8468,,71,,85,,-14,301,,39,262,405,,28,1,377,-104,-118,,8350
243614,4000,Female,GM0907,Gennep,2016JJ00,2016,8350,,60,,92,,-32,372,,42,330,306,,19,0,287,66,33,,8383
243615,4000,Female,GM0907,Gennep,2017JJ00,2017,8383,,69,,97,,-28,383,,39,344,394,,28,-5,366,-11,-37,,8346
243616,4000,Female,GM0907,Gennep,2018JJ00,2018,8346,,85,,101,,-16,344,,57,287,310,,14,0,296,34,17,,8363
243617,4000,Female,GM0907,Gennep,2019JJ00,2019,8363,,45,,78,,-33,333,,31,302,403,,18,-2,385,-70,-103,,8260
243618,4000,Female,GM0907,Gennep,2020JJ00,2020,8260,,62,,85,,-23,430,,61,369,337,,20,-1,317,93,70,,8330
243619,4000,Female,GM0907,Gennep,2021JJ00,2021,8330,,58,,93,,-35,438,,63,375,291,,24,-2,267,147,112,,8442
243620,4000,Female,GM0907,Gennep,2022JJ00,2022,8442,,72,,112,,-40,719,,324,395,340,,77,-9,263,379,337,,8779
243621,4000,Female,GM0907,Gennep,2023JJ00,2023,8779,,70,,104,,-34,401,,93,308,348,,56,-8,292,53,20,,8799
244020,4000,Female,GM0689,Giessenlanden,2012JJ00,2012,7130,,64,,28,,36,200,,14,186,255,,19,-2,236,-55,-18,,7112
244021,4000,Female,GM0689,Giessenlanden,2013JJ00,2013,7112,,64,,38,,26,245,,19,226,282,,17,2,265,-37,-12,,7100
244022,4000,Female,GM0689,Giessenlanden,2014JJ00,2014,7100,,56,,43,,13,280,,17,263,287,,13,1,274,-7,7,,7107
244023,4000,Female,GM0689,Giessenlanden,2015JJ00,2015,7107,,56,,43,,13,320,,20,300,295,,12,-2,283,25,38,,7145
244024,4000,Female,GM0689,Giessenlanden,2016JJ00,2016,7145,,60,,42,,18,356,,19,337,328,,12,-1,316,28,47,,7192
244025,4000,Female,GM0689,Giessenlanden,2017JJ00,2017,7192,,63,,40,,23,337,,30,307,372,,19,-2,353,-35,-13,,7179
244026,4000,Female,GM0689,Giessenlanden,2018JJ00,2018,7179,,68,,45,,23,333,,27,306,363,,28,-4,335,-30,0,,7179
244348,4000,Female,GM0784,Gilze en Rijen,2012JJ00,2012,12704,,122,,91,,31,576,,60,516,469,,46,-10,423,107,138,,12842
244349,4000,Female,GM0784,Gilze en Rijen,2013JJ00,2013,12842,,116,,98,,18,626,,106,520,487,,54,-14,433,139,157,,12999
244350,4000,Female,GM0784,Gilze en Rijen,2014JJ00,2014,12999,,128,,96,,32,574,,114,460,594,,62,-23,532,-20,16,,13015
244351,4000,Female,GM0784,Gilze en Rijen,2015JJ00,2015,13015,,120,,88,,32,669,,192,477,671,,53,-3,618,-2,29,,13044
244352,4000,Female,GM0784,Gilze en Rijen,2016JJ00,2016,13044,,124,,118,,6,1669,,1030,639,1639,,48,-8,1591,30,44,,13088
244353,4000,Female,GM0784,Gilze en Rijen,2017JJ00,2017,13088,,131,,107,,24,1012,,345,667,992,,67,-10,925,20,45,,13133
244354,4000,Female,GM0784,Gilze en Rijen,2018JJ00,2018,13133,,126,,105,,21,989,,417,572,905,,44,-10,861,84,106,,13239
244355,4000,Female,GM0784,Gilze en Rijen,2019JJ00,2019,13239,,128,,105,,23,975,,451,524,995,,61,-13,934,-20,10,,13249
244356,4000,Female,GM0784,Gilze en Rijen,2020JJ00,2020,13249,,129,,104,,25,1564,,722,842,1473,,46,-11,1427,91,127,,13376
244357,4000,Female,GM0784,Gilze en Rijen,2021JJ00,2021,13376,,128,,125,,3,1742,,1057,685,1890,,90,-26,1800,-148,-129,,13247
244358,4000,Female,GM0784,Gilze en Rijen,2022JJ00,2022,13247,,110,,138,,-28,1835,,1137,698,1750,,61,0,1689,85,65,,13312
244359,4000,Female,GM0784,Gilze en Rijen,2023JJ00,2023,13312,,113,,121,,-8,2092,,1360,732,1933,,71,-7,1862,159,171,,13483
244430,4000,Female,GM0511,Goedereede,2012JJ00,2012,5756,,46,,42,,4,131,,12,119,157,,13,-2,144,-26,-24,,5732
244513,4000,Female,GM1924,Goeree-Overflakkee,2013JJ00,2013,24373,,227,,219,,8,540,,72,468,522,,39,-2,483,18,18,,24391
244514,4000,Female,GM1924,Goeree-Overflakkee,2014JJ00,2014,24391,,240,,233,,7,548,,60,488,597,,68,-4,529,-49,-42,,24349
244515,4000,Female,GM1924,Goeree-Overflakkee,2015JJ00,2015,24349,,221,,238,,-17,608,,68,540,507,,57,-10,450,101,84,,24433
244516,4000,Female,GM1924,Goeree-Overflakkee,2016JJ00,2016,24433,,236,,212,,24,704,,64,640,548,,65,-1,483,156,178,,24611
244517,4000,Female,GM1924,Goeree-Overflakkee,2017JJ00,2017,24611,,227,,225,,2,851,,101,750,616,,60,-4,556,235,238,,24849
244518,4000,Female,GM1924,Goeree-Overflakkee,2018JJ00,2018,24849,,215,,234,,-19,855,,69,786,578,,46,-6,532,277,256,,25105
244519,4000,Female,GM1924,Goeree-Overflakkee,2019JJ00,2019,25105,,248,,260,,-12,893,,85,808,665,,58,-1,607,228,215,,25320
244520,4000,Female,GM1924,Goeree-Overflakkee,2020JJ00,2020,25320,,229,,287,,-58,968,,71,897,639,,49,0,590,329,270,,25590
244521,4000,Female,GM1924,Goeree-Overflakkee,2021JJ00,2021,25590,,267,,267,,0,886,,69,817,605,,59,-10,546,281,281,,25871
244522,4000,Female,GM1924,Goeree-Overflakkee,2022JJ00,2022,25871,,248,,290,,-42,992,,326,666,638,,141,-4,497,354,309,,26180
244523,4000,Female,GM1924,Goeree-Overflakkee,2023JJ00,2023,26180,,205,,280,,-75,863,,153,710,788,,130,-7,658,75,1,,26181
244594,4000,Female,GM0664,Goes,2012JJ00,2012,18875,,163,,214,,-51,1024,,252,772,970,,88,-19,882,54,3,,18878
244595,4000,Female,GM0664,Goes,2013JJ00,2013,18878,,159,,204,,-45,1014,,244,770,927,,67,9,860,87,40,,18918
244596,4000,Female,GM0664,Goes,2014JJ00,2014,18918,,154,,194,,-40,955,,152,803,856,,91,-14,765,99,59,,18977
244597,4000,Female,GM0664,Goes,2015JJ00,2015,18977,,136,,225,,-89,1000,,166,834,936,,94,-15,842,64,-22,,18955
244598,4000,Female,GM0664,Goes,2016JJ00,2016,18955,,149,,230,,-81,1076,,136,940,950,,64,-4,886,126,45,,19000
244599,4000,Female,GM0664,Goes,2017JJ00,2017,19000,,163,,200,,-37,1176,,122,1054,970,,77,-15,893,206,179,,19179
244600,4000,Female,GM0664,Goes,2018JJ00,2018,19179,,162,,235,,-73,1014,,104,910,913,,80,-23,833,101,26,,19205
244601,4000,Female,GM0664,Goes,2019JJ00,2019,19205,,155,,222,,-67,1170,,135,1035,916,,71,-4,845,254,185,,19390
244602,4000,Female,GM0664,Goes,2020JJ00,2020,19390,,170,,225,,-55,1102,,129,973,743,,78,-12,665,359,304,,19694
244603,4000,Female,GM0664,Goes,2021JJ00,2021,19694,,170,,253,,-83,1007,,137,870,779,,96,-7,683,228,145,,19839
244604,4000,Female,GM0664,Goes,2022JJ00,2022,19839,,172,,228,,-56,1167,,250,917,845,,121,-9,724,322,265,,20104
244605,4000,Female,GM0664,Goes,2023JJ00,2023,20104,,159,,251,,-92,1145,,262,883,984,,105,-19,879,161,67,,20171
244676,4000,Female,GM0785,Goirle,2012JJ00,2012,11492,,124,,106,,18,544,,44,500,467,,22,6,445,77,97,,11589
244677,4000,Female,GM0785,Goirle,2013JJ00,2013,11589,,127,,98,,29,606,,56,550,557,,29,-2,528,49,78,,11667
244678,4000,Female,GM0785,Goirle,2014JJ00,2014,11667,,109,,90,,19,491,,50,441,568,,33,-1,535,-77,-59,,11608
244679,4000,Female,GM0785,Goirle,2015JJ00,2015,11608,,125,,105,,20,581,,47,534,540,,21,1,519,41,62,,11670
244680,4000,Female,GM0785,Goirle,2016JJ00,2016,11670,,112,,86,,26,604,,40,564,527,,26,-2,501,77,104,,11774
244681,4000,Female,GM0785,Goirle,2017JJ00,2017,11774,,98,,88,,10,655,,42,613,556,,33,-1,523,99,109,,11883
244682,4000,Female,GM0785,Goirle,2018JJ00,2018,11914,,89,,109,,-20,663,,54,609,596,,42,-1,554,67,48,,11962
244683,4000,Female,GM0785,Goirle,2019JJ00,2019,11962,,99,,105,,-6,630,,43,587,536,,30,-4,506,94,88,,12050
244684,4000,Female,GM0785,Goirle,2020JJ00,2020,12050,,99,,130,,-31,656,,62,594,614,,30,1,584,42,9,,12059
244685,4000,Female,GM0785,Goirle,2021JJ00,2021,12059,,93,,103,,-10,612,,52,560,565,,35,1,530,47,38,,12097
244686,4000,Female,GM0785,Goirle,2022JJ00,2022,12097,,85,,103,,-18,675,,128,547,531,,57,-3,474,144,125,,12222
244687,4000,Female,GM0785,Goirle,2023JJ00,2023,12222,,76,,127,,-51,593,,67,526,517,,65,-5,452,76,23,,12245
244762,4000,Female,GM1942,Gooise Meren,2016JJ00,2016,29418,,233,,314,,-81,1959,,309,1650,1756,,210,-23,1546,203,119,,29537
244763,4000,Female,GM1942,Gooise Meren,2017JJ00,2017,29537,,242,,296,,-54,2015,,290,1725,1759,,205,-8,1554,256,195,,29732
244764,4000,Female,GM1942,Gooise Meren,2018JJ00,2018,29732,,215,,292,,-77,1957,,317,1640,1763,,190,-15,1573,194,113,,29845
244765,4000,Female,GM1942,Gooise Meren,2019JJ00,2019,29845,,273,,314,,-41,2005,,379,1626,1791,,211,-16,1580,214,172,,30017
244766,4000,Female,GM1942,Gooise Meren,2020JJ00,2020,30017,,237,,345,,-108,2260,,352,1908,1988,,202,-14,1786,272,163,,30180
244767,4000,Female,GM1942,Gooise Meren,2021JJ00,2021,30180,,286,,355,,-69,2180,,345,1835,1966,,230,-18,1736,214,150,,30330
244768,4000,Female,GM1942,Gooise Meren,2022JJ00,2022,30330,,261,,357,,-96,2824,,784,2040,1883,,294,-24,1589,941,840,,31170
244769,4000,Female,GM1942,Gooise Meren,2023JJ00,2023,31170,,271,,360,,-89,2257,,485,1772,2197,,369,-31,1828,60,-20,,31150
244922,4000,Female,GM0512,Gorinchem,2012JJ00,2012,17835,,191,,138,,53,644,,83,561,686,,101,-11,585,-42,12,,17847
244923,4000,Female,GM0512,Gorinchem,2013JJ00,2013,17847,,171,,152,,19,663,,102,561,668,,100,-24,568,-5,16,,17863
244924,4000,Female,GM0512,Gorinchem,2014JJ00,2014,17863,,194,,170,,24,708,,89,619,689,,96,-11,593,19,43,,17906
244925,4000,Female,GM0512,Gorinchem,2015JJ00,2015,17906,,164,,171,,-7,783,,109,674,787,,92,-19,695,-4,-13,,17893
244926,4000,Female,GM0512,Gorinchem,2016JJ00,2016,17893,,166,,172,,-6,1112,,150,962,889,,113,-8,776,223,215,,18108
244927,4000,Female,GM0512,Gorinchem,2017JJ00,2017,18108,,190,,177,,13,1228,,140,1088,970,,62,-7,908,258,269,,18377
244928,4000,Female,GM0512,Gorinchem,2018JJ00,2018,18377,,193,,182,,11,936,,129,807,813,,76,2,737,123,135,,18512
244929,4000,Female,GM0512,Gorinchem,2019JJ00,2019,18512,,166,,160,,6,956,,135,821,845,,85,-7,760,111,117,,18629
244930,4000,Female,GM0512,Gorinchem,2020JJ00,2020,18629,,198,,167,,31,949,,107,842,776,,89,-13,687,173,203,,18832
244931,4000,Female,GM0512,Gorinchem,2021JJ00,2021,18832,,210,,202,,8,969,,128,841,861,,76,-13,785,108,112,,18944
244932,4000,Female,GM0512,Gorinchem,2022JJ00,2022,18944,,184,,169,,15,1393,,285,1108,1000,,84,-6,916,393,404,,19348
244933,4000,Female,GM0512,Gorinchem,2023JJ00,2023,19348,,193,,190,,3,1177,,163,1014,1054,,88,-16,966,123,124,,19472
245086,4000,Female,GM0513,Gouda,2012JJ00,2012,36379,,396,,340,,56,1293,,150,1143,1528,,138,-16,1390,-235,-179,,36200
245087,4000,Female,GM0513,Gouda,2013JJ00,2013,36200,,392,,320,,72,1465,,213,1252,1527,,150,-8,1377,-62,8,,36208
245088,4000,Female,GM0513,Gouda,2014JJ00,2014,36208,,438,,346,,92,1507,,209,1298,1541,,163,-23,1378,-34,59,,36267
245089,4000,Female,GM0513,Gouda,2015JJ00,2015,36267,,396,,346,,50,1601,,224,1377,1586,,157,-25,1429,15,67,,36334
245090,4000,Female,GM0513,Gouda,2016JJ00,2016,36334,,374,,326,,48,1918,,391,1527,1750,,273,-43,1477,168,214,,36548
245091,4000,Female,GM0513,Gouda,2017JJ00,2017,36548,,381,,378,,3,2327,,358,1969,1861,,302,-77,1559,466,467,,37015
245092,4000,Female,GM0513,Gouda,2018JJ00,2018,37015,,373,,341,,32,2110,,353,1757,1881,,271,-62,1610,229,264,,37279
245093,4000,Female,GM0513,Gouda,2019JJ00,2019,37279,,415,,379,,36,1879,,314,1565,1808,,244,-29,1564,71,101,,37380
245094,4000,Female,GM0513,Gouda,2020JJ00,2020,37380,,352,,406,,-54,1998,,284,1714,1888,,179,-16,1709,110,57,,37437
245095,4000,Female,GM0513,Gouda,2021JJ00,2021,37437,,403,,370,,33,1950,,264,1686,1776,,198,-42,1578,174,204,,37641
245096,4000,Female,GM0513,Gouda,2022JJ00,2022,37641,,416,,403,,13,2448,,631,1817,1792,,254,-82,1538,656,673,,38314
245097,4000,Female,GM0513,Gouda,2023JJ00,2023,38314,,396,,392,,4,2071,,327,1744,1890,,275,-72,1615,181,181,,38495
245414,4000,Female,GM0693,Graafstroom,2012JJ00,2012,4784,,63,,32,,31,201,,8,193,173,,13,-2,160,28,56,,4840
245660,4000,Female,GM0365,Graft-De Rijp,2012JJ00,2012,3207,,15,,21,,-6,113,,12,101,111,,8,1,103,2,-4,,3203
245661,4000,Female,GM0365,Graft-De Rijp,2013JJ00,2013,3203,,23,,26,,-3,134,,23,111,125,,14,0,111,9,7,,3210
245662,4000,Female,GM0365,Graft-De Rijp,2014JJ00,2014,3210,,24,,24,,0,147,,16,131,167,,23,-3,144,-20,-20,,3190
245906,4000,Female,GM0786,Grave,2012JJ00,2012,6192,,55,,42,,13,352,,95,257,399,,17,-7,382,-47,-32,,6160
245907,4000,Female,GM0786,Grave,2013JJ00,2013,6160,,59,,61,,-2,468,,222,246,492,,24,-7,468,-24,-25,,6135
245908,4000,Female,GM0786,Grave,2014JJ00,2014,6135,,56,,48,,8,483,,219,264,457,,18,0,439,26,33,,6168
245909,4000,Female,GM0786,Grave,2015JJ00,2015,6168,,46,,57,,-11,423,,190,233,490,,21,-10,469,-67,-75,,6093
245910,4000,Female,GM0786,Grave,2016JJ00,2016,6093,,58,,49,,9,451,,94,357,503,,68,-49,435,-52,-44,,6049
245911,4000,Female,GM0786,Grave,2017JJ00,2017,6049,,47,,64,,-17,514,,51,463,449,,12,3,437,65,50,,6099
245912,4000,Female,GM0786,Grave,2018JJ00,2018,6099,,46,,54,,-8,481,,34,447,429,,15,-4,414,52,45,,6144
245913,4000,Female,GM0786,Grave,2019JJ00,2019,6144,,41,,54,,-13,374,,45,329,396,,22,-12,374,-22,-35,,6109
245914,4000,Female,GM0786,Grave,2020JJ00,2020,6109,,50,,86,,-36,450,,44,406,415,,28,-6,387,35,-1,,6108
245915,4000,Female,GM0786,Grave,2021JJ00,2021,6108,,51,,73,,-22,521,,23,498,471,,17,-8,454,50,25,,6133
246152,4000,Female,GM0518,The Hague,2012JJ00,2012,254189,,3359,,2271,,1088,15302,,6571,8731,14477,,5223,-1400,9254,825,1929,,256118
246153,4000,Female,GM0518,The Hague,2013JJ00,2013,256118,,3191,,2212,,979,16118,,7004,9114,15588,,6376,-2214,9212,530,1514,,257632
246154,4000,Female,GM0518,The Hague,2014JJ00,2014,257632,,3402,,2233,,1169,16950,,7419,9531,14996,,5132,-1069,9864,1954,3042,,260674
246155,4000,Female,GM0518,The Hague,2015JJ00,2015,260674,,3301,,2298,,1003,16831,,7160,9671,15449,,5010,-685,10439,1382,2272,,262946
246156,4000,Female,GM0518,The Hague,2016JJ00,2016,262946,,3309,,2289,,1020,17922,,7638,10284,16779,,5628,-1185,11151,1143,2099,,265045
246157,4000,Female,GM0518,The Hague,2017JJ00,2017,265045,,3202,,2233,,969,19175,,8562,10613,16548,,5289,-888,11259,2627,3541,,268586
246158,4000,Female,GM0518,The Hague,2018JJ00,2018,268586,,3236,,2241,,995,18535,,8557,9978,16892,,5436,-928,11456,1643,2469,,271055
246159,4000,Female,GM0518,The Hague,2019JJ00,2019,271055,,3162,,2091,,1071,19503,,9646,9857,16882,,5162,-464,11720,2621,3662,,274717
246160,4000,Female,GM0518,The Hague,2020JJ00,2020,274717,,2919,,2322,,597,18533,,7732,10801,18173,,5789,-976,12384,360,917,,275634
246161,4000,Female,GM0518,The Hague,2021JJ00,2021,275634,,2997,,2271,,726,19373,,8744,10629,17769,,4600,-138,13169,1604,2293,,277927
246162,4000,Female,GM0518,The Hague,2022JJ00,2022,277927,,2731,,2364,,367,22863,,12279,10584,18611,,5738,-533,12873,4252,4574,,282501
246163,4000,Female,GM0518,The Hague,2023JJ00,2023,282501,,2778,,2212,,566,21021,,10373,10648,20017,,6571,-787,13446,1004,1527,,284028
246890,4000,Female,GM0241,Groesbeek,2012JJ00,2012,9631,,76,,154,,-78,511,,45,466,377,,38,-3,339,134,57,,9688
246891,4000,Female,GM0241,Groesbeek,2013JJ00,2013,9688,,72,,175,,-103,503,,65,438,456,,44,-1,412,47,-56,,9632
246892,4000,Female,GM0241,Groesbeek,2014JJ00,2014,9632,,79,,144,,-65,486,,51,435,437,,45,-5,392,49,-15,,9617
246893,4000,Female,GM0241,Groesbeek,2015JJ00,2015,17277,,129,,227,,-98,875,,101,774,660,,56,2,604,215,107,,17384
246972,4000,Female,GM0014,Groningen Municipality,2012JJ00,2012,97498,,1030,,734,,296,9408,,2418,6990,8763,,2011,-332,6752,645,940,,98438
246973,4000,Female,GM0014,Groningen Municipality,2013JJ00,2013,98438,,1007,,689,,318,9910,,2448,7462,8774,,1925,-317,6849,1136,1455,,99893
246974,4000,Female,GM0014,Groningen Municipality,2014JJ00,2014,99893,,1010,,717,,293,10095,,2578,7517,9604,,2291,-452,7313,491,786,,100679
246975,4000,Female,GM0014,Groningen Municipality,2015JJ00,2015,100679,,1023,,709,,314,9641,,2483,7158,9842,,2184,-452,7658,-201,114,,100793
246976,4000,Female,GM0014,Groningen Municipality,2016JJ00,2016,100793,,961,,698,,263,10394,,3100,7294,10624,,2383,-507,8241,-230,26,,100819
246977,4000,Female,GM0014,Groningen Municipality,2017JJ00,2017,101321,,948,,713,,235,10612,,3220,7392,10657,,2501,-468,8156,-45,190,,101511
246978,4000,Female,GM0014,Groningen Municipality,2018JJ00,2018,101511,,874,,702,,172,10675,,3598,7077,10197,,2400,-267,7797,478,648,,102159
246979,4000,Female,GM0014,Groningen Municipality,2019JJ00,2019,116362,,937,,863,,74,10782,,3903,6879,10182,,2732,-380,7450,600,674,,117036
246980,4000,Female,GM0014,Groningen Municipality,2020JJ00,2020,117036,,961,,937,,24,10190,,3187,7003,10147,,2853,-410,7294,43,60,,117096
246981,4000,Female,GM0014,Groningen Municipality,2021JJ00,2021,117096,,1079,,957,,122,10455,,3846,6609,9610,,2291,-242,7319,845,960,,118056
246982,4000,Female,GM0014,Groningen Municipality,2022JJ00,2022,118056,,982,,972,,10,11609,,5189,6420,9712,,2602,-125,7110,1897,1893,,119949
246983,4000,Female,GM0014,Groningen Municipality,2023JJ00,2023,119949,,910,,978,,-68,12913,,4345,8568,9922,,2911,-153,7011,2991,2907,,122856
247300,4000,Female,GM0015,Grootegast,2012JJ00,2012,5993,,80,,60,,20,205,,11,194,228,,10,4,218,-23,-3,,5990
247301,4000,Female,GM0015,Grootegast,2013JJ00,2013,5990,,56,,50,,6,216,,16,200,258,,9,-1,249,-42,-37,,5953
247302,4000,Female,GM0015,Grootegast,2014JJ00,2014,5953,,58,,35,,23,259,,12,247,283,,10,-1,273,-24,1,,5954
247303,4000,Female,GM0015,Grootegast,2015JJ00,2015,5954,,57,,43,,14,287,,14,273,293,,17,-2,276,-6,7,,5961
247304,4000,Female,GM0015,Grootegast,2016JJ00,2016,5961,,62,,44,,18,296,,13,283,302,,6,0,296,-6,12,,5973
247305,4000,Female,GM0015,Grootegast,2017JJ00,2017,5973,,65,,45,,20,281,,5,276,308,,6,0,302,-27,-7,,5966
247306,4000,Female,GM0015,Grootegast,2018JJ00,2018,5966,,59,,65,,-6,305,,10,295,291,,8,1,283,14,16,,5982
247546,4000,Female,GM1729,Gulpen-Wittem,2012JJ00,2012,7203,,38,,80,,-42,319,,43,276,285,,22,-1,263,34,-8,,7195
247547,4000,Female,GM1729,Gulpen-Wittem,2013JJ00,2013,7195,,36,,73,,-37,336,,39,297,282,,30,-2,252,54,17,,7212
247548,4000,Female,GM1729,Gulpen-Wittem,2014JJ00,2014,7212,,47,,71,,-24,299,,44,255,282,,30,-6,252,17,-7,,7205
247549,4000,Female,GM1729,Gulpen-Wittem,2015JJ00,2015,7205,,43,,80,,-37,438,,155,283,438,,33,-4,405,0,-40,,7165
247550,4000,Female,GM1729,Gulpen-Wittem,2016JJ00,2016,7165,,52,,98,,-46,437,,99,338,455,,30,1,425,-18,-64,,7101
247551,4000,Female,GM1729,Gulpen-Wittem,2017JJ00,2017,7101,,50,,99,,-49,339,,41,298,372,,33,-4,339,-33,-86,,7015
247552,4000,Female,GM1729,Gulpen-Wittem,2018JJ00,2018,7015,,48,,93,,-45,355,,34,321,295,,27,-5,268,60,13,,7028
247553,4000,Female,GM1729,Gulpen-Wittem,2019JJ00,2019,7028,,44,,73,,-29,318,,39,279,314,,34,-6,280,4,-25,,7003
247554,4000,Female,GM1729,Gulpen-Wittem,2020JJ00,2020,7003,,47,,97,,-50,368,,41,327,269,,22,-3,247,99,48,,7051
247555,4000,Female,GM1729,Gulpen-Wittem,2021JJ00,2021,7051,,51,,90,,-39,338,,36,302,296,,26,-4,270,42,3,,7054
247556,4000,Female,GM1729,Gulpen-Wittem,2022JJ00,2022,7054,,59,,88,,-29,411,,95,316,325,,36,-8,289,86,57,,7111
247557,4000,Female,GM1729,Gulpen-Wittem,2023JJ00,2023,7111,,51,,101,,-50,288,,31,257,337,,50,-7,287,-49,-101,,7010
247710,4000,Female,GM0158,Haaksbergen,2012JJ00,2012,12128,,84,,113,,-29,347,,28,319,356,,18,2,338,-9,-37,,12091
247711,4000,Female,GM0158,Haaksbergen,2013JJ00,2013,12091,,103,,100,,3,355,,18,337,354,,20,1,334,1,5,,12096
247712,4000,Female,GM0158,Haaksbergen,2014JJ00,2014,12096,,93,,111,,-18,387,,28,359,367,,30,4,337,20,2,,12098
247713,4000,Female,GM0158,Haaksbergen,2015JJ00,2015,12098,,102,,116,,-14,392,,49,343,364,,33,3,331,28,14,,12112
247714,4000,Female,GM0158,Haaksbergen,2016JJ00,2016,12112,,95,,147,,-52,425,,33,392,399,,26,4,373,26,-26,,12086
247715,4000,Female,GM0158,Haaksbergen,2017JJ00,2017,12086,,105,,113,,-8,464,,24,440,400,,16,1,384,64,55,,12141
247716,4000,Female,GM0158,Haaksbergen,2018JJ00,2018,12141,,83,,120,,-37,436,,41,395,411,,35,0,376,25,-13,,12128
247717,4000,Female,GM0158,Haaksbergen,2019JJ00,2019,12128,,88,,121,,-33,387,,39,348,398,,20,2,378,-11,-44,,12084
247718,4000,Female,GM0158,Haaksbergen,2020JJ00,2020,12084,,107,,137,,-30,435,,29,406,416,,14,1,402,19,-10,,12074
247719,4000,Female,GM0158,Haaksbergen,2021JJ00,2021,12074,,116,,146,,-30,453,,43,410,370,,31,4,339,83,53,,12127
247720,4000,Female,GM0158,Haaksbergen,2022JJ00,2022,12127,,91,,153,,-62,618,,184,434,395,,35,0,360,223,159,,12286
247721,4000,Female,GM0158,Haaksbergen,2023JJ00,2023,12286,,93,,163,,-70,452,,81,371,494,,55,0,439,-42,-113,,12173
247874,4000,Female,GM0788,Haaren,2012JJ00,2012,6663,,43,,55,,-12,286,,22,264,337,,29,-2,308,-51,-66,,6597
247875,4000,Female,GM0788,Haaren,2013JJ00,2013,6597,,41,,36,,5,292,,28,264,280,,10,3,270,12,15,,6612
247876,4000,Female,GM0788,Haaren,2014JJ00,2014,6612,,35,,36,,-1,308,,25,283,347,,29,-2,318,-39,-38,,6574
247877,4000,Female,GM0788,Haaren,2015JJ00,2015,6574,,40,,40,,0,342,,18,324,312,,15,-2,297,30,28,,6602
247878,4000,Female,GM0788,Haaren,2016JJ00,2016,6602,,38,,44,,-6,561,,63,498,340,,29,0,311,221,215,,6817
247879,4000,Female,GM0788,Haaren,2017JJ00,2017,6817,,54,,52,,2,493,,47,446,367,,42,-2,325,126,127,,6944
247880,4000,Female,GM0788,Haaren,2018JJ00,2018,6944,,58,,70,,-12,403,,37,366,341,,20,-2,321,62,50,,6994
247881,4000,Female,GM0788,Haaren,2019JJ00,2019,6994,,53,,58,,-5,406,,26,380,311,,23,-2,288,95,91,,7085
247882,4000,Female,GM0788,Haaren,2020JJ00,2020,7085,,62,,65,,-3,322,,18,304,359,,7,0,352,-37,-42,,7043
247956,4000,Female,GM0392,Haarlem,2012JJ00,2012,77896,,935,,806,,129,4127,,772,3355,3712,,572,-129,3140,415,542,,78438
247957,4000,Female,GM0392,Haarlem,2013JJ00,2013,78438,,912,,739,,173,4467,,792,3675,3708,,605,-72,3103,759,930,,79368
247958,4000,Female,GM0392,Haarlem,2014JJ00,2014,79368,,976,,740,,236,4818,,766,4052,4247,,704,-166,3543,571,796,,80164
247959,4000,Female,GM0392,Haarlem,2015JJ00,2015,80164,,940,,854,,86,5095,,804,4291,4596,,649,-79,3947,499,579,,80743
247960,4000,Female,GM0392,Haarlem,2016JJ00,2016,80743,,840,,771,,69,5409,,981,4428,5014,,656,-64,4358,395,455,,81198
247961,4000,Female,GM0392,Haarlem,2017JJ00,2017,81198,,891,,775,,116,5417,,1017,4400,5217,,736,-75,4481,200,322,,81520
247962,4000,Female,GM0392,Haarlem,2018JJ00,2018,81520,,877,,798,,79,5495,,1196,4299,4826,,710,-48,4116,669,745,,82265
247963,4000,Female,GM0392,Haarlem,2019JJ00,2019,82265,,912,,763,,149,5776,,1324,4452,5196,,732,-55,4464,580,727,,82992
247964,4000,Female,GM0392,Haarlem,2020JJ00,2020,82992,,916,,816,,100,5375,,1084,4291,5751,,719,-73,5032,-376,-285,,82707
247965,4000,Female,GM0392,Haarlem,2021JJ00,2021,82707,,960,,801,,159,5610,,1053,4557,5604,,700,-53,4904,6,162,,82869
247966,4000,Female,GM0392,Haarlem,2022JJ00,2022,82869,,875,,841,,34,6760,,2009,4751,5377,,832,-54,4545,1383,1417,,84286
247967,4000,Female,GM0392,Haarlem,2023JJ00,2023,84286,,862,,774,,88,6455,,1423,5032,5434,,942,-96,4492,1021,1099,,85385
248038,4000,Female,GM0393,Haarlemmerliede en Spaarnwoude,2012JJ00,2012,2774,,31,,11,,20,163,,14,149,160,,15,-3,145,3,23,,2797
248039,4000,Female,GM0393,Haarlemmerliede en Spaarnwoude,2013JJ00,2013,2797,,25,,22,,3,160,,13,147,145,,10,-1,135,15,18,,2815
248040,4000,Female,GM0393,Haarlemmerliede en Spaarnwoude,2014JJ00,2014,2815,,18,,9,,9,175,,14,161,171,,7,-1,164,4,15,,2830
248041,4000,Female,GM0393,Haarlemmerliede en Spaarnwoude,2015JJ00,2015,2830,,15,,12,,3,150,,11,139,162,,12,-1,150,-12,-9,,2821
248042,4000,Female,GM0393,Haarlemmerliede en Spaarnwoude,2016JJ00,2016,2821,,23,,14,,9,214,,11,203,195,,10,-4,185,19,28,,2849
248043,4000,Female,GM0393,Haarlemmerliede en Spaarnwoude,2017JJ00,2017,2849,,26,,15,,11,255,,12,243,177,,6,-1,171,78,89,,2938
248044,4000,Female,GM0393,Haarlemmerliede en Spaarnwoude,2018JJ00,2018,2938,,36,,12,,24,301,,75,226,194,,19,-2,175,107,130,,3068
248120,4000,Female,GM0394,Haarlemmermeer,2012JJ00,2012,72389,,667,,414,,253,2751,,588,2163,2956,,481,-78,2475,-205,53,,72442
248121,4000,Female,GM0394,Haarlemmermeer,2013JJ00,2013,72442,,666,,410,,256,2724,,625,2099,2966,,442,-39,2524,-242,13,,72455
248122,4000,Female,GM0394,Haarlemmermeer,2014JJ00,2014,72362,,634,,443,,191,3451,,1047,2404,3495,,421,-48,3074,-44,148,,72510
248123,4000,Female,GM0394,Haarlemmermeer,2015JJ00,2015,72510,,587,,475,,112,3706,,986,2720,3636,,509,-99,3127,70,181,,72691
248124,4000,Female,GM0394,Haarlemmermeer,2016JJ00,2016,72691,,663,,506,,157,4396,,1099,3297,3881,,521,-94,3360,515,674,,73365
248125,4000,Female,GM0394,Haarlemmermeer,2017JJ00,2017,73365,,645,,474,,171,4357,,975,3382,3872,,541,-86,3331,485,651,,74016
248126,4000,Female,GM0394,Haarlemmermeer,2018JJ00,2018,74016,,625,,503,,122,4373,,1266,3107,4096,,544,-98,3552,277,394,,74410
248127,4000,Female,GM0394,Haarlemmermeer,2019JJ00,2019,77478,,691,,546,,145,5040,,1635,3405,4339,,578,-82,3761,701,847,,78325
248128,4000,Female,GM0394,Haarlemmermeer,2020JJ00,2020,78325,,773,,531,,242,4900,,1032,3868,4238,,597,-136,3641,662,901,,79226
248129,4000,Female,GM0394,Haarlemmermeer,2021JJ00,2021,79226,,765,,560,,205,4719,,970,3749,4074,,545,-82,3529,645,849,,80075
248130,4000,Female,GM0394,Haarlemmermeer,2022JJ00,2022,80075,,743,,644,,99,6374,,2463,3911,4927,,766,-80,4161,1447,1536,,81611
248131,4000,Female,GM0394,Haarlemmermeer,2023JJ00,2023,81611,,715,,531,,184,5705,,1590,4115,5488,,890,-167,4598,217,411,,82022
248530,4000,Female,GM1655,Halderberge,2012JJ00,2012,14762,,106,,131,,-25,558,,75,483,560,,53,-5,507,-2,-27,,14735
248531,4000,Female,GM1655,Halderberge,2013JJ00,2013,14735,,110,,135,,-25,642,,98,544,582,,59,-4,523,60,37,,14772
248532,4000,Female,GM1655,Halderberge,2014JJ00,2014,14772,,145,,134,,11,692,,83,609,602,,72,5,530,90,96,,14868
248533,4000,Female,GM1655,Halderberge,2015JJ00,2015,14868,,101,,127,,-26,682,,98,584,642,,70,-2,572,40,17,,14885
248534,4000,Female,GM1655,Halderberge,2016JJ00,2016,14885,,156,,153,,3,708,,77,631,702,,55,-5,647,6,7,,14892
248535,4000,Female,GM1655,Halderberge,2017JJ00,2017,14892,,126,,135,,-9,837,,115,722,698,,69,-3,629,139,131,,15023
248536,4000,Female,GM1655,Halderberge,2018JJ00,2018,15023,,113,,158,,-45,834,,135,699,677,,96,-28,581,157,111,,15134
248537,4000,Female,GM1655,Halderberge,2019JJ00,2019,15134,,111,,144,,-33,824,,101,723,700,,98,-45,602,124,88,,15222
248538,4000,Female,GM1655,Halderberge,2020JJ00,2020,15222,,125,,175,,-50,807,,97,710,689,,70,-13,619,118,67,,15289
248539,4000,Female,GM1655,Halderberge,2021JJ00,2021,15289,,136,,172,,-36,872,,123,749,655,,82,-18,573,217,181,,15470
248540,4000,Female,GM1655,Halderberge,2022JJ00,2022,15470,,124,,197,,-73,905,,219,686,703,,90,-10,613,202,126,,15596
248541,4000,Female,GM1655,Halderberge,2023JJ00,2023,15596,,120,,169,,-49,838,,150,688,732,,91,-19,641,106,58,,15654
248858,4000,Female,GM0160,Hardenberg,2012JJ00,2012,29325,,343,,230,,113,794,,70,724,802,,61,-5,741,-8,105,,29430
248859,4000,Female,GM0160,Hardenberg,2013JJ00,2013,29430,,311,,244,,67,737,,74,663,794,,57,-8,737,-57,9,,29439
248860,4000,Female,GM0160,Hardenberg,2014JJ00,2014,29439,,318,,216,,102,730,,45,685,812,,48,0,764,-82,21,,29460
248861,4000,Female,GM0160,Hardenberg,2015JJ00,2015,29460,,312,,232,,80,831,,81,750,867,,79,-5,788,-36,46,,29506
248862,4000,Female,GM0160,Hardenberg,2016JJ00,2016,29506,,319,,248,,71,1037,,87,950,862,,59,2,803,175,247,,29753
248863,4000,Female,GM0160,Hardenberg,2017JJ00,2017,29753,,299,,246,,53,1120,,111,1009,1076,,59,-6,1017,44,99,,29852
248864,4000,Female,GM0160,Hardenberg,2018JJ00,2018,29852,,324,,290,,34,1053,,118,935,1089,,44,-2,1045,-36,-3,,29849
248865,4000,Female,GM0160,Hardenberg,2019JJ00,2019,29849,,299,,246,,53,1115,,181,934,999,,64,-5,935,116,172,,30021
248866,4000,Female,GM0160,Hardenberg,2020JJ00,2020,30021,,291,,248,,43,1089,,118,971,944,,60,-14,884,145,183,,30204
248867,4000,Female,GM0160,Hardenberg,2021JJ00,2021,30204,,322,,259,,63,1152,,67,1085,1021,,61,-14,960,131,192,,30396
248868,4000,Female,GM0160,Hardenberg,2022JJ00,2022,30396,,305,,276,,29,1354,,227,1127,998,,118,-25,880,356,387,,30783
248869,4000,Female,GM0160,Hardenberg,2023JJ00,2023,30783,,316,,248,,68,1127,,104,1023,1017,,127,-30,890,110,176,,30959
248940,4000,Female,GM0243,Harderwijk,2012JJ00,2012,23053,,307,,184,,123,845,,104,741,834,,70,-9,764,11,134,,23187
248941,4000,Female,GM0243,Harderwijk,2013JJ00,2013,23187,,247,,160,,87,783,,103,680,829,,67,-15,762,-46,42,,23229
248942,4000,Female,GM0243,Harderwijk,2014JJ00,2014,23229,,265,,180,,85,868,,118,750,963,,102,-12,861,-95,-8,,23221
248943,4000,Female,GM0243,Harderwijk,2015JJ00,2015,23221,,247,,192,,55,916,,114,802,932,,74,-11,858,-16,38,,23259
248944,4000,Female,GM0243,Harderwijk,2016JJ00,2016,23259,,252,,195,,57,955,,110,845,831,,81,0,750,124,180,,23439
248945,4000,Female,GM0243,Harderwijk,2017JJ00,2017,23439,,266,,175,,91,1270,,122,1148,1107,,51,4,1056,163,255,,23694
248946,4000,Female,GM0243,Harderwijk,2018JJ00,2018,23694,,228,,179,,49,1516,,149,1367,1189,,64,-6,1125,327,377,,24071
248947,4000,Female,GM0243,Harderwijk,2019JJ00,2019,24071,,259,,197,,62,1456,,162,1294,1140,,86,-12,1054,316,379,,24450
248948,4000,Female,GM0243,Harderwijk,2020JJ00,2020,24450,,234,,185,,49,1380,,140,1240,1235,,112,-33,1123,145,187,,24637
248949,4000,Female,GM0243,Harderwijk,2021JJ00,2021,24637,,260,,233,,27,1250,,105,1145,1234,,82,-6,1152,16,43,,24680
248950,4000,Female,GM0243,Harderwijk,2022JJ00,2022,24680,,222,,224,,-2,1234,,196,1038,1252,,95,-12,1157,-18,-20,,24660
248951,4000,Female,GM0243,Harderwijk,2023JJ00,2023,24660,,216,,221,,-5,1400,,178,1222,1125,,127,-40,998,275,269,,24929
249104,4000,Female,GM0523,Hardinxveld-Giessendam,2012JJ00,2012,8886,,104,,72,,32,213,,10,203,234,,7,1,227,-21,8,,8894
249105,4000,Female,GM0523,Hardinxveld-Giessendam,2013JJ00,2013,8894,,99,,78,,21,221,,20,201,217,,10,2,207,4,27,,8921
249106,4000,Female,GM0523,Hardinxveld-Giessendam,2014JJ00,2014,8921,,102,,81,,21,239,,22,217,273,,18,0,255,-34,-12,,8909
249107,4000,Female,GM0523,Hardinxveld-Giessendam,2015JJ00,2015,8909,,107,,96,,11,273,,33,240,315,,17,-3,298,-42,-31,,8878
249108,4000,Female,GM0523,Hardinxveld-Giessendam,2016JJ00,2016,8878,,125,,88,,37,351,,24,327,339,,10,4,329,12,49,,8927
249109,4000,Female,GM0523,Hardinxveld-Giessendam,2017JJ00,2017,8927,,106,,77,,29,341,,15,326,326,,10,1,316,15,44,,8971
249110,4000,Female,GM0523,Hardinxveld-Giessendam,2018JJ00,2018,8971,,106,,80,,26,353,,28,325,313,,16,-3,297,40,66,,9037
249111,4000,Female,GM0523,Hardinxveld-Giessendam,2019JJ00,2019,9037,,106,,95,,11,378,,24,354,271,,3,-1,268,107,126,,9163
249112,4000,Female,GM0523,Hardinxveld-Giessendam,2020JJ00,2020,9163,,120,,102,,18,365,,18,347,295,,13,-1,282,70,88,,9251
249113,4000,Female,GM0523,Hardinxveld-Giessendam,2021JJ00,2021,9251,,122,,91,,31,358,,19,339,349,,9,-1,340,9,41,,9292
249114,4000,Female,GM0523,Hardinxveld-Giessendam,2022JJ00,2022,9292,,122,,74,,48,421,,159,262,349,,54,-3,295,72,120,,9412
249115,4000,Female,GM0523,Hardinxveld-Giessendam,2023JJ00,2023,9412,,105,,108,,-3,374,,46,328,349,,34,0,315,25,22,,9434
249186,4000,Female,GM0017,Haren,2012JJ00,2012,9728,,62,,148,,-86,714,,66,648,530,,63,-8,467,184,98,,9826
249187,4000,Female,GM0017,Haren,2013JJ00,2013,9826,,72,,159,,-87,677,,64,613,562,,45,-5,517,115,28,,9854
249188,4000,Female,GM0017,Haren,2014JJ00,2014,9854,,71,,153,,-82,699,,60,639,553,,40,-7,513,146,64,,9918
249189,4000,Female,GM0017,Haren,2015JJ00,2015,9918,,80,,151,,-71,871,,196,675,759,,50,0,709,112,44,,9962
249190,4000,Female,GM0017,Haren,2016JJ00,2016,9962,,77,,186,,-109,1052,,128,924,663,,45,0,618,389,279,,10241
249191,4000,Female,GM0017,Haren,2017JJ00,2017,10241,,87,,170,,-83,948,,61,887,723,,47,-7,676,225,141,,10382
249192,4000,Female,GM0017,Haren,2018JJ00,2018,10382,,96,,148,,-52,798,,52,746,592,,41,-3,551,206,148,,10530
249268,4000,Female,GM0395,Harenkarspel,2012JJ00,2012,7893,,82,,61,,21,289,,23,266,351,,32,-4,319,-62,-38,,7855
249350,4000,Female,GM0072,Harlingen,2012JJ00,2012,7887,,71,,93,,-22,280,,32,248,263,,12,-6,251,17,-6,,7881
249351,4000,Female,GM0072,Harlingen,2013JJ00,2013,7881,,71,,85,,-14,306,,33,273,289,,33,-8,256,17,4,,7885
249352,4000,Female,GM0072,Harlingen,2014JJ00,2014,7885,,67,,92,,-25,294,,31,263,303,,21,2,282,-9,-34,,7851
249353,4000,Female,GM0072,Harlingen,2015JJ00,2015,7851,,66,,95,,-29,351,,51,300,331,,28,-4,303,20,-8,,7843
249354,4000,Female,GM0072,Harlingen,2016JJ00,2016,7843,,79,,93,,-14,332,,23,309,295,,40,-7,255,37,24,,7867
249355,4000,Female,GM0072,Harlingen,2017JJ00,2017,7867,,55,,104,,-49,344,,22,322,328,,20,-4,308,16,-33,,7834
249356,4000,Female,GM0072,Harlingen,2018JJ00,2018,7834,,68,,93,,-25,320,,28,292,294,,18,-1,276,26,0,,7834
249357,4000,Female,GM0072,Harlingen,2019JJ00,2019,7834,,50,,93,,-43,363,,29,334,312,,17,1,295,51,9,,7843
249358,4000,Female,GM0072,Harlingen,2020JJ00,2020,7843,,47,,97,,-50,383,,34,349,295,,12,0,283,88,38,,7881
249359,4000,Female,GM0072,Harlingen,2021JJ00,2021,7881,,87,,105,,-18,370,,40,330,295,,14,-2,281,75,57,,7938
249360,4000,Female,GM0072,Harlingen,2022JJ00,2022,7938,,59,,103,,-44,469,,105,364,290,,29,-6,261,179,135,,8073
249361,4000,Female,GM0072,Harlingen,2023JJ00,2023,8073,,59,,99,,-40,355,,41,314,311,,38,-7,273,44,2,,8075
249678,4000,Female,GM0244,Hattem,2012JJ00,2012,6020,,44,,47,,-3,204,,13,191,206,,13,0,193,-2,-5,,6015
249679,4000,Female,GM0244,Hattem,2013JJ00,2013,6015,,49,,58,,-9,214,,15,199,245,,23,2,222,-31,-40,,5975
249680,4000,Female,GM0244,Hattem,2014JJ00,2014,5975,,42,,53,,-11,280,,13,267,249,,15,-5,234,31,19,,5994
249681,4000,Female,GM0244,Hattem,2015JJ00,2015,5994,,60,,51,,9,312,,29,283,263,,16,-1,247,49,57,,6051
249682,4000,Female,GM0244,Hattem,2016JJ00,2016,6051,,45,,50,,-5,326,,6,320,263,,16,0,247,63,58,,6109
249683,4000,Female,GM0244,Hattem,2017JJ00,2017,6109,,57,,50,,7,314,,24,290,284,,11,2,273,30,37,,6146
249684,4000,Female,GM0244,Hattem,2018JJ00,2018,6146,,48,,67,,-19,286,,14,272,293,,12,-2,281,-7,-25,,6121
249685,4000,Female,GM0244,Hattem,2019JJ00,2019,6121,,51,,63,,-12,304,,14,290,263,,10,-2,253,41,29,,6150
249686,4000,Female,GM0244,Hattem,2020JJ00,2020,6150,,59,,61,,-2,289,,18,271,267,,10,0,257,22,20,,6170
249687,4000,Female,GM0244,Hattem,2021JJ00,2021,6170,,61,,57,,4,283,,8,275,243,,18,0,225,40,44,,6214
249688,4000,Female,GM0244,Hattem,2022JJ00,2022,6214,,53,,63,,-10,381,,73,308,232,,17,1,215,149,138,,6352
249689,4000,Female,GM0244,Hattem,2023JJ00,2023,6352,,71,,74,,-3,317,,19,298,271,,16,0,255,46,43,,6395
250170,4000,Female,GM0396,Heemskerk,2012JJ00,2012,20023,,166,,209,,-43,837,,75,762,912,,78,-9,834,-75,-118,,19905
250171,4000,Female,GM0396,Heemskerk,2013JJ00,2013,19905,,173,,189,,-16,897,,98,799,850,,69,1,781,47,31,,19936
250172,4000,Female,GM0396,Heemskerk,2014JJ00,2014,19936,,166,,199,,-33,919,,75,844,894,,92,-11,802,25,-8,,19928
250173,4000,Female,GM0396,Heemskerk,2015JJ00,2015,19928,,163,,198,,-35,1056,,63,993,946,,105,-12,841,110,73,,20001
250174,4000,Female,GM0396,Heemskerk,2016JJ00,2016,20001,,179,,220,,-41,959,,81,878,949,,64,-3,885,10,-31,,19970
250175,4000,Female,GM0396,Heemskerk,2017JJ00,2017,19970,,161,,164,,-3,911,,73,838,889,,80,3,809,22,19,,19989
250176,4000,Female,GM0396,Heemskerk,2018JJ00,2018,19989,,163,,227,,-64,918,,105,813,849,,66,-11,783,69,6,,19995
250177,4000,Female,GM0396,Heemskerk,2019JJ00,2019,19995,,157,,202,,-45,926,,88,838,876,,64,-8,812,50,3,,19998
250178,4000,Female,GM0396,Heemskerk,2020JJ00,2020,19998,,177,,203,,-26,921,,58,863,850,,51,0,799,71,44,,20042
250179,4000,Female,GM0396,Heemskerk,2021JJ00,2021,20042,,183,,210,,-27,858,,72,786,825,,64,-4,761,33,3,,20045
250180,4000,Female,GM0396,Heemskerk,2022JJ00,2022,20045,,188,,229,,-41,1061,,145,916,911,,84,-4,827,150,105,,20150
250181,4000,Female,GM0396,Heemskerk,2023JJ00,2023,20150,,159,,246,,-87,918,,89,829,819,,96,-4,723,99,9,,20159
250252,4000,Female,GM0397,Heemstede,2012JJ00,2012,13891,,86,,172,,-86,811,,113,698,671,,85,-7,586,140,55,,13946
250253,4000,Female,GM0397,Heemstede,2013JJ00,2013,13946,,112,,161,,-49,856,,131,725,748,,102,-4,646,108,59,,14005
250254,4000,Female,GM0397,Heemstede,2014JJ00,2014,14005,,104,,150,,-46,981,,113,868,842,,121,-8,721,139,92,,14097
250255,4000,Female,GM0397,Heemstede,2015JJ00,2015,14097,,95,,198,,-103,1126,,132,994,872,,117,-8,755,254,152,,14249
250256,4000,Female,GM0397,Heemstede,2016JJ00,2016,14249,,110,,192,,-82,1017,,134,883,910,,96,-4,814,107,26,,14275
250257,4000,Female,GM0397,Heemstede,2017JJ00,2017,14275,,108,,197,,-89,1064,,133,931,927,,82,-9,845,137,47,,14322
250258,4000,Female,GM0397,Heemstede,2018JJ00,2018,14322,,115,,179,,-64,991,,179,812,862,,92,-7,770,129,64,,14386
250259,4000,Female,GM0397,Heemstede,2019JJ00,2019,14386,,115,,195,,-80,962,,156,806,910,,112,-10,798,52,-27,,14359
250260,4000,Female,GM0397,Heemstede,2020JJ00,2020,14359,,110,,229,,-119,1138,,113,1025,912,,89,1,823,226,108,,14467
250261,4000,Female,GM0397,Heemstede,2021JJ00,2021,14467,,115,,199,,-84,986,,126,860,889,,94,2,795,97,12,,14479
250262,4000,Female,GM0397,Heemstede,2022JJ00,2022,14479,,97,,187,,-90,1092,,246,846,848,,115,-1,733,244,156,,14635
250263,4000,Female,GM0397,Heemstede,2023JJ00,2023,14635,,105,,239,,-134,913,,153,760,933,,123,1,810,-20,-153,,14482
250662,4000,Female,GM0246,Heerde,2012JJ00,2012,9246,,84,,93,,-9,369,,25,344,250,,18,-6,232,119,109,,9355
250663,4000,Female,GM0246,Heerde,2013JJ00,2013,9355,,83,,71,,12,315,,26,289,285,,14,3,271,30,42,,9397
250664,4000,Female,GM0246,Heerde,2014JJ00,2014,9397,,100,,110,,-10,326,,12,314,295,,11,0,284,31,21,,9418
250665,4000,Female,GM0246,Heerde,2015JJ00,2015,9418,,82,,110,,-28,351,,27,324,328,,15,2,313,23,-2,,9416
250666,4000,Female,GM0246,Heerde,2016JJ00,2016,9416,,92,,113,,-21,383,,18,365,362,,18,-2,344,21,-1,,9415
250667,4000,Female,GM0246,Heerde,2017JJ00,2017,9415,,83,,109,,-26,404,,23,381,365,,25,-1,340,39,13,,9428
250668,4000,Female,GM0246,Heerde,2018JJ00,2018,9428,,72,,110,,-38,432,,21,411,425,,16,0,409,7,-31,,9397
250669,4000,Female,GM0246,Heerde,2019JJ00,2019,9397,,78,,145,,-67,416,,27,389,334,,19,1,315,82,14,,9411
250670,4000,Female,GM0246,Heerde,2020JJ00,2020,9411,,83,,131,,-48,520,,43,477,360,,21,-1,339,160,111,,9522
250671,4000,Female,GM0246,Heerde,2021JJ00,2021,9522,,72,,111,,-39,499,,21,478,389,,19,0,370,110,70,,9592
250672,4000,Female,GM0246,Heerde,2022JJ00,2022,9592,,69,,132,,-63,551,,145,406,360,,41,-9,319,191,127,,9719
250673,4000,Female,GM0246,Heerde,2023JJ00,2023,9719,,106,,101,,5,406,,46,360,385,,40,-2,345,21,27,,9746
250826,4000,Female,GM0074,Heerenveen,2012JJ00,2012,22113,,188,,213,,-25,867,,70,797,988,,75,-11,913,-121,-146,,21967
250827,4000,Female,GM0074,Heerenveen,2013JJ00,2013,21967,,203,,196,,7,893,,67,826,918,,54,-8,864,-25,-21,,21946
250828,4000,Female,GM0074,Heerenveen,2014JJ00,2014,25287,,260,,245,,15,1107,,93,1014,1018,,54,-14,964,89,107,,25394
250829,4000,Female,GM0074,Heerenveen,2015JJ00,2015,25394,,216,,272,,-56,1179,,103,1076,1115,,86,-13,1029,64,6,,25400
250830,4000,Female,GM0074,Heerenveen,2016JJ00,2016,25400,,227,,301,,-74,1166,,100,1066,1187,,95,-12,1092,-21,-94,,25306
250831,4000,Female,GM0074,Heerenveen,2017JJ00,2017,25306,,207,,287,,-80,1197,,86,1111,1154,,88,-8,1066,43,-37,,25269
250832,4000,Female,GM0074,Heerenveen,2018JJ00,2018,25269,,183,,288,,-105,1280,,105,1175,1168,,68,-9,1100,112,4,,25273
250833,4000,Female,GM0074,Heerenveen,2019JJ00,2019,25273,,224,,238,,-14,1236,,91,1145,1115,,77,-1,1038,121,105,,25378
250834,4000,Female,GM0074,Heerenveen,2020JJ00,2020,25378,,207,,271,,-64,1212,,79,1133,1081,,59,1,1022,131,65,,25443
250835,4000,Female,GM0074,Heerenveen,2021JJ00,2021,25443,,225,,274,,-49,1285,,81,1204,1048,,50,-1,998,237,184,,25627
250836,4000,Female,GM0074,Heerenveen,2022JJ00,2022,25627,,242,,302,,-60,1424,,296,1128,1058,,99,1,959,366,304,,25931
250837,4000,Female,GM0074,Heerenveen,2023JJ00,2023,25931,,191,,311,,-120,1347,,179,1168,1172,,120,-4,1052,175,53,,25984
250990,4000,Female,GM0398,Heerhugowaard,2012JJ00,2012,26023,,309,,158,,151,1220,,121,1099,1121,,143,-33,978,99,254,,26277
250991,4000,Female,GM0398,Heerhugowaard,2013JJ00,2013,26277,,313,,151,,162,1119,,128,991,1087,,107,-20,980,32,194,,26471
250992,4000,Female,GM0398,Heerhugowaard,2014JJ00,2014,26471,,269,,151,,118,1088,,121,967,1073,,95,-2,978,15,130,,26601
250993,4000,Female,GM0398,Heerhugowaard,2015JJ00,2015,26601,,299,,168,,131,1276,,117,1159,1176,,113,-15,1063,100,230,,26831
250994,4000,Female,GM0398,Heerhugowaard,2016JJ00,2016,26831,,259,,194,,65,1691,,295,1396,1357,,87,-12,1270,334,400,,27231
250995,4000,Female,GM0398,Heerhugowaard,2017JJ00,2017,27231,,291,,172,,119,1733,,151,1582,1436,,113,-6,1323,297,412,,27643
250996,4000,Female,GM0398,Heerhugowaard,2018JJ00,2018,27643,,266,,189,,77,1761,,135,1626,1412,,97,1,1315,349,422,,28065
250997,4000,Female,GM0398,Heerhugowaard,2019JJ00,2019,28065,,269,,191,,78,1867,,166,1701,1470,,112,-20,1358,397,480,,28545
250998,4000,Female,GM0398,Heerhugowaard,2020JJ00,2020,28545,,313,,214,,99,1833,,148,1685,1506,,97,-23,1409,327,425,,28970
250999,4000,Female,GM0398,Heerhugowaard,2021JJ00,2021,28970,,332,,220,,112,1689,,120,1569,1479,,123,-18,1356,210,349,,29319
251154,4000,Female,GM0917,Heerlen,2012JJ00,2012,45013,,358,,556,,-198,2249,,358,1891,2237,,235,-56,2002,12,-189,,44824
251155,4000,Female,GM0917,Heerlen,2013JJ00,2013,44824,,393,,547,,-154,2201,,396,1805,2386,,319,-100,2067,-185,-344,,44480
251156,4000,Female,GM0917,Heerlen,2014JJ00,2014,44480,,388,,536,,-148,2316,,379,1937,2498,,354,-108,2144,-182,-329,,44151
251157,4000,Female,GM0917,Heerlen,2015JJ00,2015,44151,,349,,529,,-180,2434,,387,2047,2306,,272,-57,2034,128,-54,,44097
251158,4000,Female,GM0917,Heerlen,2016JJ00,2016,44097,,344,,540,,-196,2435,,362,2073,2434,,297,-86,2137,1,-198,,43899
251159,4000,Female,GM0917,Heerlen,2017JJ00,2017,43899,,333,,554,,-221,2546,,329,2217,2556,,265,-64,2291,-10,-237,,43662
251160,4000,Female,GM0917,Heerlen,2018JJ00,2018,43662,,370,,551,,-181,2733,,475,2258,2464,,289,-75,2175,269,88,,43750
251161,4000,Female,GM0917,Heerlen,2019JJ00,2019,43750,,320,,546,,-226,2665,,434,2231,2417,,316,-88,2101,248,15,,43765
251162,4000,Female,GM0917,Heerlen,2020JJ00,2020,43765,,326,,612,,-286,2606,,358,2248,2500,,244,-44,2256,106,-185,,43580
251163,4000,Female,GM0917,Heerlen,2021JJ00,2021,43580,,336,,640,,-304,2722,,405,2317,2551,,270,-62,2281,171,-137,,43443
251164,4000,Female,GM0917,Heerlen,2022JJ00,2022,43443,,352,,608,,-256,2892,,631,2261,2410,,335,-51,2075,482,223,,43666
251165,4000,Female,GM0917,Heerlen,2023JJ00,2023,43666,,358,,600,,-242,2865,,650,2215,2510,,343,-67,2167,355,116,,43782
251564,4000,Female,GM1658,Heeze-Leende,2012JJ00,2012,7598,,67,,72,,-5,303,,39,264,257,,33,-3,224,46,42,,7640
251565,4000,Female,GM1658,Heeze-Leende,2013JJ00,2013,7640,,46,,62,,-16,267,,32,235,303,,34,-1,269,-36,-52,,7588
251566,4000,Female,GM1658,Heeze-Leende,2014JJ00,2014,7588,,59,,79,,-20,334,,36,298,276,,28,0,248,58,39,,7627
251567,4000,Female,GM1658,Heeze-Leende,2015JJ00,2015,7627,,69,,72,,-3,365,,39,326,261,,25,-2,236,104,102,,7729
251568,4000,Female,GM1658,Heeze-Leende,2016JJ00,2016,7729,,68,,93,,-25,342,,37,305,306,,27,3,279,36,11,,7740
251569,4000,Female,GM1658,Heeze-Leende,2017JJ00,2017,7740,,55,,62,,-7,436,,41,395,311,,37,1,274,125,118,,7858
251570,4000,Female,GM1658,Heeze-Leende,2018JJ00,2018,7858,,73,,77,,-4,367,,33,334,316,,30,0,286,51,47,,7905
251571,4000,Female,GM1658,Heeze-Leende,2019JJ00,2019,7905,,76,,70,,6,416,,38,378,310,,18,1,292,106,112,,8017
251572,4000,Female,GM1658,Heeze-Leende,2020JJ00,2020,8017,,57,,87,,-30,424,,50,374,340,,31,-4,309,84,52,,8069
251573,4000,Female,GM1658,Heeze-Leende,2021JJ00,2021,8069,,68,,83,,-15,434,,35,399,301,,28,-3,273,133,119,,8188
251574,4000,Female,GM1658,Heeze-Leende,2022JJ00,2022,8188,,67,,95,,-28,456,,91,365,333,,43,-2,290,123,93,,8281
251575,4000,Female,GM1658,Heeze-Leende,2023JJ00,2023,8281,,64,,92,,-28,421,,59,362,326,,43,-1,283,95,69,,8350
251810,4000,Female,GM0399,Heiloo,2012JJ00,2012,11510,,81,,105,,-24,429,,38,391,453,,59,-3,394,-24,-48,,11462
251811,4000,Female,GM0399,Heiloo,2013JJ00,2013,11462,,74,,87,,-13,526,,45,481,448,,35,1,413,78,65,,11527
251812,4000,Female,GM0399,Heiloo,2014JJ00,2014,11527,,64,,107,,-43,447,,47,400,512,,47,-2,465,-65,-108,,11419
251813,4000,Female,GM0399,Heiloo,2015JJ00,2015,11419,,70,,107,,-37,654,,49,605,541,,34,3,507,113,76,,11495
251814,4000,Female,GM0399,Heiloo,2016JJ00,2016,11495,,74,,108,,-34,611,,42,569,524,,35,-2,489,87,53,,11548
251815,4000,Female,GM0399,Heiloo,2017JJ00,2017,11548,,71,,107,,-36,721,,56,665,555,,42,0,513,166,130,,11678
251816,4000,Female,GM0399,Heiloo,2018JJ00,2018,11678,,73,,120,,-47,734,,55,679,485,,34,-1,451,249,201,,11879
251817,4000,Female,GM0399,Heiloo,2019JJ00,2019,11879,,82,,95,,-13,828,,63,765,532,,53,-7,479,296,280,,12159
251818,4000,Female,GM0399,Heiloo,2020JJ00,2020,12159,,85,,136,,-51,734,,46,688,602,,37,0,565,132,80,,12239
251819,4000,Female,GM0399,Heiloo,2021JJ00,2021,12239,,87,,137,,-50,663,,51,612,506,,35,1,471,157,107,,12346
251820,4000,Female,GM0399,Heiloo,2022JJ00,2022,12346,,83,,138,,-55,624,,96,528,608,,53,-1,555,16,-39,,12307
251821,4000,Female,GM0399,Heiloo,2023JJ00,2023,12307,,81,,132,,-51,636,,57,579,606,,55,-2,551,30,-20,,12287
252384,4000,Female,GM0400,Den Helder,2012JJ00,2012,28781,,266,,271,,-5,876,,170,706,898,,100,12,798,-22,-23,,28758
252385,4000,Female,GM0400,Den Helder,2013JJ00,2013,28758,,251,,284,,-33,791,,201,590,910,,176,-12,734,-119,-151,,28607
252386,4000,Female,GM0400,Den Helder,2014JJ00,2014,28607,,259,,266,,-7,806,,155,651,905,,131,-3,774,-99,-107,,28500
252387,4000,Female,GM0400,Den Helder,2015JJ00,2015,28500,,243,,273,,-30,979,,328,651,1027,,144,-21,883,-48,-79,,28421
252388,4000,Female,GM0400,Den Helder,2016JJ00,2016,28421,,256,,319,,-63,1027,,250,777,1118,,142,-11,976,-91,-151,,28270
252389,4000,Female,GM0400,Den Helder,2017JJ00,2017,28270,,235,,273,,-38,1160,,187,973,1180,,111,-13,1069,-20,-60,,28210
252390,4000,Female,GM0400,Den Helder,2018JJ00,2018,28210,,240,,307,,-67,1020,,195,825,1046,,114,-14,932,-26,-87,,28123
252391,4000,Female,GM0400,Den Helder,2019JJ00,2019,28123,,253,,300,,-47,1363,,326,1037,1069,,142,-13,927,294,247,,28370
252392,4000,Female,GM0400,Den Helder,2020JJ00,2020,28370,,231,,322,,-91,1205,,236,969,995,,108,-15,887,210,118,,28488
252393,4000,Female,GM0400,Den Helder,2021JJ00,2021,28488,,260,,346,,-86,1183,,156,1027,1225,,154,-24,1071,-42,-133,,28355
252394,4000,Female,GM0400,Den Helder,2022JJ00,2022,28355,,259,,364,,-105,1415,,370,1045,1120,,163,-15,957,295,188,,28543
252395,4000,Female,GM0400,Den Helder,2023JJ00,2023,28543,,231,,349,,-118,1067,,229,838,1030,,151,-18,879,37,-89,,28454
252466,4000,Female,GM0163,Hellendoorn,2012JJ00,2012,17909,,139,,151,,-12,404,,29,375,429,,17,2,412,-25,-37,,17872
252467,4000,Female,GM0163,Hellendoorn,2013JJ00,2013,17872,,162,,186,,-24,410,,24,386,409,,28,-7,381,1,-23,,17849
252468,4000,Female,GM0163,Hellendoorn,2014JJ00,2014,17849,,152,,184,,-32,440,,25,415,424,,27,-2,397,16,-16,,17833
252469,4000,Female,GM0163,Hellendoorn,2015JJ00,2015,17833,,147,,174,,-27,476,,41,435,444,,26,-3,418,32,2,,17835
252470,4000,Female,GM0163,Hellendoorn,2016JJ00,2016,17835,,173,,162,,11,506,,42,464,471,,15,1,456,35,45,,17880
252471,4000,Female,GM0163,Hellendoorn,2017JJ00,2017,17880,,172,,145,,27,571,,36,535,541,,30,-2,511,30,56,,17936
252472,4000,Female,GM0163,Hellendoorn,2018JJ00,2018,17936,,178,,200,,-22,494,,31,463,483,,20,-1,463,11,-13,,17923
252473,4000,Female,GM0163,Hellendoorn,2019JJ00,2019,17923,,182,,164,,18,530,,40,490,470,,21,-1,449,60,80,,18003
252474,4000,Female,GM0163,Hellendoorn,2020JJ00,2020,18003,,155,,205,,-50,554,,30,524,524,,30,-1,494,30,-20,,17983
252475,4000,Female,GM0163,Hellendoorn,2021JJ00,2021,17983,,162,,195,,-33,484,,48,436,485,,26,2,459,-1,-35,,17948
252476,4000,Female,GM0163,Hellendoorn,2022JJ00,2022,17948,,184,,205,,-21,710,,216,494,485,,67,-12,418,225,204,,18152
252477,4000,Female,GM0163,Hellendoorn,2023JJ00,2023,18152,,165,,183,,-18,590,,108,482,570,,84,-15,486,20,0,,18152
252548,4000,Female,GM0530,Hellevoetsluis,2012JJ00,2012,19724,,172,,157,,15,613,,94,519,687,,50,3,637,-74,-60,,19664
252549,4000,Female,GM0530,Hellevoetsluis,2013JJ00,2013,19664,,150,,158,,-8,668,,83,585,720,,85,-6,635,-52,-57,,19607
252550,4000,Female,GM0530,Hellevoetsluis,2014JJ00,2014,19607,,163,,154,,9,663,,101,562,686,,70,-15,616,-23,-13,,19594
252551,4000,Female,GM0530,Hellevoetsluis,2015JJ00,2015,19594,,150,,137,,13,656,,83,573,799,,73,-5,726,-143,-128,,19466
252552,4000,Female,GM0530,Hellevoetsluis,2016JJ00,2016,19466,,172,,151,,21,803,,97,706,730,,58,-2,672,73,95,,19561
252553,4000,Female,GM0530,Hellevoetsluis,2017JJ00,2017,19561,,160,,154,,6,816,,91,725,802,,77,-18,725,14,20,,19581
252554,4000,Female,GM0530,Hellevoetsluis,2018JJ00,2018,20199,,151,,185,,-34,904,,103,801,837,,72,-15,765,67,31,,20230
252555,4000,Female,GM0530,Hellevoetsluis,2019JJ00,2019,20230,,160,,174,,-14,884,,102,782,840,,65,-2,775,44,31,,20261
252556,4000,Female,GM0530,Hellevoetsluis,2020JJ00,2020,20261,,162,,176,,-14,958,,110,848,800,,67,-5,733,158,146,,20407
252557,4000,Female,GM0530,Hellevoetsluis,2021JJ00,2021,20407,,171,,193,,-22,942,,83,859,788,,78,-6,710,154,131,,20538
252558,4000,Female,GM0530,Hellevoetsluis,2022JJ00,2022,20538,,159,,196,,-37,1039,,168,871,847,,60,-1,787,192,131,,20669
252630,4000,Female,GM0794,Helmond,2012JJ00,2012,44234,,500,,321,,179,1455,,270,1185,1521,,238,-14,1283,-66,112,,44346
252631,4000,Female,GM0794,Helmond,2013JJ00,2013,44346,,512,,337,,175,1571,,289,1282,1609,,274,-16,1335,-38,138,,44484
252632,4000,Female,GM0794,Helmond,2014JJ00,2014,44484,,467,,346,,121,1714,,317,1397,1610,,280,-39,1330,104,227,,44711
252633,4000,Female,GM0794,Helmond,2015JJ00,2015,44711,,445,,371,,74,1714,,341,1373,1665,,330,-30,1335,49,122,,44833
252634,4000,Female,GM0794,Helmond,2016JJ00,2016,44833,,473,,364,,109,1698,,331,1367,1672,,235,-18,1437,26,133,,44966
252635,4000,Female,GM0794,Helmond,2017JJ00,2017,44966,,436,,347,,89,1959,,354,1605,1931,,248,-51,1683,28,118,,45084
252636,4000,Female,GM0794,Helmond,2018JJ00,2018,45084,,407,,368,,39,2037,,387,1650,1857,,235,-32,1622,180,218,,45302
252637,4000,Female,GM0794,Helmond,2019JJ00,2019,45302,,465,,335,,130,2078,,460,1618,1771,,244,-39,1527,307,438,,45740
252638,4000,Female,GM0794,Helmond,2020JJ00,2020,45740,,390,,417,,-27,2055,,406,1649,1914,,241,-38,1673,141,112,,45852
252639,4000,Female,GM0794,Helmond,2021JJ00,2021,45852,,475,,408,,67,2320,,439,1881,1943,,285,-19,1658,377,440,,46292
252640,4000,Female,GM0794,Helmond,2022JJ00,2022,46292,,450,,428,,22,2613,,779,1834,1954,,365,-51,1589,659,685,,46977
252641,4000,Female,GM0794,Helmond,2023JJ00,2023,46977,,383,,436,,-53,2436,,633,1803,1925,,414,-62,1511,511,461,,47438
253040,4000,Female,GM0531,Hendrik-Ido-Ambacht,2012JJ00,2012,14409,,181,,115,,66,615,,38,577,527,,42,-6,485,88,156,,14565
253041,4000,Female,GM0531,Hendrik-Ido-Ambacht,2013JJ00,2013,14565,,173,,79,,94,621,,23,598,576,,37,-6,539,45,140,,14705
253042,4000,Female,GM0531,Hendrik-Ido-Ambacht,2014JJ00,2014,14705,,174,,85,,89,608,,47,561,590,,33,-5,557,18,108,,14813
253043,4000,Female,GM0531,Hendrik-Ido-Ambacht,2015JJ00,2015,14813,,175,,110,,65,655,,37,618,655,,48,-2,607,0,66,,14879
253044,4000,Female,GM0531,Hendrik-Ido-Ambacht,2016JJ00,2016,14879,,173,,104,,69,785,,39,746,651,,35,-2,616,134,203,,15082
253045,4000,Female,GM0531,Hendrik-Ido-Ambacht,2017JJ00,2017,15082,,204,,114,,90,1068,,28,1040,646,,29,-5,617,422,512,,15594
253046,4000,Female,GM0531,Hendrik-Ido-Ambacht,2018JJ00,2018,15594,,173,,118,,55,774,,46,728,670,,25,5,645,104,159,,15753
253047,4000,Female,GM0531,Hendrik-Ido-Ambacht,2019JJ00,2019,15753,,196,,109,,87,776,,38,738,758,,28,-3,730,18,105,,15858
253048,4000,Female,GM0531,Hendrik-Ido-Ambacht,2020JJ00,2020,15858,,201,,122,,79,631,,40,591,681,,18,5,663,-50,27,,15885
253049,4000,Female,GM0531,Hendrik-Ido-Ambacht,2021JJ00,2021,15885,,189,,133,,56,871,,39,832,721,,28,-3,693,150,205,,16090
253050,4000,Female,GM0531,Hendrik-Ido-Ambacht,2022JJ00,2022,16090,,205,,116,,89,869,,147,722,698,,54,-1,644,171,259,,16349
253051,4000,Female,GM0531,Hendrik-Ido-Ambacht,2023JJ00,2023,16349,,157,,112,,45,939,,89,850,760,,64,-40,696,179,224,,16573
253204,4000,Female,GM0164,Hengelo (O.),2012JJ00,2012,40649,,428,,348,,80,1450,,171,1279,1554,,193,-30,1361,-104,-24,,40625
253205,4000,Female,GM0164,Hengelo (O.),2013JJ00,2013,40625,,393,,387,,6,1426,,168,1258,1472,,191,-12,1281,-46,-43,,40582
253206,4000,Female,GM0164,Hengelo (O.),2014JJ00,2014,40582,,416,,343,,73,1478,,188,1290,1542,,222,-33,1320,-64,11,,40593
253207,4000,Female,GM0164,Hengelo (O.),2015JJ00,2015,40593,,371,,374,,-3,1474,,227,1247,1543,,180,-12,1363,-69,-72,,40521
253208,4000,Female,GM0164,Hengelo (O.),2016JJ00,2016,40521,,368,,396,,-28,1692,,256,1436,1861,,185,-11,1676,-169,-194,,40327
253209,4000,Female,GM0164,Hengelo (O.),2017JJ00,2017,40327,,364,,391,,-27,1680,,216,1464,1768,,167,-14,1601,-88,-115,,40212
253210,4000,Female,GM0164,Hengelo (O.),2018JJ00,2018,40212,,312,,416,,-104,1699,,229,1470,1586,,181,-14,1405,113,2,,40214
253211,4000,Female,GM0164,Hengelo (O.),2019JJ00,2019,40214,,311,,410,,-99,1770,,222,1548,1526,,158,2,1368,244,141,,40355
253212,4000,Female,GM0164,Hengelo (O.),2020JJ00,2020,40355,,346,,451,,-105,1818,,249,1569,1795,,145,-18,1650,23,-82,,40273
253213,4000,Female,GM0164,Hengelo (O.),2021JJ00,2021,40273,,335,,416,,-81,1866,,279,1587,1644,,126,-10,1518,222,141,,40414
253214,4000,Female,GM0164,Hengelo (O.),2022JJ00,2022,40414,,348,,452,,-104,2228,,617,1611,1775,,240,-31,1535,453,353,,40767
253215,4000,Female,GM0164,Hengelo (O.),2023JJ00,2023,40767,,321,,401,,-80,2242,,398,1844,1776,,237,-35,1539,466,385,,41152
253614,4000,Female,GM0796,s-Hertogenbosch,2012JJ00,2012,72085,,787,,594,,193,3357,,464,2893,3093,,424,-87,2669,264,456,,72541
253615,4000,Female,GM0796,s-Hertogenbosch,2013JJ00,2013,72541,,819,,568,,251,3345,,420,2925,3259,,356,-60,2903,86,336,,72877
253616,4000,Female,GM0796,s-Hertogenbosch,2014JJ00,2014,72877,,886,,586,,300,3433,,418,3015,3476,,412,-37,3064,-43,265,,73142
253617,4000,Female,GM0796,s-Hertogenbosch,2015JJ00,2015,76465,,815,,546,,269,3752,,429,3323,3681,,421,-53,3260,71,336,,76801
253618,4000,Female,GM0796,s-Hertogenbosch,2016JJ00,2016,76801,,810,,613,,197,3924,,480,3444,3790,,438,-53,3352,134,334,,77135
253619,4000,Female,GM0796,s-Hertogenbosch,2017JJ00,2017,77135,,766,,620,,146,4291,,539,3752,3919,,377,-33,3542,372,511,,77646
253620,4000,Female,GM0796,s-Hertogenbosch,2018JJ00,2018,77646,,701,,697,,4,4097,,627,3470,3742,,470,-60,3272,355,358,,78004
253621,4000,Female,GM0796,s-Hertogenbosch,2019JJ00,2019,78004,,768,,676,,92,4231,,657,3574,3819,,421,-41,3398,412,501,,78505
253622,4000,Female,GM0796,s-Hertogenbosch,2020JJ00,2020,78505,,739,,752,,-13,4120,,503,3617,4008,,309,-27,3699,112,94,,78599
253623,4000,Female,GM0796,s-Hertogenbosch,2021JJ00,2021,78599,,826,,749,,77,4286,,599,3687,3907,,380,-33,3527,379,456,,79055
253624,4000,Female,GM0796,s-Hertogenbosch,2022JJ00,2022,79055,,755,,771,,-16,5045,,1376,3669,3970,,541,-74,3429,1075,1049,,80104
253625,4000,Female,GM0796,s-Hertogenbosch,2023JJ00,2023,80104,,700,,757,,-57,5008,,951,4057,4090,,497,-64,3593,918,861,,80965
254024,4000,Female,GM0252,Heumen,2012JJ00,2012,8285,,68,,65,,3,378,,31,347,375,,25,0,350,3,7,,8292
254025,4000,Female,GM0252,Heumen,2013JJ00,2013,8292,,38,,66,,-28,324,,34,290,376,,29,1,347,-52,-80,,8212
254026,4000,Female,GM0252,Heumen,2014JJ00,2014,8212,,49,,49,,0,418,,31,387,403,,22,-1,381,15,15,,8227
254027,4000,Female,GM0252,Heumen,2015JJ00,2015,8227,,46,,68,,-22,423,,38,385,384,,28,0,356,39,16,,8243
254028,4000,Female,GM0252,Heumen,2016JJ00,2016,8243,,59,,66,,-7,664,,38,626,586,,19,1,567,78,73,,8316
254029,4000,Female,GM0252,Heumen,2017JJ00,2017,8316,,55,,81,,-26,489,,30,459,486,,31,0,455,3,-23,,8293
254030,4000,Female,GM0252,Heumen,2018JJ00,2018,8293,,70,,68,,2,512,,37,475,499,,43,-5,456,13,14,,8307
254031,4000,Female,GM0252,Heumen,2019JJ00,2019,8307,,48,,88,,-40,486,,36,450,477,,25,2,452,9,-32,,8275
254032,4000,Female,GM0252,Heumen,2020JJ00,2020,8275,,52,,84,,-32,527,,30,497,455,,34,-1,421,72,37,,8312
254033,4000,Female,GM0252,Heumen,2021JJ00,2021,8312,,63,,76,,-13,741,,41,700,423,,24,-3,399,318,305,,8617
254034,4000,Female,GM0252,Heumen,2022JJ00,2022,8617,,62,,99,,-37,631,,138,493,747,,67,-26,680,-116,-153,,8464
254035,4000,Female,GM0252,Heumen,2023JJ00,2023,8464,,75,,93,,-18,490,,65,425,513,,54,-8,459,-23,-39,,8425
254106,4000,Female,GM0797,Heusden,2012JJ00,2012,21559,,205,,149,,56,778,,89,689,751,,72,-18,679,27,86,,21645
254107,4000,Female,GM0797,Heusden,2013JJ00,2013,21645,,173,,140,,33,672,,105,567,799,,82,-9,717,-127,-94,,21551
254108,4000,Female,GM0797,Heusden,2014JJ00,2014,21551,,188,,130,,58,751,,101,650,817,,97,-18,720,-66,-4,,21547
254109,4000,Female,GM0797,Heusden,2015JJ00,2015,21547,,184,,174,,10,920,,143,777,856,,90,-9,766,64,75,,21622
254110,4000,Female,GM0797,Heusden,2016JJ00,2016,21622,,204,,159,,45,844,,139,705,792,,73,-8,719,52,94,,21716
254111,4000,Female,GM0797,Heusden,2017JJ00,2017,21716,,169,,169,,0,982,,118,864,888,,112,-25,776,94,94,,21810
254112,4000,Female,GM0797,Heusden,2018JJ00,2018,21810,,195,,147,,48,1027,,189,838,889,,98,-21,791,138,186,,21996
254113,4000,Female,GM0797,Heusden,2019JJ00,2019,21996,,192,,176,,16,1122,,157,965,864,,123,-9,741,258,271,,22267
254114,4000,Female,GM0797,Heusden,2020JJ00,2020,22267,,189,,218,,-29,1056,,139,917,880,,105,-21,775,176,148,,22415
254115,4000,Female,GM0797,Heusden,2021JJ00,2021,22415,,214,,212,,2,1141,,164,977,888,,100,-11,788,253,256,,22671
254116,4000,Female,GM0797,Heusden,2022JJ00,2022,22671,,207,,186,,21,1073,,278,795,860,,137,-26,723,213,233,,22904
254117,4000,Female,GM0797,Heusden,2023JJ00,2023,22904,,196,,228,,-32,1113,,190,923,954,,126,-18,828,159,124,,23028
254270,4000,Female,GM0534,Hillegom,2012JJ00,2012,10527,,101,,100,,1,452,,53,399,422,,42,-7,380,30,31,,10558
254271,4000,Female,GM0534,Hillegom,2013JJ00,2013,10558,,82,,104,,-22,457,,62,395,440,,40,-5,400,17,-3,,10555
254272,4000,Female,GM0534,Hillegom,2014JJ00,2014,10555,,87,,104,,-17,559,,90,469,454,,50,-7,404,105,88,,10643
254273,4000,Female,GM0534,Hillegom,2015JJ00,2015,10643,,92,,104,,-12,524,,82,442,518,,53,-3,465,6,-7,,10636
254274,4000,Female,GM0534,Hillegom,2016JJ00,2016,10636,,97,,102,,-5,647,,63,584,509,,53,-2,456,138,135,,10771
254275,4000,Female,GM0534,Hillegom,2017JJ00,2017,10771,,111,,106,,5,754,,72,682,557,,55,-1,502,197,203,,10974
254276,4000,Female,GM0534,Hillegom,2018JJ00,2018,10974,,120,,119,,1,598,,70,528,497,,29,3,468,101,100,,11074
254277,4000,Female,GM0534,Hillegom,2019JJ00,2019,11074,,121,,124,,-3,609,,94,515,501,,36,4,465,108,103,,11177
254278,4000,Female,GM0534,Hillegom,2020JJ00,2020,11177,,100,,120,,-20,599,,101,498,583,,43,-2,540,16,-5,,11172
254279,4000,Female,GM0534,Hillegom,2021JJ00,2021,11172,,121,,131,,-10,645,,107,538,586,,74,-15,512,59,48,,11220
254280,4000,Female,GM0534,Hillegom,2022JJ00,2022,11220,,102,,122,,-20,753,,221,532,659,,81,-7,578,94,73,,11293
254281,4000,Female,GM0534,Hillegom,2023JJ00,2023,11293,,112,,127,,-15,838,,169,669,623,,113,-15,510,215,199,,11492
254352,4000,Female,GM0798,Hilvarenbeek,2012JJ00,2012,7445,,57,,42,,15,223,,23,200,230,,20,-1,210,-7,8,,7453
254353,4000,Female,GM0798,Hilvarenbeek,2013JJ00,2013,7453,,57,,48,,9,255,,16,239,252,,11,0,241,3,13,,7466
254354,4000,Female,GM0798,Hilvarenbeek,2014JJ00,2014,7466,,50,,54,,-4,215,,23,192,226,,13,1,213,-11,-15,,7451
254355,4000,Female,GM0798,Hilvarenbeek,2015JJ00,2015,7451,,68,,57,,11,307,,33,274,234,,10,7,224,73,85,,7536
254356,4000,Female,GM0798,Hilvarenbeek,2016JJ00,2016,7536,,66,,52,,14,304,,27,277,271,,20,-1,251,33,46,,7582
254357,4000,Female,GM0798,Hilvarenbeek,2017JJ00,2017,7582,,56,,54,,2,360,,17,343,308,,14,-2,294,52,53,,7635
254358,4000,Female,GM0798,Hilvarenbeek,2018JJ00,2018,7635,,75,,73,,2,289,,17,272,297,,31,-2,266,-8,-6,,7629
254359,4000,Female,GM0798,Hilvarenbeek,2019JJ00,2019,7629,,59,,50,,9,358,,25,333,258,,17,-1,241,100,110,,7739
254360,4000,Female,GM0798,Hilvarenbeek,2020JJ00,2020,7739,,80,,74,,6,369,,23,346,291,,12,0,279,78,84,,7823
254361,4000,Female,GM0798,Hilvarenbeek,2021JJ00,2021,7823,,61,,67,,-6,346,,32,314,271,,29,-1,242,75,69,,7892
254362,4000,Female,GM0798,Hilvarenbeek,2022JJ00,2022,7892,,60,,71,,-11,396,,104,292,289,,37,-3,252,107,98,,7990
254363,4000,Female,GM0798,Hilvarenbeek,2023JJ00,2023,7990,,66,,67,,-1,291,,39,252,297,,35,-4,262,-6,-8,,7982
254434,4000,Female,GM0402,Hilversum,2012JJ00,2012,43950,,432,,490,,-58,2596,,484,2112,2406,,395,-83,2011,190,133,,44083
254435,4000,Female,GM0402,Hilversum,2013JJ00,2013,44083,,405,,462,,-57,2495,,484,2011,2262,,385,-26,1877,233,175,,44258
254436,4000,Female,GM0402,Hilversum,2014JJ00,2014,44258,,436,,491,,-55,2863,,602,2261,2522,,380,-60,2142,341,284,,44542
254437,4000,Female,GM0402,Hilversum,2015JJ00,2015,44542,,469,,497,,-28,3044,,725,2319,2680,,379,-18,2301,364,334,,44876
254438,4000,Female,GM0402,Hilversum,2016JJ00,2016,44876,,407,,486,,-79,3312,,726,2586,2836,,370,-21,2466,476,401,,45277
254439,4000,Female,GM0402,Hilversum,2017JJ00,2017,45277,,406,,486,,-80,3343,,729,2614,2953,,409,-44,2544,390,307,,45584
254440,4000,Female,GM0402,Hilversum,2018JJ00,2018,45584,,496,,498,,-2,3285,,859,2426,2913,,420,-34,2493,372,374,,45958
254441,4000,Female,GM0402,Hilversum,2019JJ00,2019,45958,,431,,480,,-49,3490,,913,2577,3182,,446,-17,2736,308,254,,46212
254442,4000,Female,GM0402,Hilversum,2020JJ00,2020,46212,,460,,475,,-15,3278,,663,2615,3068,,435,-28,2633,210,195,,46407
254443,4000,Female,GM0402,Hilversum,2021JJ00,2021,46407,,484,,497,,-13,3372,,736,2636,3127,,432,-32,2695,245,234,,46641
254444,4000,Female,GM0402,Hilversum,2022JJ00,2022,46641,,454,,485,,-31,4031,,1426,2605,3268,,491,-36,2777,763,735,,47376
254445,4000,Female,GM0402,Hilversum,2023JJ00,2023,47376,,414,,460,,-46,3593,,1031,2562,3020,,490,-41,2530,573,516,,47892
254769,4000,Female,GM1963,Hoeksche Waard,2019JJ00,2019,43762,,370,,370,,0,1491,,134,1357,1056,,93,-4,963,435,428,,44190
254770,4000,Female,GM1963,Hoeksche Waard,2020JJ00,2020,44190,,391,,406,,-15,1448,,103,1345,1045,,81,-12,964,403,387,,44577
254771,4000,Female,GM1963,Hoeksche Waard,2021JJ00,2021,44577,,403,,412,,-9,1558,,111,1447,1212,,98,-6,1114,346,341,,44918
254772,4000,Female,GM1963,Hoeksche Waard,2022JJ00,2022,44918,,384,,458,,-74,1920,,324,1596,1298,,166,-13,1132,622,551,,45469
254773,4000,Female,GM1963,Hoeksche Waard,2023JJ00,2023,45469,,385,,436,,-51,1670,,249,1421,1364,,163,-12,1201,306,254,,45723
255172,4000,Female,GM1735,Hof van Twente,2012JJ00,2012,17923,,129,,188,,-59,568,,89,479,686,,48,3,638,-118,-176,,17747
255173,4000,Female,GM1735,Hof van Twente,2013JJ00,2013,17747,,132,,205,,-73,496,,53,443,555,,56,-13,499,-59,-133,,17614
255174,4000,Female,GM1735,Hof van Twente,2014JJ00,2014,17614,,141,,202,,-61,532,,42,490,547,,41,-8,506,-15,-80,,17534
255175,4000,Female,GM1735,Hof van Twente,2015JJ00,2015,17534,,112,,200,,-88,585,,72,513,487,,36,1,451,98,14,,17548
255176,4000,Female,GM1735,Hof van Twente,2016JJ00,2016,17548,,148,,194,,-46,683,,63,620,580,,37,-8,543,103,57,,17605
255177,4000,Female,GM1735,Hof van Twente,2017JJ00,2017,17605,,140,,202,,-62,655,,73,582,646,,53,-6,593,9,-53,,17552
255178,4000,Female,GM1735,Hof van Twente,2018JJ00,2018,17552,,120,,207,,-87,683,,76,607,598,,38,2,560,85,-2,,17550
255179,4000,Female,GM1735,Hof van Twente,2019JJ00,2019,17550,,123,,184,,-61,665,,79,586,602,,52,-1,550,63,5,,17555
255180,4000,Female,GM1735,Hof van Twente,2020JJ00,2020,17555,,125,,199,,-74,669,,63,606,595,,47,-4,548,74,2,,17557
255181,4000,Female,GM1735,Hof van Twente,2021JJ00,2021,17557,,142,,249,,-107,689,,64,625,593,,57,-5,536,96,-10,,17547
255182,4000,Female,GM1735,Hof van Twente,2022JJ00,2022,17547,,142,,198,,-56,854,,225,629,583,,75,-10,508,271,214,,17761
255183,4000,Female,GM1735,Hof van Twente,2023JJ00,2023,17761,,136,,232,,-96,762,,129,633,711,,80,-14,631,51,-47,,17714
255261,4000,Female,GM1966,Het Hogeland,2019JJ00,2019,23822,,206,,245,,-39,910,,87,823,932,,47,7,885,-22,-63,,23759
255262,4000,Female,GM1966,Het Hogeland,2020JJ00,2020,23759,,181,,224,,-43,958,,86,872,893,,53,-5,840,65,23,,23782
255263,4000,Female,GM1966,Het Hogeland,2021JJ00,2021,23782,,189,,254,,-65,1023,,81,942,844,,60,0,784,179,114,,23896
255264,4000,Female,GM1966,Het Hogeland,2022JJ00,2022,23896,,189,,265,,-76,1342,,247,1095,1054,,94,-10,960,288,214,,24110
255265,4000,Female,GM1966,Het Hogeland,2023JJ00,2023,24110,,203,,267,,-64,1259,,101,1158,1227,,94,-10,1133,32,-34,,24076
255336,4000,Female,GM1911,Hollands Kroon,2012JJ00,2012,23553,,220,,161,,59,733,,104,629,767,,77,-19,690,-34,6,,23559
255337,4000,Female,GM1911,Hollands Kroon,2013JJ00,2013,23559,,190,,162,,28,724,,117,607,842,,73,-7,769,-118,-88,,23471
255338,4000,Female,GM1911,Hollands Kroon,2014JJ00,2014,23471,,220,,164,,56,830,,183,647,858,,119,-25,739,-28,37,,23508
255339,4000,Female,GM1911,Hollands Kroon,2015JJ00,2015,23508,,223,,181,,42,858,,149,709,914,,104,-12,810,-56,-14,,23494
255340,4000,Female,GM1911,Hollands Kroon,2016JJ00,2016,23494,,214,,178,,36,949,,124,825,980,,83,-10,897,-31,9,,23503
255341,4000,Female,GM1911,Hollands Kroon,2017JJ00,2017,23503,,217,,199,,18,1097,,127,970,1084,,99,-18,985,13,29,,23532
255342,4000,Female,GM1911,Hollands Kroon,2018JJ00,2018,23532,,205,,189,,16,1037,,164,873,1022,,80,-7,942,15,26,,23558
255343,4000,Female,GM1911,Hollands Kroon,2019JJ00,2019,23558,,204,,173,,31,1319,,444,875,1115,,189,-59,926,204,235,,23793
255344,4000,Female,GM1911,Hollands Kroon,2020JJ00,2020,23793,,213,,202,,11,1256,,360,896,1201,,284,-55,917,55,66,,23859
255345,4000,Female,GM1911,Hollands Kroon,2021JJ00,2021,23859,,216,,209,,7,1249,,255,994,1138,,298,-59,840,111,118,,23977
255346,4000,Female,GM1911,Hollands Kroon,2022JJ00,2022,23977,,221,,207,,14,1636,,662,974,1294,,391,-47,903,342,351,,24328
255347,4000,Female,GM1911,Hollands Kroon,2023JJ00,2023,24328,,184,,201,,-17,1294,,380,914,1297,,378,-63,919,-3,-18,,24310
255992,4000,Female,GM0118,Hoogeveen,2012JJ00,2012,27608,,287,,258,,29,727,,57,670,792,,67,-14,725,-65,-34,,27574
255993,4000,Female,GM0118,Hoogeveen,2013JJ00,2013,27574,,263,,255,,8,715,,71,644,807,,65,-2,742,-92,-85,,27489
255994,4000,Female,GM0118,Hoogeveen,2014JJ00,2014,27489,,275,,245,,30,884,,79,805,823,,53,-2,770,61,90,,27579
255995,4000,Female,GM0118,Hoogeveen,2015JJ00,2015,27579,,267,,277,,-10,1054,,278,776,947,,64,-6,883,107,98,,27677
255996,4000,Female,GM0118,Hoogeveen,2016JJ00,2016,27677,,309,,279,,30,1103,,232,871,1084,,88,-19,996,19,47,,27724
255997,4000,Female,GM0118,Hoogeveen,2017JJ00,2017,27724,,286,,296,,-10,1146,,132,1014,1026,,58,-6,968,120,109,,27833
255998,4000,Female,GM0118,Hoogeveen,2018JJ00,2018,27833,,226,,312,,-86,1148,,175,973,1106,,86,-36,1020,42,-42,,27791
255999,4000,Female,GM0118,Hoogeveen,2019JJ00,2019,27791,,267,,272,,-5,1079,,116,963,1036,,67,-4,969,43,36,,27827
256000,4000,Female,GM0118,Hoogeveen,2020JJ00,2020,27827,,258,,313,,-55,1012,,102,910,1022,,56,-5,966,-10,-63,,27764
256001,4000,Female,GM0118,Hoogeveen,2021JJ00,2021,27764,,278,,329,,-51,1095,,115,980,985,,63,-12,922,110,58,,27822
256002,4000,Female,GM0118,Hoogeveen,2022JJ00,2022,27822,,257,,326,,-69,1473,,413,1060,1026,,115,-34,911,447,384,,28206
256003,4000,Female,GM0118,Hoogeveen,2023JJ00,2023,28206,,262,,356,,-94,1152,,240,912,1037,,142,-36,895,115,21,,28227
256156,4000,Female,GM0018,Hoogezand-Sappemeer,2012JJ00,2012,17617,,153,,171,,-18,622,,63,559,741,,79,-26,662,-119,-137,,17480
256157,4000,Female,GM0018,Hoogezand-Sappemeer,2013JJ00,2013,17480,,159,,187,,-28,586,,67,519,689,,54,-7,635,-103,-127,,17353
256158,4000,Female,GM0018,Hoogezand-Sappemeer,2014JJ00,2014,17353,,159,,185,,-26,669,,70,599,618,,55,-11,563,51,26,,17379
256159,4000,Female,GM0018,Hoogezand-Sappemeer,2015JJ00,2015,17379,,132,,178,,-46,715,,80,635,783,,86,-16,697,-68,-115,,17264
256160,4000,Female,GM0018,Hoogezand-Sappemeer,2016JJ00,2016,17264,,172,,189,,-17,805,,89,716,725,,59,-5,666,80,62,,17326
256161,4000,Female,GM0018,Hoogezand-Sappemeer,2017JJ00,2017,17326,,163,,220,,-57,803,,82,721,847,,45,-8,802,-44,-100,,17226
256566,4000,Female,GM0405,Hoorn,2012JJ00,2012,36123,,396,,282,,114,1341,,197,1144,1321,,199,-32,1122,20,133,,36256
256567,4000,Female,GM0405,Hoorn,2013JJ00,2013,36256,,386,,320,,66,1323,,187,1136,1249,,138,-4,1111,74,134,,36390
256568,4000,Female,GM0405,Hoorn,2014JJ00,2014,36390,,437,,311,,126,1251,,191,1060,1284,,134,-21,1150,-33,90,,36480
256569,4000,Female,GM0405,Hoorn,2015JJ00,2015,36480,,400,,303,,97,1502,,205,1297,1454,,162,-10,1292,48,142,,36622
256570,4000,Female,GM0405,Hoorn,2016JJ00,2016,36622,,379,,349,,30,1590,,244,1346,1478,,190,-24,1288,112,137,,36759
256571,4000,Female,GM0405,Hoorn,2017JJ00,2017,36759,,389,,337,,52,1568,,243,1325,1498,,200,-20,1298,70,122,,36881
256572,4000,Female,GM0405,Hoorn,2018JJ00,2018,36881,,354,,330,,24,1639,,287,1352,1554,,188,-37,1366,85,104,,36985
256573,4000,Female,GM0405,Hoorn,2019JJ00,2019,36985,,352,,328,,24,1566,,317,1249,1465,,173,-37,1292,101,127,,37112
256574,4000,Female,GM0405,Hoorn,2020JJ00,2020,37112,,361,,337,,24,1762,,277,1485,1594,,203,-33,1391,168,206,,37318
256575,4000,Female,GM0405,Hoorn,2021JJ00,2021,37318,,368,,369,,-1,1902,,305,1597,1541,,184,-7,1357,361,358,,37676
256576,4000,Female,GM0405,Hoorn,2022JJ00,2022,37676,,410,,311,,99,1997,,484,1513,1619,,267,-69,1352,378,477,,38153
256577,4000,Female,GM0405,Hoorn,2023JJ00,2023,38153,,379,,362,,17,1809,,366,1443,1581,,251,-71,1330,228,243,,38396
256976,4000,Female,GM1507,Horst aan de Maas,2012JJ00,2012,20798,,184,,158,,26,660,,127,533,760,,152,7,608,-100,-75,,20723
256977,4000,Female,GM1507,Horst aan de Maas,2013JJ00,2013,20723,,193,,172,,21,676,,160,516,669,,75,10,594,7,29,,20752
256978,4000,Female,GM1507,Horst aan de Maas,2014JJ00,2014,20752,,189,,159,,30,691,,141,550,796,,84,-6,712,-105,-75,,20677
256979,4000,Female,GM1507,Horst aan de Maas,2015JJ00,2015,20677,,150,,177,,-27,713,,169,544,697,,92,-4,605,16,-11,,20666
256980,4000,Female,GM1507,Horst aan de Maas,2016JJ00,2016,20666,,176,,163,,13,934,,327,607,685,,100,-13,585,249,263,,20929
256981,4000,Female,GM1507,Horst aan de Maas,2017JJ00,2017,20929,,162,,164,,-2,853,,212,641,790,,151,-20,639,63,61,,20990
256982,4000,Female,GM1507,Horst aan de Maas,2018JJ00,2018,20990,,164,,198,,-34,785,,202,583,790,,145,-19,645,-5,-40,,20950
256983,4000,Female,GM1507,Horst aan de Maas,2019JJ00,2019,20950,,183,,202,,-19,894,,270,624,782,,115,-30,667,112,91,,21041
256984,4000,Female,GM1507,Horst aan de Maas,2020JJ00,2020,21041,,162,,221,,-59,886,,244,642,791,,163,-24,628,95,37,,21078
256985,4000,Female,GM1507,Horst aan de Maas,2021JJ00,2021,21078,,199,,212,,-13,1066,,269,797,784,,168,-10,616,282,267,,21345
256986,4000,Female,GM1507,Horst aan de Maas,2022JJ00,2022,21345,,179,,207,,-28,1337,,609,728,947,,282,-17,665,390,362,,21707
256987,4000,Female,GM1507,Horst aan de Maas,2023JJ00,2023,21707,,186,,233,,-47,1416,,692,724,1259,,521,-49,738,157,112,,21819
257058,4000,Female,GM0321,Houten,2012JJ00,2012,24393,,255,,119,,136,921,,75,846,917,,87,-10,830,4,138,,24531
257059,4000,Female,GM0321,Houten,2013JJ00,2013,24531,,245,,156,,89,872,,61,811,987,,67,2,920,-115,-27,,24504
257060,4000,Female,GM0321,Houten,2014JJ00,2014,24504,,248,,136,,112,1026,,89,937,1005,,73,-13,932,21,136,,24640
257061,4000,Female,GM0321,Houten,2015JJ00,2015,24640,,258,,159,,99,1092,,87,1005,1116,,77,-2,1039,-24,77,,24717
257062,4000,Female,GM0321,Houten,2016JJ00,2016,24717,,239,,155,,84,1275,,104,1171,1114,,85,-7,1029,161,245,,24962
257063,4000,Female,GM0321,Houten,2017JJ00,2017,24962,,262,,157,,105,1195,,97,1098,1142,,76,-4,1066,53,153,,25115
257064,4000,Female,GM0321,Houten,2018JJ00,2018,25115,,227,,152,,75,1204,,110,1094,1053,,63,-1,990,151,226,,25341
257065,4000,Female,GM0321,Houten,2019JJ00,2019,25341,,230,,144,,86,1090,,128,962,1057,,81,-1,976,33,117,,25458
257066,4000,Female,GM0321,Houten,2020JJ00,2020,25458,,219,,170,,49,1124,,102,1022,1180,,55,-2,1125,-56,-12,,25446
257067,4000,Female,GM0321,Houten,2021JJ00,2021,25446,,267,,138,,129,1073,,99,974,1148,,60,-3,1088,-75,58,,25504
257068,4000,Female,GM0321,Houten,2022JJ00,2022,25504,,227,,164,,63,1215,,217,998,1134,,105,-18,1029,81,140,,25644
257069,4000,Female,GM0321,Houten,2023JJ00,2023,25644,,242,,151,,91,1270,,186,1084,1201,,105,-8,1096,69,160,,25804
257304,4000,Female,GM0406,Huizen,2012JJ00,2012,21350,,168,,202,,-34,801,,103,698,836,,83,-14,753,-35,-69,,21281
257305,4000,Female,GM0406,Huizen,2013JJ00,2013,21281,,152,,172,,-20,793,,99,694,856,,94,-7,762,-63,-83,,21198
257306,4000,Female,GM0406,Huizen,2014JJ00,2014,21198,,174,,196,,-22,966,,91,875,877,,94,-1,783,89,69,,21267
257307,4000,Female,GM0406,Huizen,2015JJ00,2015,21267,,187,,226,,-39,1049,,104,945,956,,95,-21,861,93,58,,21325
257308,4000,Female,GM0406,Huizen,2016JJ00,2016,21325,,165,,213,,-48,1081,,120,961,1061,,95,-10,966,20,-29,,21296
257309,4000,Female,GM0406,Huizen,2017JJ00,2017,21296,,186,,208,,-22,1177,,105,1072,1117,,86,-7,1031,60,38,,21334
257310,4000,Female,GM0406,Huizen,2018JJ00,2018,21334,,178,,224,,-46,1024,,107,917,987,,98,-10,889,37,-10,,21324
257311,4000,Female,GM0406,Huizen,2019JJ00,2019,21324,,178,,232,,-54,1032,,116,916,958,,80,-6,878,74,7,,21331
257312,4000,Female,GM0406,Huizen,2020JJ00,2020,21331,,164,,257,,-93,1106,,103,1003,1067,,77,-8,990,39,-53,,21278
257313,4000,Female,GM0406,Huizen,2021JJ00,2021,21278,,173,,239,,-66,1089,,96,993,1100,,61,-4,1039,-11,-77,,21201
257314,4000,Female,GM0406,Huizen,2022JJ00,2022,21201,,166,,227,,-61,1253,,327,926,1029,,142,-7,887,224,162,,21363
257315,4000,Female,GM0406,Huizen,2023JJ00,2023,21363,,175,,245,,-70,983,,154,829,927,,106,-24,821,56,-16,,21347
257468,4000,Female,GM0677,Hulst,2012JJ00,2012,13851,,86,,132,,-46,470,,180,290,488,,109,-9,379,-18,-65,,13786
257469,4000,Female,GM0677,Hulst,2013JJ00,2013,13786,,98,,146,,-48,450,,184,266,458,,98,-8,360,-8,-55,,13731
257470,4000,Female,GM0677,Hulst,2014JJ00,2014,13731,,105,,132,,-27,476,,177,299,453,,101,-3,352,23,-5,,13726
257471,4000,Female,GM0677,Hulst,2015JJ00,2015,13726,,108,,144,,-36,455,,153,302,416,,109,-12,307,39,2,,13728
257472,4000,Female,GM0677,Hulst,2016JJ00,2016,13728,,94,,137,,-43,507,,198,309,447,,114,-9,333,60,17,,13745
257473,4000,Female,GM0677,Hulst,2017JJ00,2017,13745,,105,,148,,-43,563,,196,367,501,,124,-6,377,62,17,,13762
257474,4000,Female,GM0677,Hulst,2018JJ00,2018,13762,,101,,138,,-37,523,,202,321,516,,136,-4,380,7,-30,,13732
257475,4000,Female,GM0677,Hulst,2019JJ00,2019,13732,,85,,133,,-48,506,,185,321,440,,94,-4,346,66,16,,13748
257476,4000,Female,GM0677,Hulst,2020JJ00,2020,13748,,92,,155,,-63,538,,184,354,431,,97,-5,334,107,45,,13793
257477,4000,Female,GM0677,Hulst,2021JJ00,2021,13793,,112,,156,,-44,477,,150,327,455,,107,-5,348,22,-22,,13771
257478,4000,Female,GM0677,Hulst,2022JJ00,2022,13771,,92,,167,,-75,557,,228,329,484,,145,-5,339,73,-1,,13770
257479,4000,Female,GM0677,Hulst,2023JJ00,2023,13770,,99,,175,,-76,441,,122,319,508,,110,-7,398,-67,-144,,13626
258124,4000,Female,GM0353,IJsselstein,2012JJ00,2012,17552,,175,,119,,56,685,,59,626,721,,40,-4,681,-36,20,,17572
258125,4000,Female,GM0353,IJsselstein,2013JJ00,2013,17572,,176,,95,,81,666,,57,609,765,,67,-3,698,-99,-18,,17554
258126,4000,Female,GM0353,IJsselstein,2014JJ00,2014,17554,,173,,118,,55,719,,67,652,823,,36,10,787,-104,-48,,17506
258127,4000,Female,GM0353,IJsselstein,2015JJ00,2015,17506,,165,,128,,37,861,,62,799,876,,63,-6,813,-15,21,,17527
258128,4000,Female,GM0353,IJsselstein,2016JJ00,2016,17527,,153,,146,,7,846,,85,761,822,,58,-10,764,24,29,,17556
258129,4000,Female,GM0353,IJsselstein,2017JJ00,2017,17556,,168,,102,,66,832,,63,769,840,,56,-7,784,-8,56,,17612
258130,4000,Female,GM0353,IJsselstein,2018JJ00,2018,17612,,153,,148,,5,766,,72,694,816,,58,-8,758,-50,-48,,17564
258131,4000,Female,GM0353,IJsselstein,2019JJ00,2019,17564,,148,,156,,-8,721,,94,627,747,,43,-1,704,-26,-35,,17529
258132,4000,Female,GM0353,IJsselstein,2020JJ00,2020,17529,,151,,166,,-15,762,,76,686,904,,51,-2,853,-142,-155,,17374
258133,4000,Female,GM0353,IJsselstein,2021JJ00,2021,17374,,156,,146,,10,713,,56,657,917,,66,-4,851,-204,-198,,17176
258134,4000,Female,GM0353,IJsselstein,2022JJ00,2022,17176,,126,,162,,-36,821,,176,645,757,,78,-9,679,64,27,,17203
258135,4000,Female,GM0353,IJsselstein,2023JJ00,2023,17203,,134,,156,,-22,786,,100,686,802,,54,0,748,-16,-39,,17164
258944,4000,Female,GM1884,Kaag en Braassem,2012JJ00,2012,12675,,134,,88,,46,370,,45,325,407,,48,-12,359,-37,10,,12685
258945,4000,Female,GM1884,Kaag en Braassem,2013JJ00,2013,12685,,118,,89,,29,411,,56,355,431,,33,-4,398,-20,11,,12696
258946,4000,Female,GM1884,Kaag en Braassem,2014JJ00,2014,12696,,105,,112,,-7,527,,80,447,478,,43,-2,435,49,43,,12739
258947,4000,Female,GM1884,Kaag en Braassem,2015JJ00,2015,12739,,96,,107,,-11,628,,68,560,497,,58,-11,439,131,119,,12858
258948,4000,Female,GM1884,Kaag en Braassem,2016JJ00,2016,12858,,120,,99,,21,663,,83,580,531,,54,2,477,132,153,,13011
258949,4000,Female,GM1884,Kaag en Braassem,2017JJ00,2017,13011,,105,,104,,1,645,,67,578,485,,34,-3,451,160,159,,13170
258950,4000,Female,GM1884,Kaag en Braassem,2018JJ00,2018,13170,,111,,113,,-2,633,,87,546,547,,58,-2,489,86,82,,13252
258951,4000,Female,GM1884,Kaag en Braassem,2019JJ00,2019,13252,,128,,112,,16,705,,81,624,526,,60,-10,466,179,196,,13448
258952,4000,Female,GM1884,Kaag en Braassem,2020JJ00,2020,13448,,121,,89,,32,679,,58,621,577,,36,3,541,102,134,,13582
258953,4000,Female,GM1884,Kaag en Braassem,2021JJ00,2021,13582,,148,,92,,56,706,,79,627,549,,29,1,520,157,214,,13796
258954,4000,Female,GM1884,Kaag en Braassem,2022JJ00,2022,13796,,141,,112,,29,922,,272,650,601,,102,-8,499,321,351,,14147
258955,4000,Female,GM1884,Kaag en Braassem,2023JJ00,2023,14147,,146,,113,,33,892,,119,773,611,,99,-2,512,281,312,,14459
259108,4000,Female,GM0166,Kampen,2012JJ00,2012,25502,,322,,180,,142,686,,76,610,703,,65,-3,638,-17,125,,25627
259109,4000,Female,GM0166,Kampen,2013JJ00,2013,25627,,341,,195,,146,700,,93,607,744,,73,4,671,-44,101,,25728
259110,4000,Female,GM0166,Kampen,2014JJ00,2014,25728,,302,,185,,117,808,,91,717,791,,98,-4,693,17,135,,25863
259111,4000,Female,GM0166,Kampen,2015JJ00,2015,25863,,300,,192,,108,884,,117,767,751,,84,-2,667,133,244,,26107
259112,4000,Female,GM0166,Kampen,2016JJ00,2016,26107,,329,,184,,145,934,,83,851,854,,69,2,785,80,225,,26332
259113,4000,Female,GM0166,Kampen,2017JJ00,2017,26332,,293,,176,,117,1020,,101,919,802,,75,2,727,218,333,,26665
259114,4000,Female,GM0166,Kampen,2018JJ00,2018,26665,,324,,250,,74,1021,,102,919,870,,63,-3,807,151,224,,26889
259115,4000,Female,GM0166,Kampen,2019JJ00,2019,26889,,290,,204,,86,954,,129,825,777,,61,-2,716,177,260,,27149
259116,4000,Female,GM0166,Kampen,2020JJ00,2020,27149,,293,,238,,55,918,,101,817,901,,68,-6,833,17,70,,27219
259117,4000,Female,GM0166,Kampen,2021JJ00,2021,27219,,342,,209,,133,892,,89,803,869,,82,-2,787,23,154,,27373
259118,4000,Female,GM0166,Kampen,2022JJ00,2022,27373,,328,,244,,84,1304,,356,948,951,,141,-1,810,353,437,,27810
259119,4000,Female,GM0166,Kampen,2023JJ00,2023,27810,,278,,225,,53,1179,,259,920,1010,,108,-5,902,169,222,,28032
259272,4000,Female,GM0678,Kapelle,2012JJ00,2012,6231,,63,,46,,17,283,,18,265,250,,15,-1,235,33,48,,6279
259273,4000,Female,GM0678,Kapelle,2013JJ00,2013,6279,,73,,43,,30,263,,27,236,285,,28,-3,257,-22,8,,6287
259274,4000,Female,GM0678,Kapelle,2014JJ00,2014,6287,,63,,38,,25,242,,26,216,262,,14,2,248,-20,5,,6292
259275,4000,Female,GM0678,Kapelle,2015JJ00,2015,6292,,63,,60,,3,313,,38,275,272,,23,-7,249,41,44,,6336
259276,4000,Female,GM0678,Kapelle,2016JJ00,2016,6336,,52,,62,,-10,335,,50,285,347,,30,-1,317,-12,-22,,6314
259277,4000,Female,GM0678,Kapelle,2017JJ00,2017,6314,,64,,49,,15,364,,21,343,320,,14,1,306,44,58,,6372
259278,4000,Female,GM0678,Kapelle,2018JJ00,2018,6372,,58,,53,,5,325,,28,297,307,,16,-1,291,18,22,,6394
259279,4000,Female,GM0678,Kapelle,2019JJ00,2019,6394,,50,,59,,-9,353,,38,315,368,,25,-6,343,-15,-24,,6370
259280,4000,Female,GM0678,Kapelle,2020JJ00,2020,6370,,76,,58,,18,364,,33,331,279,,9,1,270,85,103,,6473
259281,4000,Female,GM0678,Kapelle,2021JJ00,2021,6473,,64,,59,,5,355,,30,325,290,,20,1,270,65,68,,6541
259282,4000,Female,GM0678,Kapelle,2022JJ00,2022,6541,,67,,62,,5,411,,121,290,354,,46,-4,308,57,61,,6602
259283,4000,Female,GM0678,Kapelle,2023JJ00,2023,6602,,49,,54,,-5,317,,55,262,349,,39,-3,310,-32,-37,,6565
259436,4000,Female,GM0537,Katwijk,2012JJ00,2012,31458,,367,,244,,123,813,,112,701,837,,91,-5,746,-24,105,,31563
259437,4000,Female,GM0537,Katwijk,2013JJ00,2013,31563,,367,,290,,77,819,,138,681,895,,122,-26,773,-76,5,,31568
259438,4000,Female,GM0537,Katwijk,2014JJ00,2014,31568,,376,,261,,115,1080,,147,933,750,,121,-26,629,330,444,,32012
259439,4000,Female,GM0537,Katwijk,2015JJ00,2015,32012,,387,,274,,113,1214,,408,806,1019,,100,-22,919,195,308,,32320
259440,4000,Female,GM0537,Katwijk,2016JJ00,2016,32320,,346,,302,,44,1185,,248,937,1139,,134,-36,1005,46,89,,32409
259441,4000,Female,GM0537,Katwijk,2017JJ00,2017,32409,,350,,253,,97,1134,,154,980,943,,113,-23,830,191,285,,32694
259442,4000,Female,GM0537,Katwijk,2018JJ00,2018,32694,,407,,292,,115,1039,,182,857,973,,160,-52,813,66,183,,32877
259443,4000,Female,GM0537,Katwijk,2019JJ00,2019,32877,,366,,267,,99,1055,,185,870,910,,120,-13,790,145,246,,33123
259444,4000,Female,GM0537,Katwijk,2020JJ00,2020,33123,,349,,313,,36,1114,,145,969,1035,,99,-4,936,79,116,,33239
259445,4000,Female,GM0537,Katwijk,2021JJ00,2021,33239,,345,,250,,95,994,,127,867,1100,,102,-2,998,-106,-12,,33227
259446,4000,Female,GM0537,Katwijk,2022JJ00,2022,33227,,341,,284,,57,1308,,335,973,1107,,167,-26,940,201,261,,33488
259447,4000,Female,GM0537,Katwijk,2023JJ00,2023,33488,,352,,273,,79,1261,,216,1045,1128,,136,-18,992,133,205,,33693
259682,4000,Female,GM0928,Kerkrade,2012JJ00,2012,23740,,190,,297,,-107,1069,,160,909,1038,,183,-10,855,31,-76,,23664
259683,4000,Female,GM0928,Kerkrade,2013JJ00,2013,23664,,178,,346,,-168,985,,184,801,1021,,176,-11,845,-36,-205,,23459
259684,4000,Female,GM0928,Kerkrade,2014JJ00,2014,23459,,189,,275,,-86,1029,,166,863,1076,,146,-5,930,-47,-134,,23325
259685,4000,Female,GM0928,Kerkrade,2015JJ00,2015,23325,,157,,326,,-169,1024,,171,853,1117,,178,-3,939,-93,-262,,23063
259686,4000,Female,GM0928,Kerkrade,2016JJ00,2016,23063,,174,,316,,-142,1085,,170,915,1038,,154,-7,884,47,-94,,22969
259687,4000,Female,GM0928,Kerkrade,2017JJ00,2017,22969,,165,,314,,-149,1193,,204,989,1080,,152,-7,928,113,-37,,22932
259688,4000,Female,GM0928,Kerkrade,2018JJ00,2018,22932,,198,,354,,-156,1205,,225,980,1197,,186,-8,1011,8,-144,,22788
259689,4000,Female,GM0928,Kerkrade,2019JJ00,2019,22788,,166,,328,,-162,1265,,279,986,1098,,164,2,934,167,10,,22798
259690,4000,Female,GM0928,Kerkrade,2020JJ00,2020,22798,,177,,349,,-172,1252,,212,1040,1205,,180,-34,1025,47,-127,,22671
259691,4000,Female,GM0928,Kerkrade,2021JJ00,2021,22671,,182,,371,,-189,1345,,240,1105,1255,,191,-30,1064,90,-99,,22572
259692,4000,Female,GM0928,Kerkrade,2022JJ00,2022,22572,,189,,339,,-150,1431,,404,1027,1075,,202,-25,873,356,202,,22774
259693,4000,Female,GM0928,Kerkrade,2023JJ00,2023,22774,,170,,289,,-119,1125,,296,829,1160,,196,-32,964,-35,-157,,22617
260748,4000,Female,GM1598,Koggenland,2012JJ00,2012,11112,,98,,87,,11,414,,33,381,393,,21,2,372,21,33,,11145
260749,4000,Female,GM1598,Koggenland,2013JJ00,2013,11145,,112,,91,,21,421,,43,378,394,,28,-5,366,27,47,,11192
260750,4000,Female,GM1598,Koggenland,2014JJ00,2014,11192,,116,,100,,16,410,,39,371,459,,39,-2,420,-49,-32,,11160
260751,4000,Female,GM1598,Koggenland,2015JJ00,2015,11160,,88,,99,,-11,488,,54,434,467,,38,1,429,21,12,,11172
260752,4000,Female,GM1598,Koggenland,2016JJ00,2016,11172,,100,,88,,12,508,,46,462,510,,27,-1,483,-2,10,,11182
260753,4000,Female,GM1598,Koggenland,2017JJ00,2017,11182,,108,,106,,2,561,,31,530,519,,46,-4,473,42,41,,11223
260754,4000,Female,GM1598,Koggenland,2018JJ00,2018,11223,,107,,105,,2,543,,47,496,511,,33,0,478,32,37,,11260
260755,4000,Female,GM1598,Koggenland,2019JJ00,2019,11260,,97,,92,,5,513,,41,472,497,,32,-1,465,16,25,,11285
260756,4000,Female,GM1598,Koggenland,2020JJ00,2020,11285,,89,,103,,-14,588,,33,555,473,,37,-8,436,115,100,,11385
260757,4000,Female,GM1598,Koggenland,2021JJ00,2021,11385,,119,,101,,18,520,,41,479,498,,29,-1,469,22,39,,11424
260758,4000,Female,GM1598,Koggenland,2022JJ00,2022,11424,,119,,103,,16,794,,276,518,549,,103,-37,446,245,262,,11686
260759,4000,Female,GM1598,Koggenland,2023JJ00,2023,11686,,125,,111,,14,696,,145,551,671,,117,-31,554,25,37,,11723
260830,4000,Female,GM0079,Kollumerland en Nieuwkruisland,2012JJ00,2012,6276,,63,,70,,-7,211,,10,201,252,,5,4,247,-41,-47,,6229
260831,4000,Female,GM0079,Kollumerland en Nieuwkruisland,2013JJ00,2013,6229,,68,,62,,6,260,,10,250,236,,4,1,232,24,30,,6259
260832,4000,Female,GM0079,Kollumerland en Nieuwkruisland,2014JJ00,2014,6259,,64,,49,,15,231,,13,218,278,,8,-3,270,-47,-32,,6227
260833,4000,Female,GM0079,Kollumerland en Nieuwkruisland,2015JJ00,2015,6227,,65,,51,,14,255,,6,249,266,,7,0,259,-11,3,,6230
260834,4000,Female,GM0079,Kollumerland en Nieuwkruisland,2016JJ00,2016,6230,,74,,59,,15,296,,8,288,258,,10,2,248,38,52,,6282
260835,4000,Female,GM0079,Kollumerland en Nieuwkruisland,2017JJ00,2017,6282,,55,,66,,-11,283,,8,275,297,,5,0,292,-14,-25,,6257
260836,4000,Female,GM0079,Kollumerland en Nieuwkruisland,2018JJ00,2018,6257,,63,,57,,6,290,,13,277,290,,8,1,282,0,3,,6260
260994,4000,Female,GM0588,Korendijk,2012JJ00,2012,5400,,44,,33,,11,189,,10,179,211,,5,2,206,-22,-10,,5390
260995,4000,Female,GM0588,Korendijk,2013JJ00,2013,5390,,55,,60,,-5,162,,10,152,195,,8,1,187,-33,-38,,5352
260996,4000,Female,GM0588,Korendijk,2014JJ00,2014,5352,,54,,38,,16,227,,12,215,174,,7,-1,167,53,68,,5420
260997,4000,Female,GM0588,Korendijk,2015JJ00,2015,5420,,54,,48,,6,252,,17,235,230,,15,-3,215,22,28,,5448
260998,4000,Female,GM0588,Korendijk,2016JJ00,2016,5448,,55,,43,,12,273,,14,259,233,,10,1,223,40,52,,5500
260999,4000,Female,GM0588,Korendijk,2017JJ00,2017,5500,,54,,53,,1,320,,16,304,249,,0,4,249,71,72,,5572
261000,4000,Female,GM0588,Korendijk,2018JJ00,2018,5572,,50,,57,,-7,293,,12,281,249,,23,0,226,44,35,,5607
261568,4000,Female,GM0542,Krimpen aan den IJssel,2012JJ00,2012,14740,,124,,138,,-14,578,,49,529,492,,38,-2,454,86,72,,14812
261569,4000,Female,GM0542,Krimpen aan den IJssel,2013JJ00,2013,14812,,131,,125,,6,522,,40,482,522,,39,-9,483,0,6,,14818
261570,4000,Female,GM0542,Krimpen aan den IJssel,2014JJ00,2014,14818,,144,,118,,26,579,,45,534,464,,38,-4,426,115,141,,14959
261571,4000,Female,GM0542,Krimpen aan den IJssel,2015JJ00,2015,14959,,142,,129,,13,560,,34,526,534,,36,-2,498,26,40,,14999
261572,4000,Female,GM0542,Krimpen aan den IJssel,2016JJ00,2016,14999,,137,,140,,-3,603,,37,566,585,,38,-12,547,18,15,,15014
261573,4000,Female,GM0542,Krimpen aan den IJssel,2017JJ00,2017,15014,,139,,141,,-2,704,,48,656,572,,21,1,551,132,128,,15142
261574,4000,Female,GM0542,Krimpen aan den IJssel,2018JJ00,2018,15142,,148,,154,,-6,614,,40,574,554,,41,-1,513,60,55,,15197
261575,4000,Female,GM0542,Krimpen aan den IJssel,2019JJ00,2019,15197,,149,,157,,-8,627,,42,585,547,,43,-4,504,80,70,,15267
261576,4000,Female,GM0542,Krimpen aan den IJssel,2020JJ00,2020,15267,,112,,180,,-68,642,,39,603,616,,28,-7,588,26,-42,,15225
261577,4000,Female,GM0542,Krimpen aan den IJssel,2021JJ00,2021,15225,,150,,157,,-7,630,,53,577,626,,39,-3,587,4,-4,,15221
261578,4000,Female,GM0542,Krimpen aan den IJssel,2022JJ00,2022,15221,,146,,155,,-9,686,,105,581,585,,65,-15,520,101,94,,15315
261579,4000,Female,GM0542,Krimpen aan den IJssel,2023JJ00,2023,15315,,146,,151,,-5,665,,84,581,613,,58,-13,555,52,48,,15363
261653,4000,Female,GM1931,Krimpenerwaard,2015JJ00,2015,27351,,289,,206,,83,1041,,110,931,894,,73,-15,821,147,208,,27559
261654,4000,Female,GM1931,Krimpenerwaard,2016JJ00,2016,27559,,252,,241,,11,1192,,105,1087,863,,79,-5,784,329,338,,27897
261655,4000,Female,GM1931,Krimpenerwaard,2017JJ00,2017,27897,,270,,217,,53,1212,,87,1125,1055,,84,-14,971,157,208,,28105
261656,4000,Female,GM1931,Krimpenerwaard,2018JJ00,2018,28105,,273,,226,,47,1122,,68,1054,1015,,63,-5,952,107,155,,28260
261657,4000,Female,GM1931,Krimpenerwaard,2019JJ00,2019,28260,,274,,236,,38,1087,,82,1005,1001,,72,-14,929,86,125,,28385
261658,4000,Female,GM1931,Krimpenerwaard,2020JJ00,2020,28385,,271,,236,,35,1096,,90,1006,1003,,52,-9,951,93,130,,28515
261659,4000,Female,GM1931,Krimpenerwaard,2021JJ00,2021,28515,,331,,248,,83,1113,,94,1019,950,,60,-3,890,163,245,,28760
261660,4000,Female,GM1931,Krimpenerwaard,2022JJ00,2022,28760,,281,,236,,45,1354,,326,1028,1063,,144,-19,919,291,334,,29094
261661,4000,Female,GM1931,Krimpenerwaard,2023JJ00,2023,29094,,307,,281,,26,1042,,152,890,1064,,103,-17,961,-22,4,,29098
262142,4000,Female,GM1659,Laarbeek,2012JJ00,2012,10687,,87,,78,,9,403,,47,356,351,,30,-2,321,52,61,,10748
262143,4000,Female,GM1659,Laarbeek,2013JJ00,2013,10748,,85,,85,,0,368,,34,334,323,,41,-13,282,45,45,,10793
262144,4000,Female,GM1659,Laarbeek,2014JJ00,2014,10793,,96,,94,,2,392,,50,342,355,,27,-2,328,37,38,,10831
262145,4000,Female,GM1659,Laarbeek,2015JJ00,2015,10831,,91,,113,,-22,398,,48,350,357,,33,0,324,41,19,,10850
262146,4000,Female,GM1659,Laarbeek,2016JJ00,2016,10850,,78,,103,,-25,388,,35,353,391,,29,-4,362,-3,-27,,10823
262147,4000,Female,GM1659,Laarbeek,2017JJ00,2017,10823,,86,,115,,-29,548,,52,496,423,,24,-4,399,125,93,,10916
262148,4000,Female,GM1659,Laarbeek,2018JJ00,2018,10916,,92,,95,,-3,503,,50,453,382,,20,0,362,121,119,,11035
262149,4000,Female,GM1659,Laarbeek,2019JJ00,2019,11035,,96,,106,,-10,529,,51,478,447,,35,-2,412,82,72,,11107
262150,4000,Female,GM1659,Laarbeek,2020JJ00,2020,11107,,104,,123,,-19,577,,48,529,409,,44,-7,365,168,145,,11252
262151,4000,Female,GM1659,Laarbeek,2021JJ00,2021,11252,,126,,118,,8,483,,29,454,405,,22,-3,383,78,85,,11337
262152,4000,Female,GM1659,Laarbeek,2022JJ00,2022,11337,,134,,114,,20,619,,123,496,432,,47,-9,385,187,206,,11543
262153,4000,Female,GM1659,Laarbeek,2023JJ00,2023,11543,,110,,139,,-29,458,,81,377,473,,53,-10,420,-15,-46,,11497
262234,4000,Female,GM1982,Land van Cuijk,2022JJ00,2022,44876,,396,,470,,-74,2180,,481,1699,1708,,199,-27,1509,472,395,,45271
262235,4000,Female,GM1982,Land van Cuijk,2023JJ00,2023,45271,,359,,482,,-123,1839,,447,1392,1613,,257,-98,1356,226,103,,45374
262306,4000,Female,GM1685,Landerd,2012JJ00,2012,7367,,76,,64,,12,312,,19,293,232,,10,1,222,80,92,,7459
262307,4000,Female,GM1685,Landerd,2013JJ00,2013,7459,,75,,61,,14,292,,32,260,268,,20,-2,248,24,38,,7497
262308,4000,Female,GM1685,Landerd,2014JJ00,2014,7497,,59,,59,,0,295,,26,269,296,,17,0,279,-1,0,,7497
262309,4000,Female,GM1685,Landerd,2015JJ00,2015,7497,,65,,77,,-12,295,,44,251,270,,22,-1,248,25,12,,7509
262310,4000,Female,GM1685,Landerd,2016JJ00,2016,7509,,53,,77,,-24,337,,25,312,315,,13,1,302,22,-2,,7507
262311,4000,Female,GM1685,Landerd,2017JJ00,2017,7507,,70,,77,,-7,352,,26,326,347,,20,-2,327,5,-2,,7505
262312,4000,Female,GM1685,Landerd,2018JJ00,2018,7505,,63,,67,,-4,386,,36,350,287,,13,1,274,99,95,,7600
262313,4000,Female,GM1685,Landerd,2019JJ00,2019,7600,,59,,63,,-4,400,,37,363,291,,25,1,266,109,104,,7704
262314,4000,Female,GM1685,Landerd,2020JJ00,2020,7704,,75,,72,,3,349,,42,307,314,,22,-3,292,35,40,,7744
262315,4000,Female,GM1685,Landerd,2021JJ00,2021,7744,,82,,83,,-1,323,,35,288,282,,24,1,258,41,34,,7778
262388,4000,Female,GM0882,Landgraaf,2012JJ00,2012,19337,,121,,199,,-78,829,,70,759,863,,81,-2,782,-34,-111,,19226
262389,4000,Female,GM0882,Landgraaf,2013JJ00,2013,19226,,136,,207,,-71,805,,66,739,885,,90,-2,795,-80,-151,,19075
262390,4000,Female,GM0882,Landgraaf,2014JJ00,2014,19075,,148,,161,,-13,893,,61,832,948,,86,-2,862,-55,-68,,19007
262391,4000,Female,GM0882,Landgraaf,2015JJ00,2015,19007,,133,,188,,-55,947,,96,851,876,,75,-8,801,71,13,,19020
262392,4000,Female,GM0882,Landgraaf,2016JJ00,2016,19020,,134,,191,,-57,939,,78,861,883,,73,-6,810,56,-2,,19018
262393,4000,Female,GM0882,Landgraaf,2017JJ00,2017,19018,,139,,224,,-85,1072,,92,980,945,,67,1,878,127,43,,19061
262394,4000,Female,GM0882,Landgraaf,2018JJ00,2018,19061,,141,,218,,-77,1011,,93,918,941,,68,-10,873,70,-8,,19053
262395,4000,Female,GM0882,Landgraaf,2019JJ00,2019,19053,,160,,206,,-46,961,,82,879,978,,89,-12,889,-17,-64,,18989
262396,4000,Female,GM0882,Landgraaf,2020JJ00,2020,18989,,152,,231,,-79,933,,90,843,922,,67,-7,855,11,-69,,18920
262397,4000,Female,GM0882,Landgraaf,2021JJ00,2021,18920,,137,,276,,-139,956,,104,852,929,,65,-5,864,27,-115,,18805
262398,4000,Female,GM0882,Landgraaf,2022JJ00,2022,18805,,137,,228,,-91,1027,,219,808,872,,100,-3,772,155,63,,18868
262399,4000,Female,GM0882,Landgraaf,2023JJ00,2023,18868,,135,,231,,-96,900,,128,772,810,,94,-17,716,90,-7,,18861
262470,4000,Female,GM0415,Landsmeer,2012JJ00,2012,5376,,43,,39,,4,249,,29,220,187,,10,0,177,62,66,,5442
262471,4000,Female,GM0415,Landsmeer,2013JJ00,2013,5442,,36,,39,,-3,196,,16,180,197,,22,-7,175,-1,-3,,5439
262472,4000,Female,GM0415,Landsmeer,2014JJ00,2014,5439,,45,,37,,8,416,,27,389,226,,21,-3,205,190,199,,5638
262473,4000,Female,GM0415,Landsmeer,2015JJ00,2015,5638,,44,,49,,-5,291,,25,266,228,,24,-4,204,63,59,,5697
262474,4000,Female,GM0415,Landsmeer,2016JJ00,2016,5697,,50,,36,,14,431,,21,410,304,,21,-3,283,127,141,,5838
262475,4000,Female,GM0415,Landsmeer,2017JJ00,2017,5838,,58,,41,,17,340,,24,316,270,,19,-5,251,70,86,,5924
262476,4000,Female,GM0415,Landsmeer,2018JJ00,2018,5924,,47,,51,,-4,334,,38,296,282,,12,5,270,52,46,,5970
262477,4000,Female,GM0415,Landsmeer,2019JJ00,2019,5970,,50,,51,,-1,268,,21,247,288,,26,-1,262,-20,-21,,5949
262478,4000,Female,GM0415,Landsmeer,2020JJ00,2020,5949,,42,,53,,-11,329,,28,301,289,,15,1,274,40,29,,5978
262479,4000,Female,GM0415,Landsmeer,2021JJ00,2021,5978,,50,,50,,0,321,,22,299,322,,29,-3,293,-1,-1,,5977
262480,4000,Female,GM0415,Landsmeer,2022JJ00,2022,5977,,31,,46,,-15,372,,76,296,278,,29,-3,249,94,78,,6055
262481,4000,Female,GM0415,Landsmeer,2023JJ00,2023,6055,,32,,51,,-19,311,,39,272,315,,41,-4,274,-4,-22,,6033
262716,4000,Female,GM0416,Langedijk,2012JJ00,2012,13527,,141,,78,,63,512,,34,478,633,,45,2,588,-121,-59,,13468
262717,4000,Female,GM0416,Langedijk,2013JJ00,2013,13468,,121,,83,,38,588,,43,545,603,,30,1,573,-15,24,,13492
262718,4000,Female,GM0416,Langedijk,2014JJ00,2014,13492,,146,,85,,61,677,,57,620,527,,35,-2,492,150,213,,13705
262719,4000,Female,GM0416,Langedijk,2015JJ00,2015,13705,,125,,99,,26,789,,53,736,702,,37,-4,665,87,112,,13817
262720,4000,Female,GM0416,Langedijk,2016JJ00,2016,13817,,124,,90,,34,769,,54,715,720,,45,-4,675,49,82,,13899
262721,4000,Female,GM0416,Langedijk,2017JJ00,2017,13899,,116,,92,,24,858,,51,807,779,,46,-3,733,79,103,,14002
262722,4000,Female,GM0416,Langedijk,2018JJ00,2018,14002,,135,,97,,38,746,,61,685,707,,34,-8,673,39,73,,14075
262723,4000,Female,GM0416,Langedijk,2019JJ00,2019,14075,,127,,88,,39,800,,62,738,759,,49,-10,710,41,77,,14152
262724,4000,Female,GM0416,Langedijk,2020JJ00,2020,14152,,148,,92,,56,782,,60,722,756,,22,6,734,26,86,,14238
262725,4000,Female,GM0416,Langedijk,2021JJ00,2021,14238,,131,,111,,20,829,,45,784,693,,35,-8,658,136,133,,14371
262880,4000,Female,GM1621,Lansingerland,2012JJ00,2012,27739,,387,,143,,244,1229,,116,1113,835,,108,7,727,394,640,,28379
262881,4000,Female,GM1621,Lansingerland,2013JJ00,2013,28379,,346,,154,,192,1079,,103,976,898,,93,-1,805,181,370,,28749
262882,4000,Female,GM1621,Lansingerland,2014JJ00,2014,28749,,333,,125,,208,1258,,122,1136,983,,107,-5,876,275,483,,29232
262883,4000,Female,GM1621,Lansingerland,2015JJ00,2015,29232,,322,,172,,150,1389,,129,1260,1073,,117,-5,956,316,466,,29698
262884,4000,Female,GM1621,Lansingerland,2016JJ00,2016,29698,,331,,164,,167,1547,,146,1401,1163,,107,-8,1056,384,549,,30247
262885,4000,Female,GM1621,Lansingerland,2017JJ00,2017,30247,,373,,176,,197,1565,,120,1445,1171,,97,-1,1074,394,591,,30838
262886,4000,Female,GM1621,Lansingerland,2018JJ00,2018,30838,,342,,187,,155,1331,,120,1211,1223,,85,5,1138,108,264,,31102
262887,4000,Female,GM1621,Lansingerland,2019JJ00,2019,31102,,359,,200,,159,1460,,125,1335,1166,,89,-10,1077,294,454,,31556
262888,4000,Female,GM1621,Lansingerland,2020JJ00,2020,31562,,367,,198,,169,1616,,143,1473,1225,,97,-10,1128,391,559,,32121
262889,4000,Female,GM1621,Lansingerland,2021JJ00,2021,32121,,367,,219,,148,1537,,126,1411,1301,,100,-7,1201,236,382,,32503
262890,4000,Female,GM1621,Lansingerland,2022JJ00,2022,32503,,308,,205,,103,1614,,214,1400,1368,,150,-15,1218,246,351,,32854
262891,4000,Female,GM1621,Lansingerland,2023JJ00,2023,32854,,335,,246,,89,1623,,187,1436,1309,,147,-19,1162,314,404,,33258
263044,4000,Female,GM0417,Laren (NH.),2012JJ00,2012,5939,,36,,126,,-90,490,,102,388,530,,95,-44,435,-40,-129,,5810
263045,4000,Female,GM0417,Laren (NH.),2013JJ00,2013,5810,,27,,138,,-111,427,,57,370,352,,60,-5,292,75,-36,,5774
263046,4000,Female,GM0417,Laren (NH.),2014JJ00,2014,5774,,35,,141,,-106,449,,69,380,376,,47,-1,329,73,-31,,5743
263047,4000,Female,GM0417,Laren (NH.),2015JJ00,2015,5743,,29,,116,,-87,549,,83,466,406,,76,-6,330,143,58,,5801
263048,4000,Female,GM0417,Laren (NH.),2016JJ00,2016,5801,,25,,136,,-111,585,,103,482,409,,53,-4,356,176,64,,5865
263049,4000,Female,GM0417,Laren (NH.),2017JJ00,2017,5865,,37,,136,,-99,565,,107,458,458,,55,-1,403,107,7,,5872
263050,4000,Female,GM0417,Laren (NH.),2018JJ00,2018,5872,,38,,123,,-85,528,,101,427,416,,83,0,333,112,31,,5903
263051,4000,Female,GM0417,Laren (NH.),2019JJ00,2019,5903,,37,,141,,-104,580,,119,461,407,,68,-2,339,173,68,,5971
263052,4000,Female,GM0417,Laren (NH.),2020JJ00,2020,5971,,46,,167,,-121,606,,97,509,456,,60,-3,396,150,29,,6000
263053,4000,Female,GM0417,Laren (NH.),2021JJ00,2021,6000,,45,,167,,-122,642,,99,543,438,,50,2,388,204,83,,6083
263054,4000,Female,GM0417,Laren (NH.),2022JJ00,2022,6083,,37,,145,,-108,717,,192,525,499,,103,0,396,218,110,,6193
263055,4000,Female,GM0417,Laren (NH.),2023JJ00,2023,6193,,33,,137,,-104,519,,105,414,584,,77,-3,507,-65,-169,,6024
263126,4000,Female,GM0022,Leek,2012JJ00,2012,9806,,90,,73,,17,495,,35,460,428,,36,-13,392,67,85,,9891
263127,4000,Female,GM0022,Leek,2013JJ00,2013,9891,,79,,74,,5,407,,29,378,396,,19,-6,377,11,16,,9907
263128,4000,Female,GM0022,Leek,2014JJ00,2014,9907,,95,,77,,18,464,,44,420,510,,38,-14,472,-46,-29,,9878
263129,4000,Female,GM0022,Leek,2015JJ00,2015,9878,,88,,84,,4,552,,30,522,500,,30,-5,470,52,57,,9935
263130,4000,Female,GM0022,Leek,2016JJ00,2016,9935,,69,,89,,-20,592,,31,561,558,,26,2,532,34,14,,9949
263131,4000,Female,GM0022,Leek,2017JJ00,2017,9949,,72,,108,,-36,588,,23,565,524,,37,-5,487,64,28,,9977
263132,4000,Female,GM0022,Leek,2018JJ00,2018,9977,,89,,104,,-15,597,,31,566,558,,19,0,539,39,19,,9996
263454,4000,Female,GM0545,Leerdam,2012JJ00,2012,10511,,106,,120,,-14,392,,40,352,340,,58,-7,282,52,38,,10549
263455,4000,Female,GM0545,Leerdam,2013JJ00,2013,10549,,95,,118,,-23,331,,46,285,367,,60,-19,307,-36,-59,,10490
263456,4000,Female,GM0545,Leerdam,2014JJ00,2014,10490,,92,,119,,-27,375,,25,350,363,,65,-5,298,12,-15,,10475
263457,4000,Female,GM0545,Leerdam,2015JJ00,2015,10475,,100,,111,,-11,446,,36,410,379,,42,-14,337,67,55,,10530
263458,4000,Female,GM0545,Leerdam,2016JJ00,2016,10530,,112,,114,,-2,494,,54,440,392,,32,2,360,102,101,,10631
263459,4000,Female,GM0545,Leerdam,2017JJ00,2017,10631,,110,,134,,-24,590,,49,541,503,,54,-7,449,87,63,,10694
263460,4000,Female,GM0545,Leerdam,2018JJ00,2018,10694,,117,,123,,-6,532,,49,483,439,,39,3,400,93,104,,10798
263618,4000,Female,GM0080,Leeuwarden,2012JJ00,2012,48594,,513,,435,,78,3346,,663,2683,3184,,605,-8,2579,162,238,,48832
263619,4000,Female,GM0080,Leeuwarden,2013JJ00,2013,48832,,494,,451,,43,3465,,645,2820,3428,,667,-26,2761,37,83,,48915
263620,4000,Female,GM0080,Leeuwarden,2014JJ00,2014,54389,,565,,466,,99,3673,,659,3014,3732,,772,-39,2960,-59,38,,54427
263621,4000,Female,GM0080,Leeuwarden,2015JJ00,2015,54427,,536,,463,,73,3507,,704,2803,3519,,544,-14,2975,-12,63,,54490
263622,4000,Female,GM0080,Leeuwarden,2016JJ00,2016,54490,,543,,490,,53,4021,,830,3191,3723,,611,-49,3112,298,346,,54836
263623,4000,Female,GM0080,Leeuwarden,2017JJ00,2017,54836,,564,,529,,35,3942,,877,3065,3948,,738,-112,3210,-6,38,,54874
263624,4000,Female,GM0080,Leeuwarden,2018JJ00,2018,61592,,551,,529,,22,4225,,1009,3216,3854,,717,-49,3137,371,388,,61980
263625,4000,Female,GM0080,Leeuwarden,2019JJ00,2019,61980,,559,,590,,-31,4242,,1125,3117,3790,,648,-21,3142,452,427,,62407
263626,4000,Female,GM0080,Leeuwarden,2020JJ00,2020,62407,,569,,536,,33,4093,,853,3240,3979,,739,-62,3240,114,133,,62540
263627,4000,Female,GM0080,Leeuwarden,2021JJ00,2021,62540,,657,,636,,21,4071,,859,3212,3525,,597,-83,2928,546,559,,63099
263628,4000,Female,GM0080,Leeuwarden,2022JJ00,2022,63099,,596,,635,,-39,4527,,1538,2989,3755,,804,-122,2951,772,726,,63825
263629,4000,Female,GM0080,Leeuwarden,2023JJ00,2023,63825,,575,,577,,-2,5057,,1439,3618,4173,,909,-167,3264,884,878,,64703
263700,4000,Female,GM0081,Leeuwarderadeel,2012JJ00,2012,5124,,40,,47,,-7,215,,13,202,204,,9,-1,195,11,4,,5128
263701,4000,Female,GM0081,Leeuwarderadeel,2013JJ00,2013,5128,,41,,36,,5,245,,12,233,237,,12,-1,225,8,13,,5141
263702,4000,Female,GM0081,Leeuwarderadeel,2014JJ00,2014,5141,,48,,36,,12,212,,13,199,240,,9,-1,231,-28,-17,,5124
263703,4000,Female,GM0081,Leeuwarderadeel,2015JJ00,2015,5124,,27,,50,,-23,223,,7,216,223,,5,0,218,0,-24,,5100
263704,4000,Female,GM0081,Leeuwarderadeel,2016JJ00,2016,5100,,38,,47,,-9,257,,8,249,281,,11,0,270,-24,-33,,5067
263705,4000,Female,GM0081,Leeuwarderadeel,2017JJ00,2017,5067,,41,,48,,-7,257,,5,252,252,,13,-1,239,5,-7,,5060
263782,4000,Female,GM0546,Leiden,2012JJ00,2012,60900,,610,,441,,169,4963,,1189,3774,4463,,1031,-200,3432,500,672,,61572
263783,4000,Female,GM0546,Leiden,2013JJ00,2013,61572,,636,,472,,164,5103,,1263,3840,4561,,1109,-163,3452,542,702,,62274
263784,4000,Female,GM0546,Leiden,2014JJ00,2014,62274,,607,,464,,143,5062,,1280,3782,4993,,1134,-194,3859,69,204,,62478
263785,4000,Female,GM0546,Leiden,2015JJ00,2015,62478,,599,,485,,114,5540,,1505,4035,5192,,1167,-175,4025,348,458,,62936
263786,4000,Female,GM0546,Leiden,2016JJ00,2016,62936,,607,,455,,152,6109,,1588,4521,5595,,1475,-332,4120,514,658,,63594
263787,4000,Female,GM0546,Leiden,2017JJ00,2017,63594,,578,,456,,122,6357,,1894,4463,5982,,1638,-436,4344,375,489,,64083
263788,4000,Female,GM0546,Leiden,2018JJ00,2018,64083,,516,,515,,1,6057,,1948,4109,5742,,1438,-230,4304,315,321,,64404
263789,4000,Female,GM0546,Leiden,2019JJ00,2019,64404,,538,,517,,21,6028,,2079,3949,5903,,1403,-140,4500,125,139,,64543
263790,4000,Female,GM0546,Leiden,2020JJ00,2020,64543,,531,,547,,-16,5869,,1401,4468,6450,,1517,-338,4933,-581,-596,,63947
263791,4000,Female,GM0546,Leiden,2021JJ00,2021,63947,,538,,534,,4,6161,,1712,4449,5634,,1026,-107,4608,527,528,,64475
263792,4000,Female,GM0546,Leiden,2022JJ00,2022,64475,,508,,509,,-1,6833,,2495,4338,5654,,1192,-79,4462,1179,1177,,65652
263793,4000,Female,GM0546,Leiden,2023JJ00,2023,65652,,509,,528,,-19,7834,,2220,5614,5931,,1317,-137,4614,1903,1879,,67531
263864,4000,Female,GM0547,Leiderdorp,2012JJ00,2012,13823,,122,,99,,23,654,,72,582,668,,63,-4,605,-14,7,,13830
263865,4000,Female,GM0547,Leiderdorp,2013JJ00,2013,13830,,131,,94,,37,630,,82,548,617,,59,-2,558,13,45,,13875
263866,4000,Female,GM0547,Leiderdorp,2014JJ00,2014,13875,,100,,98,,2,698,,92,606,658,,59,-4,599,40,41,,13916
263867,4000,Female,GM0547,Leiderdorp,2015JJ00,2015,13916,,120,,95,,25,765,,139,626,754,,82,-8,672,11,36,,13952
263868,4000,Female,GM0547,Leiderdorp,2016JJ00,2016,13952,,146,,120,,26,912,,115,797,896,,78,-2,818,16,37,,13989
263869,4000,Female,GM0547,Leiderdorp,2017JJ00,2017,13989,,102,,115,,-13,858,,93,765,805,,88,-7,717,53,39,,14028
263870,4000,Female,GM0547,Leiderdorp,2018JJ00,2018,14028,,115,,123,,-8,733,,84,649,764,,97,-15,667,-31,-39,,13989
263871,4000,Female,GM0547,Leiderdorp,2019JJ00,2019,13989,,123,,116,,7,736,,79,657,771,,80,-5,691,-35,-28,,13961
263872,4000,Female,GM0547,Leiderdorp,2020JJ00,2020,13961,,123,,135,,-12,936,,87,849,791,,74,-8,717,145,129,,14090
263873,4000,Female,GM0547,Leiderdorp,2021JJ00,2021,14090,,120,,123,,-3,832,,87,745,761,,46,-1,715,71,68,,14158
263874,4000,Female,GM0547,Leiderdorp,2022JJ00,2022,14158,,131,,160,,-29,835,,145,690,719,,71,0,648,116,88,,14246
263875,4000,Female,GM0547,Leiderdorp,2023JJ00,2023,14246,,126,,157,,-31,853,,111,742,829,,69,-2,760,24,-5,,14241
264028,4000,Female,GM1916,Leidschendam-Voorburg,2012JJ00,2012,37785,,404,,374,,30,2191,,375,1816,2133,,396,-57,1737,58,89,,37874
264029,4000,Female,GM1916,Leidschendam-Voorburg,2013JJ00,2013,37874,,375,,331,,44,2332,,383,1949,1988,,354,-33,1634,344,391,,38265
264030,4000,Female,GM1916,Leidschendam-Voorburg,2014JJ00,2014,38265,,410,,348,,62,2433,,381,2052,2238,,378,-24,1860,195,262,,38527
264031,4000,Female,GM1916,Leidschendam-Voorburg,2015JJ00,2015,38527,,389,,346,,43,2474,,418,2056,2429,,377,-44,2052,45,91,,38618
264032,4000,Female,GM1916,Leidschendam-Voorburg,2016JJ00,2016,38618,,380,,390,,-10,2644,,439,2205,2471,,355,-24,2116,173,168,,38786
264033,4000,Female,GM1916,Leidschendam-Voorburg,2017JJ00,2017,38786,,364,,391,,-27,2769,,513,2256,2648,,411,-27,2237,121,88,,38874
264034,4000,Female,GM1916,Leidschendam-Voorburg,2018JJ00,2018,38874,,353,,359,,-6,2700,,536,2164,2465,,377,-32,2088,235,225,,39099
264035,4000,Female,GM1916,Leidschendam-Voorburg,2019JJ00,2019,39099,,400,,404,,-4,2966,,527,2439,2440,,400,-9,2040,526,511,,39610
264036,4000,Female,GM1916,Leidschendam-Voorburg,2020JJ00,2020,39610,,357,,403,,-46,2681,,441,2240,2681,,348,-27,2333,0,-51,,39559
264037,4000,Female,GM1916,Leidschendam-Voorburg,2021JJ00,2021,39559,,393,,430,,-37,2900,,471,2429,2691,,343,3,2348,209,166,,39725
264038,4000,Female,GM1916,Leidschendam-Voorburg,2022JJ00,2022,39725,,377,,417,,-40,3270,,730,2540,2638,,377,-15,2261,632,593,,40318
264039,4000,Female,GM1916,Leidschendam-Voorburg,2023JJ00,2023,40318,,350,,412,,-62,3002,,697,2305,2661,,420,-29,2241,341,276,,40594
264274,4000,Female,GM0995,Lelystad,2012JJ00,2012,37766,,424,,264,,160,1430,,275,1155,1407,,269,-81,1138,23,186,,37952
264275,4000,Female,GM0995,Lelystad,2013JJ00,2013,37952,,400,,285,,115,1384,,269,1115,1309,,230,-48,1079,75,188,,38140
264276,4000,Female,GM0995,Lelystad,2014JJ00,2014,38140,,473,,278,,195,1401,,298,1103,1437,,289,-44,1148,-36,170,,38310
264277,4000,Female,GM0995,Lelystad,2015JJ00,2015,38310,,408,,269,,139,1486,,280,1206,1512,,235,-38,1277,-26,115,,38425
264278,4000,Female,GM0995,Lelystad,2016JJ00,2016,38425,,371,,294,,77,1527,,361,1166,1646,,233,-46,1413,-119,-48,,38377
264279,4000,Female,GM0995,Lelystad,2017JJ00,2017,38377,,377,,267,,110,1690,,281,1409,1601,,225,-40,1376,89,197,,38574
264280,4000,Female,GM0995,Lelystad,2018JJ00,2018,38574,,424,,300,,124,1755,,375,1380,1607,,225,-19,1382,148,271,,38845
264281,4000,Female,GM0995,Lelystad,2019JJ00,2019,38845,,395,,298,,97,1928,,443,1485,1754,,212,-22,1542,174,268,,39113
264282,4000,Female,GM0995,Lelystad,2020JJ00,2020,39113,,417,,317,,100,2119,,409,1710,1636,,207,-44,1429,483,588,,39701
264283,4000,Female,GM0995,Lelystad,2021JJ00,2021,39701,,424,,331,,93,2312,,474,1838,1736,,255,-15,1481,576,667,,40368
264284,4000,Female,GM0995,Lelystad,2022JJ00,2022,40368,,456,,314,,142,2718,,932,1786,1965,,394,-57,1571,753,896,,41264
264285,4000,Female,GM0995,Lelystad,2023JJ00,2023,41264,,418,,317,,101,2447,,739,1708,1996,,469,-145,1527,451,546,,41810
264356,4000,Female,GM0082,Lemsterland,2012JJ00,2012,6662,,62,,44,,18,244,,28,216,249,,31,-1,218,-5,13,,6675
264357,4000,Female,GM0082,Lemsterland,2013JJ00,2013,6675,,74,,50,,24,230,,32,198,256,,23,0,233,-26,-5,,6670
264438,4000,Female,GM1640,Leudal,2012JJ00,2012,18019,,128,,159,,-31,780,,204,576,775,,97,-15,678,5,-26,,17993
264439,4000,Female,GM1640,Leudal,2013JJ00,2013,17993,,123,,166,,-43,737,,186,551,785,,76,-17,709,-48,-92,,17901
264440,4000,Female,GM1640,Leudal,2014JJ00,2014,17901,,122,,177,,-55,848,,259,589,799,,73,-18,726,49,-6,,17895
264441,4000,Female,GM1640,Leudal,2015JJ00,2015,17895,,130,,169,,-39,859,,231,628,886,,85,-18,801,-27,-67,,17828
264442,4000,Female,GM1640,Leudal,2016JJ00,2016,17828,,143,,188,,-45,777,,154,623,899,,89,-27,810,-122,-162,,17666
264443,4000,Female,GM1640,Leudal,2017JJ00,2017,17666,,136,,176,,-40,1024,,117,907,976,,70,-12,906,48,11,,17677
264444,4000,Female,GM1640,Leudal,2018JJ00,2018,17677,,126,,194,,-68,932,,122,810,901,,72,-3,829,31,-38,,17639
264445,4000,Female,GM1640,Leudal,2019JJ00,2019,17639,,133,,190,,-57,983,,165,818,832,,96,-29,736,151,94,,17733
264446,4000,Female,GM1640,Leudal,2020JJ00,2020,17733,,120,,222,,-102,1046,,114,932,895,,103,-22,792,151,47,,17780
264447,4000,Female,GM1640,Leudal,2021JJ00,2021,17780,,140,,213,,-73,963,,93,870,941,,112,-33,829,22,-52,,17728
264448,4000,Female,GM1640,Leudal,2022JJ00,2022,17728,,152,,237,,-85,1139,,255,884,946,,130,-10,816,193,108,,17836
264449,4000,Female,GM1640,Leudal,2023JJ00,2023,17836,,142,,228,,-86,887,,170,717,896,,126,-26,770,-9,-95,,17741
264520,4000,Female,GM0327,Leusden,2012JJ00,2012,14748,,117,,125,,-8,575,,39,536,532,,23,-3,509,43,36,,14784
264521,4000,Female,GM0327,Leusden,2013JJ00,2013,14784,,111,,109,,2,534,,48,486,575,,33,-2,542,-41,-38,,14746
264522,4000,Female,GM0327,Leusden,2014JJ00,2014,14746,,131,,111,,20,585,,54,531,552,,31,-4,521,33,53,,14799
264523,4000,Female,GM0327,Leusden,2015JJ00,2015,14799,,135,,124,,11,717,,51,666,629,,37,1,592,88,99,,14898
264524,4000,Female,GM0327,Leusden,2016JJ00,2016,14898,,141,,116,,25,837,,57,780,678,,40,1,638,159,185,,15083
264525,4000,Female,GM0327,Leusden,2017JJ00,2017,15083,,133,,118,,15,719,,45,674,681,,42,-4,639,38,53,,15136
264526,4000,Female,GM0327,Leusden,2018JJ00,2018,15136,,125,,129,,-4,840,,49,791,662,,54,-3,608,178,171,,15307
264527,4000,Female,GM0327,Leusden,2019JJ00,2019,15307,,144,,128,,16,793,,62,731,628,,32,2,596,165,180,,15487
264528,4000,Female,GM0327,Leusden,2020JJ00,2020,15487,,137,,119,,18,830,,49,781,751,,26,-3,725,79,93,,15580
264529,4000,Female,GM0327,Leusden,2021JJ00,2021,15580,,139,,152,,-13,820,,47,773,691,,32,-3,659,129,114,,15694
264530,4000,Female,GM0327,Leusden,2022JJ00,2022,15694,,143,,163,,-20,1156,,254,902,749,,77,-13,672,407,387,,16081
264531,4000,Female,GM0327,Leusden,2023JJ00,2023,16081,,160,,162,,-2,813,,93,720,731,,78,-26,653,82,81,,16162
265176,4000,Female,GM0694,Liesveld,2012JJ00,2012,4870,,56,,27,,29,150,,6,144,177,,13,0,164,-27,-3,,4867
265504,4000,Female,GM0733,Lingewaal,2012JJ00,2012,5457,,52,,39,,13,253,,14,239,198,,6,3,192,55,68,,5525
265505,4000,Female,GM0733,Lingewaal,2013JJ00,2013,5525,,62,,28,,34,202,,21,181,201,,5,2,196,1,35,,5560
265506,4000,Female,GM0733,Lingewaal,2014JJ00,2014,5560,,56,,29,,27,236,,21,215,239,,15,-4,224,-3,24,,5584
265507,4000,Female,GM0733,Lingewaal,2015JJ00,2015,5584,,43,,45,,-2,246,,29,217,243,,9,-1,234,3,1,,5585
265508,4000,Female,GM0733,Lingewaal,2016JJ00,2016,5585,,53,,39,,14,277,,22,255,289,,23,-2,266,-12,2,,5587
265509,4000,Female,GM0733,Lingewaal,2017JJ00,2017,5587,,63,,42,,21,292,,15,277,318,,16,0,302,-26,-5,,5582
265510,4000,Female,GM0733,Lingewaal,2018JJ00,2018,5582,,44,,36,,8,336,,23,313,292,,14,-1,278,44,51,,5633
265586,4000,Female,GM1705,Lingewaard,2012JJ00,2012,23066,,202,,196,,6,725,,65,660,712,,67,-6,645,13,16,,23082
265587,4000,Female,GM1705,Lingewaard,2013JJ00,2013,23082,,182,,173,,9,732,,68,664,781,,65,0,716,-49,-35,,23047
265588,4000,Female,GM1705,Lingewaard,2014JJ00,2014,23047,,193,,166,,27,761,,73,688,780,,61,0,719,-19,8,,23055
265589,4000,Female,GM1705,Lingewaard,2015JJ00,2015,23055,,200,,155,,45,872,,75,797,801,,64,-5,737,71,121,,23176
265590,4000,Female,GM1705,Lingewaard,2016JJ00,2016,23176,,169,,171,,-2,1030,,72,958,919,,59,-2,860,111,108,,23284
265591,4000,Female,GM1705,Lingewaard,2017JJ00,2017,23284,,183,,194,,-11,957,,72,885,868,,50,-3,818,89,79,,23363
265592,4000,Female,GM1705,Lingewaard,2018JJ00,2018,23363,,180,,204,,-24,942,,69,873,850,,62,-8,788,92,71,,23434
265593,4000,Female,GM1705,Lingewaard,2019JJ00,2019,23434,,197,,184,,13,960,,100,860,886,,45,-2,841,74,84,,23518
265594,4000,Female,GM1705,Lingewaard,2020JJ00,2020,23518,,195,,206,,-11,996,,58,938,888,,42,2,846,108,97,,23615
265595,4000,Female,GM1705,Lingewaard,2021JJ00,2021,23615,,182,,207,,-25,936,,59,877,845,,41,-2,804,91,66,,23681
265596,4000,Female,GM1705,Lingewaard,2022JJ00,2022,23681,,176,,231,,-55,1028,,149,879,842,,45,-6,797,186,131,,23812
265597,4000,Female,GM1705,Lingewaard,2023JJ00,2023,23812,,182,,207,,-25,912,,127,785,857,,96,-24,761,55,30,,23842
265832,4000,Female,GM0553,Lisse,2012JJ00,2012,11424,,93,,85,,8,396,,79,317,480,,79,0,401,-84,-76,,11348
265833,4000,Female,GM0553,Lisse,2013JJ00,2013,11348,,88,,95,,-7,400,,64,336,413,,63,0,350,-13,-19,,11329
265834,4000,Female,GM0553,Lisse,2014JJ00,2014,11329,,90,,91,,-1,504,,64,440,372,,57,-1,315,132,131,,11460
265835,4000,Female,GM0553,Lisse,2015JJ00,2015,11460,,98,,92,,6,521,,64,457,487,,71,0,416,34,39,,11499
265836,4000,Female,GM0553,Lisse,2016JJ00,2016,11499,,110,,100,,10,528,,58,470,497,,45,-6,452,31,40,,11539
265837,4000,Female,GM0553,Lisse,2017JJ00,2017,11539,,112,,98,,14,557,,50,507,557,,42,3,515,0,15,,11554
265838,4000,Female,GM0553,Lisse,2018JJ00,2018,11554,,107,,105,,2,547,,72,475,518,,46,-3,472,29,31,,11585
265839,4000,Female,GM0553,Lisse,2019JJ00,2019,11585,,97,,97,,0,611,,75,536,539,,48,-9,491,72,70,,11655
265840,4000,Female,GM0553,Lisse,2020JJ00,2020,11655,,114,,120,,-6,536,,52,484,528,,44,-5,484,8,3,,11658
265841,4000,Female,GM0553,Lisse,2021JJ00,2021,11658,,122,,117,,5,498,,63,435,506,,46,-2,460,-8,-3,,11655
265842,4000,Female,GM0553,Lisse,2022JJ00,2022,11655,,92,,101,,-9,747,,186,561,511,,59,-4,452,236,226,,11881
265843,4000,Female,GM0553,Lisse,2023JJ00,2023,11881,,104,,115,,-11,648,,123,525,583,,93,-19,490,65,54,,11935
266078,4000,Female,GM0140,Littenseradiel,2012JJ00,2012,5382,,46,,30,,16,199,,8,191,215,,17,-1,198,-16,0,,5382
266079,4000,Female,GM0140,Littenseradiel,2013JJ00,2013,5382,,49,,37,,12,183,,6,177,223,,8,0,215,-40,-29,,5353
266080,4000,Female,GM0140,Littenseradiel,2014JJ00,2014,5353,,47,,38,,9,217,,4,213,243,,11,0,232,-26,-16,,5337
266081,4000,Female,GM0140,Littenseradiel,2015JJ00,2015,5337,,52,,35,,17,220,,7,213,254,,11,0,243,-34,-15,,5322
266082,4000,Female,GM0140,Littenseradiel,2016JJ00,2016,5322,,42,,39,,3,227,,13,214,301,,8,-1,293,-74,-71,,5251
266083,4000,Female,GM0140,Littenseradiel,2017JJ00,2017,5251,,42,,35,,7,255,,15,240,289,,5,1,284,-34,-32,,5219
266160,4000,Female,GM0262,Lochem,2012JJ00,2012,16943,,129,,194,,-65,767,,51,716,680,,38,0,642,87,23,,16966
266161,4000,Female,GM0262,Lochem,2013JJ00,2013,16966,,107,,197,,-90,742,,68,674,691,,67,-11,624,51,-39,,16927
266162,4000,Female,GM0262,Lochem,2014JJ00,2014,16927,,125,,196,,-71,760,,47,713,702,,46,-4,656,58,-13,,16914
266163,4000,Female,GM0262,Lochem,2015JJ00,2015,16914,,115,,218,,-103,845,,77,768,757,,40,1,717,88,-14,,16900
266164,4000,Female,GM0262,Lochem,2016JJ00,2016,16900,,110,,198,,-88,924,,76,848,761,,50,-1,711,163,76,,16976
266165,4000,Female,GM0262,Lochem,2017JJ00,2017,16976,,108,,206,,-98,929,,40,889,767,,19,4,748,162,63,,17039
266166,4000,Female,GM0262,Lochem,2018JJ00,2018,17039,,108,,208,,-100,911,,59,852,830,,55,-7,775,81,-17,,17022
266167,4000,Female,GM0262,Lochem,2019JJ00,2019,17022,,117,,191,,-74,885,,85,800,755,,42,-2,713,130,56,,17078
266168,4000,Female,GM0262,Lochem,2020JJ00,2020,17078,,97,,226,,-129,948,,58,890,720,,42,-7,678,228,97,,17175
266169,4000,Female,GM0262,Lochem,2021JJ00,2021,17175,,117,,237,,-120,883,,47,836,725,,36,-3,689,158,38,,17213
266170,4000,Female,GM0262,Lochem,2022JJ00,2022,17213,,92,,240,,-148,1124,,265,859,816,,97,-9,719,308,158,,17371
266171,4000,Female,GM0262,Lochem,2023JJ00,2023,17371,,109,,228,,-119,927,,85,842,841,,83,-12,758,86,-33,,17338
266406,4000,Female,GM0809,Loon op Zand,2012JJ00,2012,11647,,101,,118,,-17,502,,48,454,478,,30,-9,448,24,6,,11653
266407,4000,Female,GM0809,Loon op Zand,2013JJ00,2013,11653,,91,,107,,-16,490,,44,446,468,,29,-4,439,22,6,,11659
266408,4000,Female,GM0809,Loon op Zand,2014JJ00,2014,11659,,94,,129,,-35,453,,45,408,494,,27,-5,467,-41,-77,,11582
266409,4000,Female,GM0809,Loon op Zand,2015JJ00,2015,11582,,94,,104,,-10,561,,51,510,549,,51,-21,498,12,2,,11584
266410,4000,Female,GM0809,Loon op Zand,2016JJ00,2016,11584,,118,,112,,6,631,,59,572,590,,38,-8,552,41,48,,11632
266411,4000,Female,GM0809,Loon op Zand,2017JJ00,2017,11632,,100,,141,,-41,669,,65,604,606,,38,-6,568,63,19,,11651
266412,4000,Female,GM0809,Loon op Zand,2018JJ00,2018,11651,,109,,132,,-23,678,,75,603,573,,51,-1,522,105,80,,11731
266413,4000,Female,GM0809,Loon op Zand,2019JJ00,2019,11731,,99,,115,,-16,623,,70,553,560,,44,-9,516,63,48,,11779
266414,4000,Female,GM0809,Loon op Zand,2020JJ00,2020,11779,,102,,135,,-33,690,,65,625,582,,46,-7,536,108,75,,11854
266415,4000,Female,GM0809,Loon op Zand,2021JJ00,2021,11854,,132,,133,,-1,686,,46,640,535,,40,-4,495,151,149,,12003
266416,4000,Female,GM0809,Loon op Zand,2022JJ00,2022,12003,,110,,147,,-37,639,,103,536,569,,79,-7,490,70,33,,12036
266417,4000,Female,GM0809,Loon op Zand,2023JJ00,2023,12036,,91,,141,,-50,603,,118,485,539,,54,-3,485,64,14,,12050
266570,4000,Female,GM0331,Lopik,2012JJ00,2012,6895,,61,,29,,32,235,,8,227,288,,17,-4,271,-53,-21,,6874
266571,4000,Female,GM0331,Lopik,2013JJ00,2013,6874,,61,,32,,29,276,,23,253,292,,18,-4,274,-16,14,,6888
266572,4000,Female,GM0331,Lopik,2014JJ00,2014,6888,,67,,31,,36,272,,16,256,267,,9,-1,258,5,41,,6929
266573,4000,Female,GM0331,Lopik,2015JJ00,2015,6929,,58,,35,,23,340,,30,310,326,,18,-2,308,14,38,,6967
266574,4000,Female,GM0331,Lopik,2016JJ00,2016,6967,,60,,28,,32,330,,14,316,316,,15,-1,301,14,47,,7014
266575,4000,Female,GM0331,Lopik,2017JJ00,2017,7014,,71,,50,,21,394,,18,376,338,,14,-3,324,56,78,,7092
266576,4000,Female,GM0331,Lopik,2018JJ00,2018,7092,,82,,43,,39,333,,22,311,328,,14,-3,314,5,45,,7137
266577,4000,Female,GM0331,Lopik,2019JJ00,2019,7137,,73,,39,,34,262,,21,241,346,,23,-5,323,-84,-50,,7087
266578,4000,Female,GM0331,Lopik,2020JJ00,2020,7087,,79,,43,,36,286,,23,263,329,,8,-2,321,-43,-10,,7077
266579,4000,Female,GM0331,Lopik,2021JJ00,2021,7077,,70,,47,,23,355,,18,337,354,,10,0,344,1,24,,7101
266580,4000,Female,GM0331,Lopik,2022JJ00,2022,7101,,71,,44,,27,372,,82,290,305,,30,0,275,67,93,,7194
266581,4000,Female,GM0331,Lopik,2023JJ00,2023,7194,,65,,39,,26,317,,32,285,344,,42,-8,302,-27,-2,,7192
266652,4000,Female,GM0024,Loppersum,2012JJ00,2012,5082,,46,,45,,1,239,,8,231,238,,10,0,228,1,2,,5084
266653,4000,Female,GM0024,Loppersum,2013JJ00,2013,5084,,48,,52,,-4,215,,7,208,256,,15,-3,241,-41,-45,,5039
266654,4000,Female,GM0024,Loppersum,2014JJ00,2014,5039,,55,,41,,14,232,,7,225,255,,12,-1,243,-23,-9,,5030
266655,4000,Female,GM0024,Loppersum,2015JJ00,2015,5030,,44,,52,,-8,223,,25,198,283,,11,0,272,-60,-68,,4962
266656,4000,Female,GM0024,Loppersum,2016JJ00,2016,4962,,37,,51,,-14,239,,12,227,294,,7,2,287,-55,-69,,4893
266657,4000,Female,GM0024,Loppersum,2017JJ00,2017,4893,,33,,47,,-14,214,,10,204,300,,11,0,289,-86,-100,,4793
266658,4000,Female,GM0024,Loppersum,2018JJ00,2018,4793,,37,,50,,-13,269,,6,263,316,,12,0,304,-47,-60,,4733
266659,4000,Female,GM0024,Loppersum,2019JJ00,2019,4733,,44,,40,,4,269,,15,254,300,,11,1,289,-31,-26,,4707
266660,4000,Female,GM0024,Loppersum,2020JJ00,2020,4707,,37,,33,,4,219,,18,201,264,,12,0,252,-45,-40,,4667
266734,4000,Female,GM0168,Losser,2012JJ00,2012,11278,,95,,117,,-22,420,,57,363,449,,41,-4,408,-29,-53,,11225
266735,4000,Female,GM0168,Losser,2013JJ00,2013,11225,,104,,124,,-20,430,,45,385,368,,39,1,329,62,43,,11268
266736,4000,Female,GM0168,Losser,2014JJ00,2014,11268,,86,,119,,-33,392,,51,341,455,,42,-6,413,-63,-96,,11172
266737,4000,Female,GM0168,Losser,2015JJ00,2015,11172,,86,,122,,-36,462,,59,403,414,,46,2,368,48,12,,11184
266738,4000,Female,GM0168,Losser,2016JJ00,2016,11184,,91,,97,,-6,401,,38,363,408,,44,-6,364,-7,-14,,11170
266739,4000,Female,GM0168,Losser,2017JJ00,2017,11170,,95,,103,,-8,495,,48,447,478,,37,0,441,17,11,,11181
266740,4000,Female,GM0168,Losser,2018JJ00,2018,11181,,75,,94,,-19,468,,42,426,424,,31,-2,393,44,25,,11206
266741,4000,Female,GM0168,Losser,2019JJ00,2019,11206,,111,,101,,10,498,,57,441,434,,38,-7,396,64,74,,11280
266742,4000,Female,GM0168,Losser,2020JJ00,2020,11280,,84,,127,,-43,541,,55,486,403,,24,-4,379,138,95,,11375
266743,4000,Female,GM0168,Losser,2021JJ00,2021,11375,,103,,131,,-28,486,,44,442,408,,35,-5,373,78,48,,11423
266744,4000,Female,GM0168,Losser,2022JJ00,2022,11423,,114,,98,,16,555,,115,440,424,,59,-4,365,131,146,,11569
266745,4000,Female,GM0168,Losser,2023JJ00,2023,11569,,92,,120,,-28,455,,100,355,458,,58,-24,400,-3,-32,,11537
267554,4000,Female,GM1671,Maasdonk,2012JJ00,2012,5615,,52,,52,,0,205,,26,179,224,,4,3,220,-19,-18,,5597
267555,4000,Female,GM1671,Maasdonk,2013JJ00,2013,5597,,42,,54,,-12,242,,20,222,248,,23,-7,225,-6,-18,,5579
267556,4000,Female,GM1671,Maasdonk,2014JJ00,2014,5579,,56,,49,,7,263,,16,247,217,,15,-5,202,46,37,,5616
267636,4000,Female,GM0263,Maasdriel,2012JJ00,2012,11902,,118,,109,,9,434,,99,335,414,,54,-9,360,20,27,,11929
267637,4000,Female,GM0263,Maasdriel,2013JJ00,2013,11929,,121,,91,,30,434,,110,324,450,,32,5,418,-16,15,,11944
267638,4000,Female,GM0263,Maasdriel,2014JJ00,2014,11944,,109,,90,,19,464,,114,350,465,,63,-4,402,-1,20,,11964
267639,4000,Female,GM0263,Maasdriel,2015JJ00,2015,11964,,115,,119,,-4,456,,82,374,508,,49,0,459,-52,-56,,11908
267640,4000,Female,GM0263,Maasdriel,2016JJ00,2016,11908,,116,,105,,11,492,,80,412,461,,39,0,422,31,42,,11950
267641,4000,Female,GM0263,Maasdriel,2017JJ00,2017,11950,,127,,121,,6,624,,85,539,575,,48,-3,527,49,54,,12004
267642,4000,Female,GM0263,Maasdriel,2018JJ00,2018,12004,,110,,110,,0,680,,159,521,528,,56,-4,472,152,152,,12156
267643,4000,Female,GM0263,Maasdriel,2019JJ00,2019,12156,,91,,114,,-23,748,,246,502,586,,93,-21,493,162,141,,12297
267644,4000,Female,GM0263,Maasdriel,2020JJ00,2020,12297,,109,,119,,-10,906,,401,505,687,,176,-40,511,219,208,,12505
267645,4000,Female,GM0263,Maasdriel,2021JJ00,2021,12505,,107,,119,,-12,740,,233,507,761,,246,-35,515,-21,-33,,12472
267646,4000,Female,GM0263,Maasdriel,2022JJ00,2022,12472,,106,,125,,-19,962,,481,481,704,,246,-65,458,258,240,,12712
267647,4000,Female,GM0263,Maasdriel,2023JJ00,2023,12712,,96,,127,,-31,816,,271,545,737,,207,-54,530,79,45,,12757
267718,4000,Female,GM1641,Maasgouw,2012JJ00,2012,12058,,71,,138,,-67,483,,63,420,496,,42,-3,454,-13,-80,,11978
267719,4000,Female,GM1641,Maasgouw,2013JJ00,2013,11978,,98,,107,,-9,458,,55,403,507,,53,-5,454,-49,-58,,11920
267720,4000,Female,GM1641,Maasgouw,2014JJ00,2014,11920,,70,,114,,-44,475,,60,415,480,,57,-9,423,-5,-49,,11871
267721,4000,Female,GM1641,Maasgouw,2015JJ00,2015,11871,,91,,121,,-30,466,,51,415,479,,48,-7,431,-13,-44,,11827
267722,4000,Female,GM1641,Maasgouw,2016JJ00,2016,11827,,82,,125,,-43,559,,58,501,513,,39,-4,474,46,2,,11829
267723,4000,Female,GM1641,Maasgouw,2017JJ00,2017,11829,,76,,131,,-55,634,,73,561,630,,55,-2,575,4,-52,,11777
267724,4000,Female,GM1641,Maasgouw,2018JJ00,2018,11777,,91,,139,,-48,631,,79,552,597,,49,-4,548,34,-14,,11763
267725,4000,Female,GM1641,Maasgouw,2019JJ00,2019,11763,,73,,134,,-61,725,,104,621,564,,46,-3,518,161,98,,11861
267726,4000,Female,GM1641,Maasgouw,2020JJ00,2020,11861,,86,,164,,-78,660,,74,586,565,,45,-2,520,95,17,,11878
267727,4000,Female,GM1641,Maasgouw,2021JJ00,2021,11878,,93,,175,,-82,632,,72,560,497,,49,-2,448,135,54,,11932
267728,4000,Female,GM1641,Maasgouw,2022JJ00,2022,11932,,72,,165,,-93,839,,161,678,580,,81,-9,499,259,165,,12097
267729,4000,Female,GM1641,Maasgouw,2023JJ00,2023,12097,,104,,165,,-61,737,,153,584,616,,67,-10,549,121,59,,12156
267892,4000,Female,GM1991,Maashorst,2022JJ00,2022,29161,,271,,288,,-17,1406,,501,905,1045,,196,-34,849,361,345,,29506
267893,4000,Female,GM1991,Maashorst,2023JJ00,2023,29506,,260,,338,,-78,1293,,280,1013,1125,,192,-25,933,168,90,,29596
268128,4000,Female,GM0556,Maassluis,2012JJ00,2012,16246,,140,,142,,-2,654,,101,553,611,,96,-5,515,43,42,,16288
268129,4000,Female,GM0556,Maassluis,2013JJ00,2013,16288,,144,,142,,2,745,,138,607,669,,88,-3,581,76,81,,16369
268130,4000,Female,GM0556,Maassluis,2014JJ00,2014,16369,,157,,151,,6,743,,132,611,684,,111,-14,573,59,70,,16439
268131,4000,Female,GM0556,Maassluis,2015JJ00,2015,16439,,158,,151,,7,683,,105,578,668,,113,-13,555,15,24,,16463
268132,4000,Female,GM0556,Maassluis,2016JJ00,2016,16463,,164,,182,,-18,726,,107,619,639,,83,0,556,87,70,,16533
268133,4000,Female,GM0556,Maassluis,2017JJ00,2017,16533,,171,,190,,-19,743,,90,653,719,,62,7,657,24,4,,16537
268134,4000,Female,GM0556,Maassluis,2018JJ00,2018,16537,,155,,178,,-23,827,,135,692,652,,94,-4,558,175,154,,16691
268135,4000,Female,GM0556,Maassluis,2019JJ00,2019,16691,,169,,169,,0,924,,162,762,697,,102,-9,595,227,228,,16919
268136,4000,Female,GM0556,Maassluis,2020JJ00,2020,16919,,173,,175,,-2,872,,105,767,701,,90,-8,611,171,169,,17088
268137,4000,Female,GM0556,Maassluis,2021JJ00,2021,17088,,182,,171,,11,994,,91,903,731,,93,-16,638,263,274,,17362
268138,4000,Female,GM0556,Maassluis,2022JJ00,2022,17362,,185,,145,,40,1247,,189,1058,664,,100,-11,564,583,623,,17985
268139,4000,Female,GM0556,Maassluis,2023JJ00,2023,17985,,174,,153,,21,1015,,161,854,714,,143,-35,571,301,325,,18310
268210,4000,Female,GM0935,Maastricht,2012JJ00,2012,62819,,482,,670,,-188,5138,,2393,2745,4509,,1565,-172,2944,629,436,,63255
268211,4000,Female,GM0935,Maastricht,2013JJ00,2013,63255,,447,,626,,-179,5369,,2433,2936,4808,,1907,-97,2901,561,379,,63634
268212,4000,Female,GM0935,Maastricht,2014JJ00,2014,63634,,424,,658,,-234,5376,,2435,2941,5169,,2175,-85,2994,207,-36,,63598
268213,4000,Female,GM0935,Maastricht,2015JJ00,2015,63598,,454,,677,,-223,5886,,3151,2735,5632,,2338,-107,3294,254,26,,63624
268214,4000,Female,GM0935,Maastricht,2016JJ00,2016,63624,,438,,649,,-211,5931,,3032,2899,5537,,2170,-35,3367,394,174,,63798
268215,4000,Female,GM0935,Maastricht,2017JJ00,2017,63798,,396,,685,,-289,6365,,3370,2995,5918,,2392,-22,3526,447,158,,63956
268216,4000,Female,GM0935,Maastricht,2018JJ00,2018,63956,,379,,629,,-250,6055,,3323,2732,6414,,3064,-22,3350,-359,-610,,63346
268217,4000,Female,GM0935,Maastricht,2019JJ00,2019,63346,,403,,693,,-290,6601,,3799,2802,6195,,2823,-7,3372,406,109,,63455
268218,4000,Female,GM0935,Maastricht,2020JJ00,2020,63455,,410,,761,,-351,6540,,3352,3188,7055,,3561,-9,3494,-515,-877,,62578
268219,4000,Female,GM0935,Maastricht,2021JJ00,2021,62578,,383,,710,,-327,7204,,3921,3283,6243,,2748,0,3495,961,630,,63208
268220,4000,Female,GM0935,Maastricht,2022JJ00,2022,63208,,379,,666,,-287,7656,,4509,3147,6497,,3090,-1,3407,1159,864,,64072
268221,4000,Female,GM0935,Maastricht,2023JJ00,2023,64072,,391,,668,,-277,8124,,4318,3806,6314,,2960,12,3354,1810,1529,,65601
268784,4000,Female,GM1663,De Marne,2012JJ00,2012,5123,,49,,49,,0,170,,24,146,216,,15,-3,201,-46,-46,,5077
268785,4000,Female,GM1663,De Marne,2013JJ00,2013,5077,,48,,43,,5,185,,15,170,241,,14,-4,227,-56,-51,,5026
268786,4000,Female,GM1663,De Marne,2014JJ00,2014,5026,,48,,42,,6,207,,16,191,230,,13,-4,217,-23,-17,,5009
268787,4000,Female,GM1663,De Marne,2015JJ00,2015,5009,,40,,54,,-14,231,,14,217,226,,26,-5,200,5,-8,,5001
268788,4000,Female,GM1663,De Marne,2016JJ00,2016,5001,,58,,51,,7,210,,14,196,232,,14,-2,218,-22,-13,,4988
268789,4000,Female,GM1663,De Marne,2017JJ00,2017,4988,,32,,38,,-6,232,,12,220,235,,6,1,229,-3,-10,,4978
268790,4000,Female,GM1663,De Marne,2018JJ00,2018,4978,,47,,45,,2,243,,17,226,259,,9,0,250,-16,-16,,4962
268866,4000,Female,GM0025,Marum,2012JJ00,2012,5074,,47,,37,,10,202,,17,185,213,,7,1,206,-11,-1,,5073
268867,4000,Female,GM0025,Marum,2013JJ00,2013,5073,,55,,35,,20,211,,20,191,236,,22,-10,214,-25,-5,,5068
268868,4000,Female,GM0025,Marum,2014JJ00,2014,5068,,37,,34,,3,202,,9,193,278,,16,0,262,-76,-73,,4995
268869,4000,Female,GM0025,Marum,2015JJ00,2015,4995,,41,,32,,9,227,,13,214,232,,10,2,222,-5,6,,5001
268870,4000,Female,GM0025,Marum,2016JJ00,2016,5001,,44,,40,,4,302,,13,289,284,,7,0,277,18,23,,5024
268871,4000,Female,GM0025,Marum,2017JJ00,2017,5024,,36,,40,,-4,326,,13,313,276,,10,1,266,50,44,,5068
268872,4000,Female,GM0025,Marum,2018JJ00,2018,5068,,55,,52,,3,297,,18,279,309,,14,-1,295,-12,-9,,5059
269030,4000,Female,GM0420,Medemblik,2012JJ00,2012,21201,,196,,154,,42,753,,109,644,784,,80,-6,704,-31,14,,21215
269031,4000,Female,GM0420,Medemblik,2013JJ00,2013,21215,,218,,157,,61,822,,156,666,804,,70,-1,734,18,78,,21293
269032,4000,Female,GM0420,Medemblik,2014JJ00,2014,21293,,184,,184,,0,904,,143,761,810,,102,3,708,94,94,,21387
269033,4000,Female,GM0420,Medemblik,2015JJ00,2015,21387,,196,,201,,-5,1010,,179,831,913,,101,0,812,97,89,,21476
269034,4000,Female,GM0420,Medemblik,2016JJ00,2016,21476,,197,,175,,22,1021,,135,886,888,,97,-1,791,133,155,,21631
269035,4000,Female,GM0420,Medemblik,2017JJ00,2017,21631,,216,,217,,-1,1194,,165,1029,988,,101,4,887,206,205,,21836
269036,4000,Female,GM0420,Medemblik,2018JJ00,2018,21836,,226,,174,,52,1136,,148,988,995,,97,-7,898,141,195,,22031
269037,4000,Female,GM0420,Medemblik,2019JJ00,2019,22031,,178,,202,,-24,1035,,193,842,901,,109,2,792,134,108,,22139
269038,4000,Female,GM0420,Medemblik,2020JJ00,2020,22139,,189,,204,,-15,1163,,193,970,1096,,120,-23,976,67,47,,22186
269039,4000,Female,GM0420,Medemblik,2021JJ00,2021,22186,,225,,235,,-10,1161,,226,935,982,,141,-13,841,179,168,,22354
269040,4000,Female,GM0420,Medemblik,2022JJ00,2022,22354,,192,,225,,-33,1512,,553,959,1141,,256,-39,885,371,340,,22694
269041,4000,Female,GM0420,Medemblik,2023JJ00,2023,22694,,179,,211,,-32,1203,,270,933,1176,,231,-63,945,27,-6,,22688
269440,4000,Female,GM0938,Meerssen,2012JJ00,2012,9877,,46,,101,,-55,358,,50,308,368,,41,-3,327,-10,-65,,9812
269441,4000,Female,GM0938,Meerssen,2013JJ00,2013,9812,,59,,72,,-13,392,,57,335,418,,58,-1,360,-26,-39,,9773
269442,4000,Female,GM0938,Meerssen,2014JJ00,2014,9773,,56,,98,,-42,368,,31,337,464,,42,0,422,-96,-137,,9636
269443,4000,Female,GM0938,Meerssen,2015JJ00,2015,9636,,72,,90,,-18,425,,50,375,410,,48,-4,362,15,-3,,9633
269444,4000,Female,GM0938,Meerssen,2016JJ00,2016,9633,,77,,86,,-9,479,,50,429,429,,42,0,387,50,41,,9674
269445,4000,Female,GM0938,Meerssen,2017JJ00,2017,9674,,57,,104,,-47,484,,47,437,443,,41,-4,402,41,-5,,9669
269446,4000,Female,GM0938,Meerssen,2018JJ00,2018,9669,,61,,115,,-54,463,,65,398,470,,45,1,425,-7,-60,,9609
269447,4000,Female,GM0938,Meerssen,2019JJ00,2019,9609,,59,,112,,-53,469,,57,412,464,,51,-7,413,5,-47,,9562
269448,4000,Female,GM0938,Meerssen,2020JJ00,2020,9562,,69,,142,,-73,477,,41,436,479,,38,-1,441,-2,-75,,9487
269449,4000,Female,GM0938,Meerssen,2021JJ00,2021,9487,,62,,122,,-60,453,,57,396,449,,49,-1,400,4,-57,,9430
269450,4000,Female,GM0938,Meerssen,2022JJ00,2022,9430,,58,,123,,-65,537,,111,426,457,,64,-1,393,80,14,,9444
269451,4000,Female,GM0938,Meerssen,2023JJ00,2023,9444,,66,,121,,-55,488,,73,415,453,,50,0,403,35,-15,,9429
269609,4000,Female,GM1948,Meierijstad,2017JJ00,2017,39817,,348,,373,,-25,1613,,246,1367,1512,,231,-36,1281,101,79,,39896
269610,4000,Female,GM1948,Meierijstad,2018JJ00,2018,39896,,376,,339,,37,1701,,280,1421,1392,,189,-8,1203,309,346,,40242
269611,4000,Female,GM1948,Meierijstad,2019JJ00,2019,40242,,368,,348,,20,1564,,307,1257,1449,,190,-9,1259,115,130,,40372
269612,4000,Female,GM1948,Meierijstad,2020JJ00,2020,40372,,408,,447,,-39,1657,,264,1393,1469,,158,-9,1311,188,147,,40519
269613,4000,Female,GM1948,Meierijstad,2021JJ00,2021,40519,,390,,350,,40,1726,,245,1481,1348,,148,-14,1200,378,419,,40938
269614,4000,Female,GM1948,Meierijstad,2022JJ00,2022,40938,,386,,384,,2,1968,,659,1309,1391,,295,-47,1096,577,583,,41521
269615,4000,Female,GM1948,Meierijstad,2023JJ00,2023,41521,,383,,420,,-37,1807,,387,1420,1539,,251,-36,1288,268,227,,41748
270096,4000,Female,GM1908,Menameradiel,2012JJ00,2012,6765,,55,,63,,-8,225,,21,204,267,,11,2,256,-42,-51,,6714
270097,4000,Female,GM1908,Menameradiel,2013JJ00,2013,6714,,71,,49,,22,235,,18,217,283,,13,1,270,-48,-26,,6688
270098,4000,Female,GM1908,Menameradiel,2014JJ00,2014,6688,,69,,40,,29,246,,22,224,310,,14,0,296,-64,-36,,6652
270099,4000,Female,GM1908,Menameradiel,2015JJ00,2015,6652,,52,,54,,-2,260,,21,239,305,,15,0,290,-45,-47,,6605
270100,4000,Female,GM1908,Menameradiel,2016JJ00,2016,6605,,49,,59,,-10,317,,23,294,356,,27,-4,329,-39,-50,,6555
270101,4000,Female,GM1908,Menameradiel,2017JJ00,2017,6555,,72,,47,,25,331,,10,321,356,,16,-1,340,-25,0,,6555
270178,4000,Female,GM1987,Menterwolde,2012JJ00,2012,6062,,45,,50,,-5,267,,16,251,233,,5,2,228,34,27,,6089
270179,4000,Female,GM1987,Menterwolde,2013JJ00,2013,6089,,47,,58,,-11,214,,14,200,256,,3,2,253,-42,-53,,6036
270180,4000,Female,GM1987,Menterwolde,2014JJ00,2014,6036,,45,,46,,-1,264,,14,250,279,,15,0,264,-15,-15,,6021
270181,4000,Female,GM1987,Menterwolde,2015JJ00,2015,6021,,43,,49,,-6,332,,17,315,306,,10,2,296,26,19,,6040
270182,4000,Female,GM1987,Menterwolde,2016JJ00,2016,6040,,35,,64,,-29,302,,8,294,332,,13,-1,319,-30,-59,,5981
270183,4000,Female,GM1987,Menterwolde,2017JJ00,2017,5981,,45,,51,,-6,331,,12,319,406,,18,-5,388,-75,-83,,5898
270260,4000,Female,GM0119,Meppel,2012JJ00,2012,16654,,148,,166,,-18,704,,65,639,633,,43,8,590,71,52,,16706
270261,4000,Female,GM0119,Meppel,2013JJ00,2013,16706,,175,,154,,21,642,,68,574,579,,37,3,542,63,84,,16790
270262,4000,Female,GM0119,Meppel,2014JJ00,2014,16790,,165,,165,,0,623,,65,558,660,,74,-14,586,-37,-37,,16753
270263,4000,Female,GM0119,Meppel,2015JJ00,2015,16753,,171,,161,,10,701,,77,624,709,,60,-6,649,-8,1,,16754
270264,4000,Female,GM0119,Meppel,2016JJ00,2016,16754,,145,,168,,-23,915,,77,838,757,,49,1,708,158,134,,16888
270265,4000,Female,GM0119,Meppel,2017JJ00,2017,16888,,145,,181,,-36,1051,,97,954,782,,52,0,730,269,235,,17123
270266,4000,Female,GM0119,Meppel,2018JJ00,2018,17123,,142,,176,,-34,917,,125,792,818,,110,-16,708,99,65,,17188
270267,4000,Female,GM0119,Meppel,2019JJ00,2019,17188,,147,,198,,-51,992,,143,849,780,,73,-5,707,212,159,,17347
270268,4000,Female,GM0119,Meppel,2020JJ00,2020,17347,,148,,168,,-20,1036,,110,926,776,,62,-2,714,260,239,,17586
270269,4000,Female,GM0119,Meppel,2021JJ00,2021,17586,,175,,188,,-13,1021,,153,868,790,,81,-11,709,231,217,,17803
270270,4000,Female,GM0119,Meppel,2022JJ00,2022,17803,,152,,189,,-37,1199,,357,842,797,,135,-33,662,402,366,,18169
270271,4000,Female,GM0119,Meppel,2023JJ00,2023,18169,,168,,186,,-18,1056,,217,839,931,,179,-43,752,125,107,,18276
270588,4000,Female,GM0687,Middelburg (Z.),2012JJ00,2012,24526,,250,,217,,33,1043,,113,930,1121,,157,-48,964,-78,-47,,24479
270589,4000,Female,GM0687,Middelburg (Z.),2013JJ00,2013,24479,,219,,211,,8,1106,,127,979,1100,,113,-12,987,6,16,,24495
270590,4000,Female,GM0687,Middelburg (Z.),2014JJ00,2014,24495,,247,,205,,42,1103,,167,936,1133,,132,-31,1001,-30,14,,24509
270591,4000,Female,GM0687,Middelburg (Z.),2015JJ00,2015,24509,,230,,201,,29,1284,,228,1056,1194,,125,-15,1069,90,119,,24628
270592,4000,Female,GM0687,Middelburg (Z.),2016JJ00,2016,24628,,232,,222,,10,1415,,281,1134,1371,,135,-18,1236,44,60,,24688
270593,4000,Female,GM0687,Middelburg (Z.),2017JJ00,2017,24688,,199,,225,,-26,1486,,206,1280,1348,,144,-24,1204,138,109,,24797
270594,4000,Female,GM0687,Middelburg (Z.),2018JJ00,2018,24797,,212,,235,,-23,1573,,246,1327,1344,,143,-18,1201,229,208,,25005
270595,4000,Female,GM0687,Middelburg (Z.),2019JJ00,2019,25005,,242,,238,,4,1379,,246,1133,1268,,163,-18,1105,111,117,,25122
270596,4000,Female,GM0687,Middelburg (Z.),2020JJ00,2020,25122,,235,,229,,6,1379,,214,1165,1338,,151,-20,1187,41,46,,25168
270597,4000,Female,GM0687,Middelburg (Z.),2021JJ00,2021,25168,,222,,290,,-68,1458,,291,1167,1311,,156,-20,1155,147,76,,25244
270598,4000,Female,GM0687,Middelburg (Z.),2022JJ00,2022,25244,,219,,252,,-33,1762,,554,1208,1283,,200,-15,1083,479,441,,25685
270599,4000,Female,GM0687,Middelburg (Z.),2023JJ00,2023,25685,,202,,249,,-47,1598,,378,1220,1611,,273,-29,1338,-13,-63,,25622
270670,4000,Female,GM0559,Middelharnis,2012JJ00,2012,9194,,98,,103,,-5,307,,29,278,278,,20,-1,258,29,22,,9216
270916,4000,Female,GM1842,Midden-Delfland,2012JJ00,2012,8990,,96,,56,,40,362,,40,322,364,,33,2,331,-2,39,,9029
270917,4000,Female,GM1842,Midden-Delfland,2013JJ00,2013,9029,,85,,42,,43,399,,31,368,349,,21,-3,328,50,94,,9123
270918,4000,Female,GM1842,Midden-Delfland,2014JJ00,2014,9123,,80,,62,,18,491,,34,457,383,,27,-3,356,108,125,,9248
270919,4000,Female,GM1842,Midden-Delfland,2015JJ00,2015,9248,,87,,77,,10,485,,37,448,386,,42,-3,344,99,107,,9355
270920,4000,Female,GM1842,Midden-Delfland,2016JJ00,2016,9355,,89,,61,,28,494,,28,466,417,,32,-3,385,77,106,,9461
270921,4000,Female,GM1842,Midden-Delfland,2017JJ00,2017,9461,,78,,64,,14,605,,31,574,440,,33,-4,407,165,180,,9641
270922,4000,Female,GM1842,Midden-Delfland,2018JJ00,2018,9641,,92,,63,,29,445,,37,408,441,,29,-8,412,4,33,,9674
270923,4000,Female,GM1842,Midden-Delfland,2019JJ00,2019,9674,,90,,73,,17,427,,31,396,438,,33,-2,405,-11,7,,9681
270924,4000,Female,GM1842,Midden-Delfland,2020JJ00,2020,9681,,93,,81,,12,522,,29,493,503,,15,1,488,19,30,,9711
270925,4000,Female,GM1842,Midden-Delfland,2021JJ00,2021,9711,,87,,79,,8,449,,34,415,445,,23,0,422,4,11,,9722
270926,4000,Female,GM1842,Midden-Delfland,2022JJ00,2022,9722,,65,,88,,-23,453,,55,398,430,,29,0,401,23,0,,9722
270927,4000,Female,GM1842,Midden-Delfland,2023JJ00,2023,9722,,79,,83,,-4,391,,44,347,446,,35,1,411,-55,-59,,9663
270998,4000,Female,GM1731,Midden-Drenthe,2012JJ00,2012,16819,,152,,149,,3,574,,36,538,642,,22,9,620,-68,-65,,16754
270999,4000,Female,GM1731,Midden-Drenthe,2013JJ00,2013,16754,,124,,179,,-55,633,,38,595,616,,27,2,589,17,-38,,16716
271000,4000,Female,GM1731,Midden-Drenthe,2014JJ00,2014,16716,,133,,156,,-23,605,,39,566,626,,25,5,601,-21,-42,,16674
271001,4000,Female,GM1731,Midden-Drenthe,2015JJ00,2015,16674,,112,,164,,-52,1100,,346,754,961,,39,3,922,139,88,,16762
271002,4000,Female,GM1731,Midden-Drenthe,2016JJ00,2016,16762,,128,,169,,-41,1116,,281,835,1128,,44,-1,1084,-12,-45,,16717
271003,4000,Female,GM1731,Midden-Drenthe,2017JJ00,2017,16717,,145,,161,,-16,901,,73,828,975,,64,-18,911,-74,-89,,16628
271004,4000,Female,GM1731,Midden-Drenthe,2018JJ00,2018,16628,,131,,178,,-47,860,,57,803,822,,38,-4,784,38,-6,,16622
271005,4000,Female,GM1731,Midden-Drenthe,2019JJ00,2019,16622,,132,,174,,-42,764,,68,696,722,,26,0,696,42,1,,16623
271006,4000,Female,GM1731,Midden-Drenthe,2020JJ00,2020,16623,,122,,185,,-63,860,,46,814,734,,19,4,715,126,65,,16688
271007,4000,Female,GM1731,Midden-Drenthe,2021JJ00,2021,16688,,157,,182,,-25,892,,36,856,704,,32,-1,672,188,164,,16852
271008,4000,Female,GM1731,Midden-Drenthe,2022JJ00,2022,16852,,142,,189,,-47,994,,241,753,743,,107,-18,636,251,207,,17059
271009,4000,Female,GM1731,Midden-Drenthe,2023JJ00,2023,17059,,133,,172,,-39,843,,119,724,768,,74,-10,694,75,36,,17095
271086,4000,Female,GM1952,Midden-Groningen,2018JJ00,2018,30393,,233,,309,,-76,1329,,104,1225,1310,,70,-9,1240,19,-57,,30336
271087,4000,Female,GM1952,Midden-Groningen,2019JJ00,2019,30336,,242,,272,,-30,1267,,129,1138,1274,,82,-8,1192,-7,-43,,30293
271088,4000,Female,GM1952,Midden-Groningen,2020JJ00,2020,30293,,260,,280,,-20,1298,,111,1187,1324,,74,-3,1250,-26,-44,,30249
271089,4000,Female,GM1952,Midden-Groningen,2021JJ00,2021,30249,,241,,316,,-75,1398,,158,1240,1243,,112,-31,1131,155,78,,30327
271090,4000,Female,GM1952,Midden-Groningen,2022JJ00,2022,30327,,245,,337,,-92,1698,,503,1195,1302,,135,-11,1167,396,302,,30629
271091,4000,Female,GM1952,Midden-Groningen,2023JJ00,2023,30629,,270,,352,,-82,1394,,275,1119,1444,,246,-108,1198,-50,-135,,30494
271736,4000,Female,GM0815,Mill en Sint Hubert,2012JJ00,2012,5385,,33,,39,,-6,192,,7,185,203,,11,-1,192,-11,-17,,5368
271737,4000,Female,GM0815,Mill en Sint Hubert,2013JJ00,2013,5368,,38,,53,,-15,166,,13,153,179,,8,-4,171,-13,-28,,5340
271738,4000,Female,GM0815,Mill en Sint Hubert,2014JJ00,2014,5340,,29,,42,,-13,200,,19,181,217,,20,-6,197,-17,-30,,5310
271739,4000,Female,GM0815,Mill en Sint Hubert,2015JJ00,2015,5310,,33,,47,,-14,200,,11,189,206,,18,1,188,-6,-21,,5289
271740,4000,Female,GM0815,Mill en Sint Hubert,2016JJ00,2016,5289,,40,,57,,-17,219,,7,212,204,,16,-3,188,15,-2,,5287
271741,4000,Female,GM0815,Mill en Sint Hubert,2017JJ00,2017,5287,,46,,61,,-15,245,,8,237,227,,10,0,217,18,4,,5291
271742,4000,Female,GM0815,Mill en Sint Hubert,2018JJ00,2018,5291,,42,,49,,-7,269,,15,254,236,,17,-7,219,33,26,,5317
271743,4000,Female,GM0815,Mill en Sint Hubert,2019JJ00,2019,5317,,37,,47,,-10,280,,21,259,241,,14,-4,227,39,28,,5345
271744,4000,Female,GM0815,Mill en Sint Hubert,2020JJ00,2020,5345,,54,,57,,-3,269,,13,256,209,,14,-2,195,60,57,,5402
271745,4000,Female,GM0815,Mill en Sint Hubert,2021JJ00,2021,5402,,54,,49,,5,244,,22,222,212,,12,-2,200,32,34,,5436
271900,4000,Female,GM0265,Millingen aan de Rijn,2012JJ00,2012,2948,,25,,18,,7,113,,15,98,90,,6,1,84,23,31,,2979
271901,4000,Female,GM0265,Millingen aan de Rijn,2013JJ00,2013,2979,,17,,22,,-5,88,,8,80,125,,5,2,120,-37,-42,,2937
271902,4000,Female,GM0265,Millingen aan de Rijn,2014JJ00,2014,2937,,20,,19,,1,130,,16,114,133,,7,1,126,-3,-2,,2935
271982,4000,Female,GM1709,Moerdijk,2012JJ00,2012,18327,,162,,159,,3,565,,75,490,567,,54,-2,513,-2,1,,18328
271983,4000,Female,GM1709,Moerdijk,2013JJ00,2013,18328,,137,,166,,-29,641,,59,582,589,,56,1,533,52,24,,18352
271984,4000,Female,GM1709,Moerdijk,2014JJ00,2014,18352,,159,,162,,-3,689,,68,621,642,,49,-1,593,47,45,,18397
271985,4000,Female,GM1709,Moerdijk,2015JJ00,2015,18397,,136,,181,,-45,683,,81,602,668,,74,-5,594,15,-32,,18365
271986,4000,Female,GM1709,Moerdijk,2016JJ00,2016,18365,,151,,163,,-12,777,,66,711,679,,56,0,623,98,88,,18453
271987,4000,Female,GM1709,Moerdijk,2017JJ00,2017,18453,,152,,191,,-39,776,,84,692,742,,67,-6,675,34,-4,,18449
271988,4000,Female,GM1709,Moerdijk,2018JJ00,2018,18449,,152,,176,,-24,752,,82,670,751,,59,-2,692,1,-23,,18426
271989,4000,Female,GM1709,Moerdijk,2019JJ00,2019,18426,,141,,185,,-44,841,,121,720,743,,67,-6,676,98,53,,18479
271990,4000,Female,GM1709,Moerdijk,2020JJ00,2020,18479,,149,,197,,-48,841,,75,766,751,,68,-12,683,90,40,,18519
271991,4000,Female,GM1709,Moerdijk,2021JJ00,2021,18519,,153,,197,,-44,853,,89,764,748,,71,-4,677,105,63,,18582
271992,4000,Female,GM1709,Moerdijk,2022JJ00,2022,18582,,159,,187,,-28,979,,252,727,724,,90,-6,634,255,226,,18808
271993,4000,Female,GM1709,Moerdijk,2023JJ00,2023,18808,,150,,178,,-28,963,,178,785,750,,130,-32,620,213,183,,18991
272399,4000,Female,GM1978,Molenlanden,2019JJ00,2019,21632,,225,,160,,65,743,,78,665,782,,54,2,728,-39,21,,21653
272400,4000,Female,GM1978,Molenlanden,2020JJ00,2020,21653,,238,,135,,103,856,,88,768,798,,21,0,777,58,160,,21813
272401,4000,Female,GM1978,Molenlanden,2021JJ00,2021,21813,,242,,176,,66,955,,64,891,774,,61,-2,713,181,245,,22058
272402,4000,Female,GM1978,Molenlanden,2022JJ00,2022,22058,,230,,158,,72,1138,,343,795,891,,189,-16,702,247,321,,22379
272403,4000,Female,GM1978,Molenlanden,2023JJ00,2023,22379,,214,,148,,66,886,,132,754,955,,113,-5,842,-69,-2,,22377
272475,4000,Female,GM1927,Molenwaard,2013JJ00,2013,14355,,153,,98,,55,381,,37,344,496,,42,-5,454,-115,-70,,14285
272476,4000,Female,GM1927,Molenwaard,2014JJ00,2014,14285,,177,,103,,74,419,,37,382,503,,27,-4,476,-84,-8,,14277
272477,4000,Female,GM1927,Molenwaard,2015JJ00,2015,14277,,160,,98,,62,475,,30,445,511,,41,-2,470,-36,29,,14306
272478,4000,Female,GM1927,Molenwaard,2016JJ00,2016,14306,,171,,105,,66,517,,46,471,516,,45,-7,471,1,68,,14374
272479,4000,Female,GM1927,Molenwaard,2017JJ00,2017,14374,,147,,88,,59,571,,37,534,580,,42,-1,538,-9,47,,14421
272480,4000,Female,GM1927,Molenwaard,2018JJ00,2018,14421,,170,,91,,79,495,,28,467,538,,36,-2,502,-43,32,,14453
272720,4000,Female,GM1955,Montferland,2012JJ00,2012,17575,,130,,145,,-15,579,,55,524,672,,48,4,624,-93,-107,,17468
272721,4000,Female,GM1955,Montferland,2013JJ00,2013,17468,,105,,149,,-44,703,,79,624,633,,44,-1,589,70,25,,17493
272722,4000,Female,GM1955,Montferland,2014JJ00,2014,17493,,112,,153,,-41,768,,94,674,656,,59,2,597,112,70,,17563
272723,4000,Female,GM1955,Montferland,2015JJ00,2015,17563,,147,,171,,-24,707,,86,621,667,,55,-17,612,40,15,,17578
272724,4000,Female,GM1955,Montferland,2016JJ00,2016,17578,,123,,156,,-33,808,,72,736,722,,68,-6,654,86,53,,17631
272725,4000,Female,GM1955,Montferland,2017JJ00,2017,17631,,147,,189,,-42,979,,114,865,772,,73,-14,699,207,163,,17794
272726,4000,Female,GM1955,Montferland,2018JJ00,2018,17794,,142,,163,,-21,955,,147,808,714,,93,-10,621,241,220,,18014
272727,4000,Female,GM1955,Montferland,2019JJ00,2019,18014,,142,,220,,-78,897,,102,795,864,,75,-5,789,33,-45,,17969
272728,4000,Female,GM1955,Montferland,2020JJ00,2020,17969,,148,,184,,-36,855,,70,785,794,,64,-14,730,61,26,,17995
272729,4000,Female,GM1955,Montferland,2021JJ00,2021,17995,,155,,209,,-54,950,,92,858,750,,55,-1,695,200,146,,18141
272730,4000,Female,GM1955,Montferland,2022JJ00,2022,18141,,137,,224,,-87,1129,,312,817,786,,124,-17,662,343,257,,18398
272731,4000,Female,GM1955,Montferland,2023JJ00,2023,18398,,148,,213,,-65,826,,131,695,754,,104,-11,650,72,8,,18406
272802,4000,Female,GM0335,Montfoort,2012JJ00,2012,6792,,64,,33,,31,187,,15,172,228,,17,-8,211,-41,-10,,6782
272803,4000,Female,GM0335,Montfoort,2013JJ00,2013,6782,,83,,31,,52,238,,19,219,268,,26,-3,242,-30,22,,6804
272804,4000,Female,GM0335,Montfoort,2014JJ00,2014,6804,,77,,33,,44,231,,19,212,259,,17,-2,242,-28,16,,6820
272805,4000,Female,GM0335,Montfoort,2015JJ00,2015,6820,,65,,30,,35,265,,25,240,251,,17,-1,234,14,49,,6869
272806,4000,Female,GM0335,Montfoort,2016JJ00,2016,6869,,74,,41,,33,314,,23,291,294,,19,-4,275,20,54,,6923
272807,4000,Female,GM0335,Montfoort,2017JJ00,2017,6923,,69,,44,,25,303,,23,280,327,,7,2,320,-24,2,,6925
272808,4000,Female,GM0335,Montfoort,2018JJ00,2018,6925,,67,,41,,26,300,,24,276,283,,19,-2,264,17,42,,6967
272809,4000,Female,GM0335,Montfoort,2019JJ00,2019,6967,,73,,37,,36,219,,36,183,259,,18,-2,241,-40,-4,,6963
272810,4000,Female,GM0335,Montfoort,2020JJ00,2020,6963,,55,,41,,14,256,,26,230,281,,29,-1,252,-25,-12,,6951
272811,4000,Female,GM0335,Montfoort,2021JJ00,2021,6951,,71,,31,,40,250,,11,239,316,,13,-2,303,-66,-25,,6926
272812,4000,Female,GM0335,Montfoort,2022JJ00,2022,6926,,48,,34,,14,344,,100,244,302,,30,2,272,42,53,,6979
272813,4000,Female,GM0335,Montfoort,2023JJ00,2023,6979,,55,,51,,4,293,,29,264,340,,26,-1,314,-47,-43,,6936
272966,4000,Female,GM0944,Mook en Middelaar,2012JJ00,2012,3952,,19,,17,,2,172,,16,156,189,,5,0,184,-17,-15,,3937
272967,4000,Female,GM0944,Mook en Middelaar,2013JJ00,2013,3937,,15,,23,,-8,172,,15,157,167,,7,1,160,5,0,,3937
272968,4000,Female,GM0944,Mook en Middelaar,2014JJ00,2014,3937,,11,,21,,-10,199,,24,175,202,,13,-3,189,-3,-14,,3923
272969,4000,Female,GM0944,Mook en Middelaar,2015JJ00,2015,3923,,20,,19,,1,213,,32,181,214,,18,-3,196,-1,0,,3923
272970,4000,Female,GM0944,Mook en Middelaar,2016JJ00,2016,3923,,31,,21,,10,228,,20,208,232,,18,0,214,-4,3,,3926
272971,4000,Female,GM0944,Mook en Middelaar,2017JJ00,2017,3926,,15,,26,,-11,247,,24,223,241,,14,-3,227,6,-7,,3919
272972,4000,Female,GM0944,Mook en Middelaar,2018JJ00,2018,3919,,22,,26,,-4,243,,21,222,233,,12,1,221,10,6,,3925
272973,4000,Female,GM0944,Mook en Middelaar,2019JJ00,2019,3925,,23,,26,,-3,248,,41,207,210,,13,1,197,38,34,,3959
272974,4000,Female,GM0944,Mook en Middelaar,2020JJ00,2020,3959,,17,,30,,-13,272,,17,255,239,,9,-2,230,33,20,,3979
272975,4000,Female,GM0944,Mook en Middelaar,2021JJ00,2021,3979,,40,,26,,14,230,,25,205,181,,9,-3,172,49,62,,4041
272976,4000,Female,GM0944,Mook en Middelaar,2022JJ00,2022,4041,,37,,39,,-2,253,,45,208,226,,22,0,204,27,24,,4065
272977,4000,Female,GM0944,Mook en Middelaar,2023JJ00,2023,4065,,20,,35,,-15,289,,74,215,211,,22,0,189,78,64,,4129
273130,4000,Female,GM0424,Muiden,2012JJ00,2012,3340,,21,,20,,1,132,,21,111,190,,21,-1,169,-58,-57,,3283
273131,4000,Female,GM0424,Muiden,2013JJ00,2013,3283,,23,,28,,-5,154,,24,130,199,,10,0,189,-45,-50,,3233
273132,4000,Female,GM0424,Muiden,2014JJ00,2014,3233,,31,,25,,6,167,,16,151,186,,16,3,170,-19,-13,,3220
273133,4000,Female,GM0424,Muiden,2015JJ00,2015,3220,,18,,13,,5,173,,20,153,206,,19,-1,187,-33,-31,,3189
273458,4000,Female,GM0425,Naarden,2012JJ00,2012,8906,,76,,87,,-11,531,,55,476,479,,36,-1,443,52,40,,8946
273459,4000,Female,GM0425,Naarden,2013JJ00,2013,8946,,62,,96,,-34,568,,88,480,559,,89,-6,470,9,-23,,8923
273460,4000,Female,GM0425,Naarden,2014JJ00,2014,8923,,72,,93,,-21,628,,80,548,647,,86,-7,561,-19,-41,,8882
273461,4000,Female,GM0425,Naarden,2015JJ00,2015,8882,,71,,104,,-33,728,,118,610,586,,61,0,525,142,105,,8987
273540,4000,Female,GM1740,Neder-Betuwe,2012JJ00,2012,11387,,125,,89,,36,422,,24,398,483,,36,-7,447,-61,-24,,11363
273541,4000,Female,GM1740,Neder-Betuwe,2013JJ00,2013,11363,,143,,91,,52,341,,34,307,465,,18,-1,447,-124,-72,,11291
273542,4000,Female,GM1740,Neder-Betuwe,2014JJ00,2014,11284,,127,,95,,32,424,,38,386,372,,17,1,355,52,84,,11368
273543,4000,Female,GM1740,Neder-Betuwe,2015JJ00,2015,11368,,163,,67,,96,479,,41,438,417,,30,-11,387,62,160,,11528
273544,4000,Female,GM1740,Neder-Betuwe,2016JJ00,2016,11528,,157,,110,,47,480,,27,453,418,,18,-2,400,62,109,,11637
273545,4000,Female,GM1740,Neder-Betuwe,2017JJ00,2017,11637,,161,,80,,81,550,,32,518,504,,18,-7,486,46,127,,11764
273546,4000,Female,GM1740,Neder-Betuwe,2018JJ00,2018,11764,,160,,97,,63,517,,66,451,432,,14,-6,418,85,147,,11911
273547,4000,Female,GM1740,Neder-Betuwe,2019JJ00,2019,11911,,181,,97,,84,514,,73,441,443,,19,-2,424,71,154,,12065
273548,4000,Female,GM1740,Neder-Betuwe,2020JJ00,2020,12065,,168,,99,,69,528,,57,471,447,,40,-7,407,81,150,,12215
273549,4000,Female,GM1740,Neder-Betuwe,2021JJ00,2021,12215,,182,,102,,80,578,,119,459,494,,35,-16,459,84,164,,12379
273550,4000,Female,GM1740,Neder-Betuwe,2022JJ00,2022,12379,,177,,97,,80,781,,332,449,578,,142,-12,436,203,282,,12661
273551,4000,Female,GM1740,Neder-Betuwe,2023JJ00,2023,12661,,166,,99,,67,643,,143,500,586,,113,-41,473,57,123,,12784
273786,4000,Female,GM0643,Nederlek,2012JJ00,2012,7098,,65,,66,,-1,258,,23,235,192,,9,1,183,66,65,,7163
273787,4000,Female,GM0643,Nederlek,2013JJ00,2013,7163,,43,,63,,-20,243,,24,219,249,,22,-3,227,-6,-26,,7137
273788,4000,Female,GM0643,Nederlek,2014JJ00,2014,7137,,44,,78,,-34,299,,26,273,225,,15,1,210,74,32,,7169
273868,4000,Female,GM0946,Nederweert,2012JJ00,2012,8328,,80,,68,,12,301,,51,250,309,,20,-1,289,-8,4,,8332
273869,4000,Female,GM0946,Nederweert,2013JJ00,2013,8332,,59,,50,,9,288,,27,261,312,,34,0,278,-24,-15,,8317
273870,4000,Female,GM0946,Nederweert,2014JJ00,2014,8317,,69,,56,,13,302,,45,257,325,,22,-4,303,-23,-9,,8308
273871,4000,Female,GM0946,Nederweert,2015JJ00,2015,8308,,66,,64,,2,318,,39,279,323,,23,-2,300,-5,-3,,8305
273872,4000,Female,GM0946,Nederweert,2016JJ00,2016,8305,,62,,60,,2,415,,40,375,378,,35,-9,343,37,40,,8345
273873,4000,Female,GM0946,Nederweert,2017JJ00,2017,8345,,72,,65,,7,432,,43,389,355,,28,-2,327,77,82,,8427
273874,4000,Female,GM0946,Nederweert,2018JJ00,2018,8427,,67,,67,,0,339,,45,294,363,,38,-1,325,-24,-24,,8403
273875,4000,Female,GM0946,Nederweert,2019JJ00,2019,8403,,73,,65,,8,340,,55,285,334,,29,-1,305,6,13,,8416
273876,4000,Female,GM0946,Nederweert,2020JJ00,2020,8416,,63,,80,,-17,397,,60,337,323,,18,-1,305,74,57,,8473
273877,4000,Female,GM0946,Nederweert,2021JJ00,2021,8473,,82,,80,,2,424,,54,370,368,,48,-9,320,56,56,,8529
273878,4000,Female,GM0946,Nederweert,2022JJ00,2022,8529,,71,,71,,0,436,,125,311,332,,64,-5,268,104,105,,8634
273879,4000,Female,GM0946,Nederweert,2023JJ00,2023,8634,,78,,100,,-22,375,,104,271,398,,52,-15,346,-23,-45,,8589
274114,4000,Female,GM0304,Neerijnen,2012JJ00,2012,5931,,72,,39,,33,206,,26,180,202,,8,0,194,4,37,,5968
274115,4000,Female,GM0304,Neerijnen,2013JJ00,2013,5968,,62,,59,,3,185,,26,159,199,,19,-1,180,-14,-11,,5957
274116,4000,Female,GM0304,Neerijnen,2014JJ00,2014,5957,,59,,37,,22,213,,19,194,231,,8,-2,223,-18,4,,5961
274117,4000,Female,GM0304,Neerijnen,2015JJ00,2015,5961,,59,,37,,22,266,,32,234,250,,9,0,241,16,38,,5999
274118,4000,Female,GM0304,Neerijnen,2016JJ00,2016,5999,,82,,33,,49,319,,33,286,255,,21,1,234,64,112,,6111
274119,4000,Female,GM0304,Neerijnen,2017JJ00,2017,6111,,62,,53,,9,305,,26,279,306,,24,0,282,-1,8,,6119
274120,4000,Female,GM0304,Neerijnen,2018JJ00,2018,6119,,63,,45,,18,322,,27,295,316,,16,2,300,6,19,,6138
274770,4000,Female,GM0356,Nieuwegein,2012JJ00,2012,30660,,302,,201,,101,1485,,147,1338,1504,,146,-15,1358,-19,81,,30741
274771,4000,Female,GM0356,Nieuwegein,2013JJ00,2013,30741,,302,,183,,119,1401,,187,1214,1521,,154,-5,1367,-120,-4,,30737
274772,4000,Female,GM0356,Nieuwegein,2014JJ00,2014,30737,,354,,234,,120,1568,,183,1385,1600,,153,-8,1447,-32,93,,30830
274773,4000,Female,GM0356,Nieuwegein,2015JJ00,2015,30830,,303,,202,,101,1793,,198,1595,1707,,174,-14,1533,86,186,,31016
274774,4000,Female,GM0356,Nieuwegein,2016JJ00,2016,31016,,325,,166,,159,1581,,191,1390,1648,,133,-6,1515,-67,89,,31105
274775,4000,Female,GM0356,Nieuwegein,2017JJ00,2017,31105,,329,,182,,147,1959,,181,1778,1782,,168,-18,1614,177,318,,31423
274776,4000,Female,GM0356,Nieuwegein,2018JJ00,2018,31423,,311,,234,,77,1935,,239,1696,1704,,125,-7,1579,231,305,,31728
274777,4000,Female,GM0356,Nieuwegein,2019JJ00,2019,31728,,358,,201,,157,1837,,267,1570,1744,,140,-2,1604,93,252,,31980
274778,4000,Female,GM0356,Nieuwegein,2020JJ00,2020,31980,,318,,209,,109,1956,,205,1751,1845,,154,-4,1691,111,218,,32198
274779,4000,Female,GM0356,Nieuwegein,2021JJ00,2021,32198,,340,,235,,105,2126,,219,1907,1854,,133,-13,1721,272,377,,32575
274780,4000,Female,GM0356,Nieuwegein,2022JJ00,2022,32575,,324,,256,,68,2260,,429,1831,1917,,176,-7,1741,343,408,,32983
274781,4000,Female,GM0356,Nieuwegein,2023JJ00,2023,32983,,338,,280,,58,2030,,370,1660,1902,,192,-10,1710,128,186,,33169
275590,4000,Female,GM0569,Nieuwkoop,2012JJ00,2012,13325,,107,,85,,22,415,,59,356,415,,37,-3,378,0,22,,13347
275591,4000,Female,GM0569,Nieuwkoop,2013JJ00,2013,13347,,112,,87,,25,387,,39,348,423,,21,0,402,-36,-12,,13335
275592,4000,Female,GM0569,Nieuwkoop,2014JJ00,2014,13335,,131,,100,,31,416,,51,365,447,,40,-8,407,-31,1,,13336
275593,4000,Female,GM0569,Nieuwkoop,2015JJ00,2015,13336,,122,,105,,17,609,,46,563,459,,38,-9,421,150,167,,13503
275594,4000,Female,GM0569,Nieuwkoop,2016JJ00,2016,13503,,139,,105,,34,700,,83,617,482,,35,-7,447,218,251,,13754
275595,4000,Female,GM0569,Nieuwkoop,2017JJ00,2017,13754,,134,,89,,45,676,,50,626,531,,44,-14,487,145,190,,13944
275596,4000,Female,GM0569,Nieuwkoop,2018JJ00,2018,13944,,132,,113,,19,659,,92,567,470,,42,-8,428,189,209,,14153
275597,4000,Female,GM0569,Nieuwkoop,2019JJ00,2019,14153,,145,,97,,48,625,,65,560,566,,47,-1,519,59,108,,14261
275598,4000,Female,GM0569,Nieuwkoop,2020JJ00,2020,14261,,166,,126,,40,705,,70,635,578,,45,-2,533,127,166,,14427
275599,4000,Female,GM0569,Nieuwkoop,2021JJ00,2021,14427,,156,,108,,48,584,,69,515,574,,56,-8,518,10,60,,14487
275600,4000,Female,GM0569,Nieuwkoop,2022JJ00,2022,14487,,146,,120,,26,657,,157,500,575,,86,-8,489,82,108,,14595
275601,4000,Female,GM0569,Nieuwkoop,2023JJ00,2023,14595,,129,,117,,12,624,,119,505,621,,62,-3,559,3,15,,14610
275754,4000,Female,GM0571,Nieuw-Lekkerland,2012JJ00,2012,4634,,64,,27,,37,129,,11,118,170,,10,-5,160,-41,14,,4648
276656,4000,Female,GM0267,Nijkerk,2012JJ00,2012,20154,,203,,132,,71,713,,79,634,675,,48,-7,627,38,109,,20263
276657,4000,Female,GM0267,Nijkerk,2013JJ00,2013,20263,,232,,126,,106,688,,118,570,653,,45,-3,608,35,144,,20407
276658,4000,Female,GM0267,Nijkerk,2014JJ00,2014,20406,,245,,141,,104,726,,88,638,729,,81,-9,648,-3,99,,20505
276659,4000,Female,GM0267,Nijkerk,2015JJ00,2015,20505,,234,,139,,95,846,,110,736,791,,87,-11,704,55,152,,20657
276660,4000,Female,GM0267,Nijkerk,2016JJ00,2016,20657,,232,,141,,91,987,,105,882,764,,84,-11,680,223,315,,20972
276661,4000,Female,GM0267,Nijkerk,2017JJ00,2017,20972,,198,,135,,63,1057,,101,956,820,,84,0,736,237,299,,21271
276662,4000,Female,GM0267,Nijkerk,2018JJ00,2018,21271,,225,,151,,74,1043,,123,920,833,,80,-6,753,210,285,,21556
276663,4000,Female,GM0267,Nijkerk,2019JJ00,2019,21556,,220,,145,,75,944,,118,826,890,,93,-3,797,54,127,,21683
276664,4000,Female,GM0267,Nijkerk,2020JJ00,2020,21683,,228,,151,,77,971,,95,876,847,,62,-1,785,124,201,,21884
276665,4000,Female,GM0267,Nijkerk,2021JJ00,2021,21884,,222,,181,,41,1165,,84,1081,882,,88,-3,794,283,322,,22206
276666,4000,Female,GM0267,Nijkerk,2022JJ00,2022,22206,,209,,169,,40,1088,,206,882,796,,85,-5,711,292,333,,22539
276667,4000,Female,GM0267,Nijkerk,2023JJ00,2023,22539,,190,,186,,4,1037,,160,877,893,,114,-21,779,144,148,,22687
276738,4000,Female,GM0268,Nijmegen,2012JJ00,2012,86102,,872,,710,,162,6707,,1255,5452,6205,,1146,-304,5059,502,661,,86763
276739,4000,Female,GM0268,Nijmegen,2013JJ00,2013,86763,,837,,677,,160,6891,,1270,5621,6190,,1241,-338,4949,701,849,,87612
276740,4000,Female,GM0268,Nijmegen,2014JJ00,2014,87612,,881,,622,,259,7197,,1306,5891,6309,,1164,-229,5145,888,1135,,88747
276741,4000,Female,GM0268,Nijmegen,2015JJ00,2015,88747,,870,,729,,141,6945,,1530,5415,6641,,1212,-231,5429,304,440,,89187
276742,4000,Female,GM0268,Nijmegen,2016JJ00,2016,89187,,817,,669,,148,7397,,1744,5653,7124,,1376,-284,5748,273,404,,89591
276743,4000,Female,GM0268,Nijmegen,2017JJ00,2017,89591,,904,,763,,141,8398,,1873,6525,7286,,1340,-257,5946,1112,1238,,90829
276744,4000,Female,GM0268,Nijmegen,2018JJ00,2018,90829,,834,,680,,154,7302,,1894,5408,7122,,1565,-388,5557,180,330,,91159
276745,4000,Female,GM0268,Nijmegen,2019JJ00,2019,91149,,845,,710,,135,7207,,1872,5335,6873,,1621,-472,5252,334,467,,91616
276746,4000,Female,GM0268,Nijmegen,2020JJ00,2020,91616,,886,,783,,103,6486,,1429,5057,6873,,1334,-254,5539,-387,-294,,91322
276747,4000,Female,GM0268,Nijmegen,2021JJ00,2021,91322,,899,,794,,105,6784,,1487,5297,5797,,866,-250,4931,987,1079,,92401
276748,4000,Female,GM0268,Nijmegen,2022JJ00,2022,92401,,832,,779,,53,7926,,2507,5419,6052,,1104,-226,4948,1874,1921,,94322
276749,4000,Female,GM0268,Nijmegen,2023JJ00,2023,94322,,788,,762,,26,9063,,2023,7040,6449,,1361,-260,5088,2614,2628,,96950
276905,4000,Female,GM1930,Nissewaard,2015JJ00,2015,43313,,396,,282,,114,1548,,230,1318,1480,,166,-3,1314,68,145,,43458
276906,4000,Female,GM1930,Nissewaard,2016JJ00,2016,43458,,398,,344,,54,1673,,197,1476,1589,,150,-36,1439,84,140,,43598
276907,4000,Female,GM1930,Nissewaard,2017JJ00,2017,43598,,358,,340,,18,1868,,164,1704,1631,,142,-27,1489,237,253,,43851
276908,4000,Female,GM1930,Nissewaard,2018JJ00,2018,43233,,384,,320,,64,1722,,160,1562,1689,,136,-1,1553,33,94,,43327
276909,4000,Female,GM1930,Nissewaard,2019JJ00,2019,43327,,429,,374,,55,1829,,218,1611,1740,,141,-23,1599,89,145,,43472
276910,4000,Female,GM1930,Nissewaard,2020JJ00,2020,43472,,385,,378,,7,1789,,191,1598,1710,,122,-15,1588,79,85,,43557
276911,4000,Female,GM1930,Nissewaard,2021JJ00,2021,43557,,450,,375,,75,2188,,213,1975,1774,,130,4,1644,414,489,,44046
276912,4000,Female,GM1930,Nissewaard,2022JJ00,2022,44046,,415,,379,,36,2009,,382,1627,1797,,189,-5,1608,212,249,,44295
276913,4000,Female,GM1930,Nissewaard,2023JJ00,2023,44295,,428,,410,,18,2145,,328,1817,1847,,154,-4,1693,298,314,,44609
277073,4000,Female,GM1970,Noardeast-Fryslân,2019JJ00,2019,22390,,217,,197,,20,874,,73,801,823,,50,-13,773,51,70,,22460
277074,4000,Female,GM1970,Noardeast-Fryslân,2020JJ00,2020,22460,,221,,226,,-5,928,,62,866,782,,31,3,751,146,142,,22602
277075,4000,Female,GM1970,Noardeast-Fryslân,2021JJ00,2021,22602,,230,,247,,-17,858,,55,803,783,,35,2,748,75,58,,22660
277076,4000,Female,GM1970,Noardeast-Fryslân,2022JJ00,2022,22660,,188,,248,,-60,916,,156,760,774,,75,-2,699,142,82,,22742
277077,4000,Female,GM1970,Noardeast-Fryslân,2023JJ00,2023,22742,,219,,240,,-21,845,,100,745,841,,82,-10,759,4,-19,,22723
277230,4000,Female,GM1695,Noord-Beveland,2012JJ00,2012,3756,,36,,38,,-2,266,,35,231,271,,8,0,263,-5,-7,,3749
277231,4000,Female,GM1695,Noord-Beveland,2013JJ00,2013,3749,,39,,44,,-5,255,,17,238,240,,7,-2,233,15,10,,3759
277232,4000,Female,GM1695,Noord-Beveland,2014JJ00,2014,3759,,26,,35,,-9,210,,34,176,251,,18,-6,233,-41,-50,,3709
277233,4000,Female,GM1695,Noord-Beveland,2015JJ00,2015,3709,,29,,32,,-3,238,,29,209,224,,17,-3,207,14,13,,3722
277234,4000,Female,GM1695,Noord-Beveland,2016JJ00,2016,3722,,26,,63,,-37,230,,30,200,224,,23,-7,201,6,-31,,3691
277235,4000,Female,GM1695,Noord-Beveland,2017JJ00,2017,3691,,18,,48,,-30,259,,27,232,285,,37,-3,248,-26,-57,,3634
277236,4000,Female,GM1695,Noord-Beveland,2018JJ00,2018,3634,,21,,41,,-20,247,,20,227,222,,15,-2,207,25,5,,3639
277237,4000,Female,GM1695,Noord-Beveland,2019JJ00,2019,3639,,16,,35,,-19,291,,48,243,234,,15,-5,219,57,38,,3677
277238,4000,Female,GM1695,Noord-Beveland,2020JJ00,2020,3677,,18,,30,,-12,324,,30,294,213,,25,-9,188,111,100,,3777
277239,4000,Female,GM1695,Noord-Beveland,2021JJ00,2021,3777,,27,,52,,-25,282,,34,248,219,,23,-5,196,63,36,,3813
277240,4000,Female,GM1695,Noord-Beveland,2022JJ00,2022,3813,,31,,43,,-12,361,,99,262,230,,42,-7,188,131,117,,3930
277241,4000,Female,GM1695,Noord-Beveland,2023JJ00,2023,3930,,23,,51,,-28,278,,34,244,210,,32,-1,178,68,41,,3971
277558,4000,Female,GM1699,Noordenveld,2012JJ00,2012,15613,,104,,134,,-30,616,,27,589,571,,18,-4,553,45,15,,15628
277559,4000,Female,GM1699,Noordenveld,2013JJ00,2013,15628,,111,,144,,-33,578,,30,548,550,,27,2,523,28,-4,,15624
277560,4000,Female,GM1699,Noordenveld,2014JJ00,2014,15624,,106,,139,,-33,660,,34,626,613,,24,1,589,47,15,,15639
277561,4000,Female,GM1699,Noordenveld,2015JJ00,2015,15639,,120,,161,,-41,756,,46,710,726,,37,-4,689,30,-7,,15632
277562,4000,Female,GM1699,Noordenveld,2016JJ00,2016,15632,,131,,152,,-21,6150,,5405,745,4957,,29,-2,4928,1193,1176,,16808
277563,4000,Female,GM1699,Noordenveld,2017JJ00,2017,16808,,127,,140,,-13,10883,,10148,735,11281,,35,-2,11246,-398,-420,,16388
277564,4000,Female,GM1699,Noordenveld,2018JJ00,2018,16388,,122,,177,,-55,789,,47,742,1370,,38,-13,1332,-581,-642,,15746
277565,4000,Female,GM1699,Noordenveld,2019JJ00,2019,15746,,102,,156,,-54,712,,31,681,652,,39,-4,613,60,7,,15753
277566,4000,Female,GM1699,Noordenveld,2020JJ00,2020,15753,,119,,185,,-66,741,,34,707,684,,22,-1,662,57,-12,,15741
277567,4000,Female,GM1699,Noordenveld,2021JJ00,2021,15741,,120,,184,,-64,737,,17,720,694,,25,1,669,43,-26,,15715
277568,4000,Female,GM1699,Noordenveld,2022JJ00,2022,15715,,114,,166,,-52,934,,186,748,647,,49,0,598,287,232,,15947
277569,4000,Female,GM1699,Noordenveld,2023JJ00,2023,15947,,106,,183,,-77,863,,98,765,697,,55,-2,642,166,92,,16039
277886,4000,Female,GM0171,Noordoostpolder,2012JJ00,2012,22890,,285,,166,,119,880,,251,629,1021,,146,-66,875,-141,-16,,22874
277887,4000,Female,GM0171,Noordoostpolder,2013JJ00,2013,22874,,265,,171,,94,941,,367,574,1022,,100,-16,922,-81,16,,22890
277888,4000,Female,GM0171,Noordoostpolder,2014JJ00,2014,22890,,287,,177,,110,1025,,396,629,1140,,97,-30,1043,-115,0,,22890
277889,4000,Female,GM0171,Noordoostpolder,2015JJ00,2015,22890,,248,,199,,49,1361,,709,652,1465,,140,-20,1325,-104,-54,,22836
277890,4000,Female,GM0171,Noordoostpolder,2016JJ00,2016,22836,,265,,199,,66,1270,,403,867,1297,,101,-20,1196,-27,46,,22882
277891,4000,Female,GM0171,Noordoostpolder,2017JJ00,2017,22882,,232,,171,,61,1231,,218,1013,1193,,124,-41,1069,38,97,,22979
277892,4000,Female,GM0171,Noordoostpolder,2018JJ00,2018,22979,,293,,194,,99,1171,,250,921,1125,,138,-42,987,46,148,,23127
277893,4000,Female,GM0171,Noordoostpolder,2019JJ00,2019,23122,,268,,181,,87,1211,,281,930,1088,,138,-40,950,123,211,,23333
277894,4000,Female,GM0171,Noordoostpolder,2020JJ00,2020,23333,,235,,192,,43,1151,,200,951,1124,,114,-35,1010,27,70,,23403
277895,4000,Female,GM0171,Noordoostpolder,2021JJ00,2021,23403,,287,,205,,82,1386,,186,1200,1162,,136,-42,1026,224,301,,23704
277896,4000,Female,GM0171,Noordoostpolder,2022JJ00,2022,23704,,285,,231,,54,2263,,1127,1136,1419,,452,-42,967,844,898,,24602
277897,4000,Female,GM0171,Noordoostpolder,2023JJ00,2023,24602,,258,,218,,40,1647,,607,1040,1624,,599,-50,1025,23,63,,24665
278050,4000,Female,GM0575,Noordwijk,2012JJ00,2012,12681,,132,,127,,5,699,,164,535,613,,90,-12,523,86,92,,12773
278051,4000,Female,GM0575,Noordwijk,2013JJ00,2013,12773,,108,,145,,-37,686,,155,531,618,,81,-5,537,68,31,,12804
278052,4000,Female,GM0575,Noordwijk,2014JJ00,2014,12804,,101,,126,,-25,673,,151,522,680,,92,-7,588,-7,-33,,12771
278053,4000,Female,GM0575,Noordwijk,2015JJ00,2015,12771,,91,,139,,-48,796,,147,649,669,,100,-11,569,127,81,,12852
278054,4000,Female,GM0575,Noordwijk,2016JJ00,2016,12852,,103,,101,,2,777,,143,634,705,,64,-5,641,72,76,,12928
278055,4000,Female,GM0575,Noordwijk,2017JJ00,2017,12928,,111,,135,,-24,819,,137,682,705,,69,-6,636,114,90,,13018
278056,4000,Female,GM0575,Noordwijk,2018JJ00,2018,13018,,110,,140,,-30,786,,146,640,718,,95,-2,623,68,41,,13059
278057,4000,Female,GM0575,Noordwijk,2019JJ00,2019,21333,,171,,177,,-6,1298,,305,993,956,,174,-19,782,342,336,,21669
278058,4000,Female,GM0575,Noordwijk,2020JJ00,2020,21669,,185,,214,,-29,1315,,211,1104,1020,,184,-43,836,295,265,,21934
278059,4000,Female,GM0575,Noordwijk,2021JJ00,2021,21934,,190,,233,,-43,1177,,227,950,1001,,144,-11,857,176,129,,22063
278060,4000,Female,GM0575,Noordwijk,2022JJ00,2022,22063,,186,,202,,-16,1635,,621,1014,1071,,213,-25,858,564,545,,22608
278061,4000,Female,GM0575,Noordwijk,2023JJ00,2023,22608,,184,,229,,-45,1484,,435,1049,1169,,278,-29,891,315,274,,22882
278132,4000,Female,GM0576,Noordwijkerhout,2012JJ00,2012,7760,,59,,67,,-8,402,,61,341,343,,43,-1,300,59,51,,7811
278133,4000,Female,GM0576,Noordwijkerhout,2013JJ00,2013,7811,,57,,67,,-10,482,,84,398,342,,42,-5,300,140,129,,7940
278134,4000,Female,GM0576,Noordwijkerhout,2014JJ00,2014,7940,,80,,67,,13,412,,96,316,354,,46,-2,308,58,70,,8010
278135,4000,Female,GM0576,Noordwijkerhout,2015JJ00,2015,8010,,66,,49,,17,442,,63,379,426,,39,-5,387,16,33,,8043
278136,4000,Female,GM0576,Noordwijkerhout,2016JJ00,2016,8043,,64,,69,,-5,525,,159,366,459,,67,-3,392,66,58,,8101
278137,4000,Female,GM0576,Noordwijkerhout,2017JJ00,2017,8101,,70,,84,,-14,715,,247,468,565,,180,-7,385,150,138,,8239
278138,4000,Female,GM0576,Noordwijkerhout,2018JJ00,2018,8239,,78,,77,,1,560,,179,381,525,,163,-4,362,35,35,,8274
278378,4000,Female,GM0820,"Nuenen, Gerwen en Nederwetten",2012JJ00,2012,11363,,65,,78,,-13,431,,42,389,382,,42,0,340,49,36,,11399
278379,4000,Female,GM0820,"Nuenen, Gerwen en Nederwetten",2013JJ00,2013,11399,,74,,86,,-12,449,,61,388,449,,46,0,403,0,-12,,11387
278380,4000,Female,GM0820,"Nuenen, Gerwen en Nederwetten",2014JJ00,2014,11387,,86,,82,,4,453,,42,411,464,,32,-3,432,-11,-7,,11380
278381,4000,Female,GM0820,"Nuenen, Gerwen en Nederwetten",2015JJ00,2015,11380,,82,,112,,-30,548,,52,496,416,,34,1,382,132,101,,11481
278382,4000,Female,GM0820,"Nuenen, Gerwen en Nederwetten",2016JJ00,2016,11481,,105,,88,,17,571,,56,515,515,,30,1,485,56,74,,11555
278383,4000,Female,GM0820,"Nuenen, Gerwen en Nederwetten",2017JJ00,2017,11555,,89,,92,,-3,644,,60,584,537,,40,2,497,107,104,,11659
278384,4000,Female,GM0820,"Nuenen, Gerwen en Nederwetten",2018JJ00,2018,11659,,106,,119,,-13,634,,67,567,554,,34,-1,520,80,67,,11726
278385,4000,Female,GM0820,"Nuenen, Gerwen en Nederwetten",2019JJ00,2019,11726,,102,,89,,13,586,,63,523,492,,45,-2,447,94,106,,11832
278386,4000,Female,GM0820,"Nuenen, Gerwen en Nederwetten",2020JJ00,2020,11832,,96,,104,,-8,672,,39,633,550,,25,-4,525,122,112,,11944
278387,4000,Female,GM0820,"Nuenen, Gerwen en Nederwetten",2021JJ00,2021,11944,,96,,102,,-6,632,,71,561,520,,31,-3,489,112,105,,12049
278388,4000,Female,GM0820,"Nuenen, Gerwen en Nederwetten",2022JJ00,2022,12049,,101,,125,,-24,675,,121,554,560,,58,-1,502,115,89,,12138
278389,4000,Female,GM0820,"Nuenen, Gerwen en Nederwetten",2023JJ00,2023,12138,,109,,110,,-1,638,,109,529,556,,60,0,496,82,79,,12217
278706,4000,Female,GM0302,Nunspeet,2012JJ00,2012,13484,,151,,127,,24,440,,33,407,453,,27,1,426,-13,11,,13495
278707,4000,Female,GM0302,Nunspeet,2013JJ00,2013,13495,,137,,105,,32,437,,49,388,441,,30,-4,411,-4,27,,13522
278708,4000,Female,GM0302,Nunspeet,2014JJ00,2014,13522,,149,,116,,33,471,,58,413,476,,26,-2,450,-5,29,,13551
278709,4000,Female,GM0302,Nunspeet,2015JJ00,2015,13551,,141,,133,,8,523,,66,457,500,,39,-5,461,23,33,,13584
278710,4000,Female,GM0302,Nunspeet,2016JJ00,2016,13584,,134,,128,,6,575,,47,528,571,,32,-1,539,4,8,,13592
278711,4000,Female,GM0302,Nunspeet,2017JJ00,2017,13592,,172,,139,,33,629,,27,602,537,,17,1,520,92,124,,13716
278712,4000,Female,GM0302,Nunspeet,2018JJ00,2018,13716,,151,,135,,16,662,,35,627,512,,41,-11,471,150,166,,13882
278713,4000,Female,GM0302,Nunspeet,2019JJ00,2019,13882,,159,,122,,37,638,,66,572,517,,31,0,486,121,162,,14044
278714,4000,Female,GM0302,Nunspeet,2020JJ00,2020,14044,,166,,182,,-16,674,,46,628,543,,31,-1,512,131,114,,14158
278715,4000,Female,GM0302,Nunspeet,2021JJ00,2021,14158,,188,,151,,37,601,,32,569,533,,27,-6,506,68,106,,14264
278716,4000,Female,GM0302,Nunspeet,2022JJ00,2022,14264,,164,,160,,4,784,,190,594,480,,63,-2,417,304,310,,14574
278717,4000,Female,GM0302,Nunspeet,2023JJ00,2023,14574,,161,,148,,13,654,,61,593,529,,66,-14,463,125,137,,14711
278788,4000,Female,GM0951,Nuth,2012JJ00,2012,7932,,70,,77,,-7,319,,27,292,424,,35,-1,389,-105,-112,,7820
278789,4000,Female,GM0951,Nuth,2013JJ00,2013,7820,,52,,71,,-19,403,,28,375,318,,22,4,296,85,66,,7886
278790,4000,Female,GM0951,Nuth,2014JJ00,2014,7886,,69,,89,,-20,341,,36,305,371,,29,-3,342,-30,-50,,7836
278791,4000,Female,GM0951,Nuth,2015JJ00,2015,7836,,62,,67,,-5,323,,35,288,352,,41,-4,311,-29,-35,,7801
278792,4000,Female,GM0951,Nuth,2016JJ00,2016,7801,,41,,84,,-43,391,,34,357,405,,30,0,375,-14,-57,,7744
278793,4000,Female,GM0951,Nuth,2017JJ00,2017,7744,,46,,85,,-39,383,,26,357,427,,32,0,395,-44,-91,,7653
278794,4000,Female,GM0951,Nuth,2018JJ00,2018,7653,,53,,89,,-36,413,,22,391,377,,24,-1,353,36,-4,,7649
279280,4000,Female,GM0579,Oegstgeest,2012JJ00,2012,11838,,124,,138,,-14,922,,208,714,773,,120,-13,653,149,136,,11974
279281,4000,Female,GM0579,Oegstgeest,2013JJ00,2013,11974,,80,,119,,-39,866,,227,639,912,,154,-18,758,-46,-84,,11890
279282,4000,Female,GM0579,Oegstgeest,2014JJ00,2014,11890,,114,,131,,-17,903,,132,771,826,,141,-29,685,77,62,,11952
279283,4000,Female,GM0579,Oegstgeest,2015JJ00,2015,11952,,108,,122,,-14,949,,168,781,839,,120,-11,719,110,96,,12048
279284,4000,Female,GM0579,Oegstgeest,2016JJ00,2016,12048,,105,,128,,-23,1119,,160,959,876,,131,-4,745,243,219,,12267
279285,4000,Female,GM0579,Oegstgeest,2017JJ00,2017,12267,,114,,133,,-19,998,,166,832,854,,104,-7,750,144,125,,12392
279286,4000,Female,GM0579,Oegstgeest,2018JJ00,2018,12392,,111,,139,,-28,1090,,168,922,792,,105,-3,687,298,269,,12661
279287,4000,Female,GM0579,Oegstgeest,2019JJ00,2019,12661,,129,,121,,8,1016,,177,839,846,,127,-2,719,170,177,,12838
279288,4000,Female,GM0579,Oegstgeest,2020JJ00,2020,12838,,113,,144,,-31,1025,,154,871,861,,105,-2,756,164,131,,12969
279289,4000,Female,GM0579,Oegstgeest,2021JJ00,2021,12969,,99,,120,,-21,1071,,163,908,826,,118,-5,708,245,225,,13194
279290,4000,Female,GM0579,Oegstgeest,2022JJ00,2022,13194,,98,,128,,-30,1183,,341,842,1007,,169,0,838,176,147,,13341
279291,4000,Female,GM0579,Oegstgeest,2023JJ00,2023,13341,,127,,116,,11,1144,,217,927,1109,,148,-2,961,35,44,,13385
279526,4000,Female,GM0823,Oirschot,2012JJ00,2012,8810,,76,,81,,-5,283,,30,253,245,,27,0,218,38,33,,8843
279527,4000,Female,GM0823,Oirschot,2013JJ00,2013,8843,,71,,83,,-12,313,,37,276,243,,31,-3,212,70,58,,8901
279528,4000,Female,GM0823,Oirschot,2014JJ00,2014,8901,,81,,80,,1,354,,28,326,252,,24,-2,228,102,100,,9001
279529,4000,Female,GM0823,Oirschot,2015JJ00,2015,9001,,75,,89,,-14,361,,29,332,291,,15,0,276,70,55,,9056
279530,4000,Female,GM0823,Oirschot,2016JJ00,2016,9056,,82,,100,,-18,504,,64,440,347,,11,-2,336,157,138,,9194
279531,4000,Female,GM0823,Oirschot,2017JJ00,2017,9194,,66,,87,,-21,436,,42,394,390,,33,0,357,46,23,,9217
279532,4000,Female,GM0823,Oirschot,2018JJ00,2018,9217,,83,,94,,-11,399,,48,351,350,,28,-1,322,49,36,,9253
279533,4000,Female,GM0823,Oirschot,2019JJ00,2019,9253,,74,,89,,-15,409,,42,367,353,,28,0,325,56,40,,9293
279534,4000,Female,GM0823,Oirschot,2020JJ00,2020,9293,,54,,136,,-82,490,,56,434,388,,29,0,359,102,20,,9313
279535,4000,Female,GM0823,Oirschot,2021JJ00,2021,9313,,77,,79,,-2,457,,51,406,318,,28,0,290,139,139,,9452
279536,4000,Female,GM0823,Oirschot,2022JJ00,2022,9452,,84,,129,,-45,489,,87,402,396,,27,-7,369,93,48,,9500
279537,4000,Female,GM0823,Oirschot,2023JJ00,2023,9500,,88,,126,,-38,546,,69,477,496,,59,-8,437,50,11,,9511
279608,4000,Female,GM0824,Oisterwijk,2012JJ00,2012,13077,,85,,131,,-46,610,,96,514,563,,37,-8,526,47,3,,13080
279609,4000,Female,GM0824,Oisterwijk,2013JJ00,2013,13080,,93,,112,,-19,596,,128,468,550,,34,-6,516,46,28,,13108
279610,4000,Female,GM0824,Oisterwijk,2014JJ00,2014,13108,,91,,138,,-47,667,,165,502,682,,43,-11,639,-15,-63,,13045
279611,4000,Female,GM0824,Oisterwijk,2015JJ00,2015,13045,,103,,149,,-46,769,,215,554,680,,46,-8,634,89,45,,13090
279612,4000,Female,GM0824,Oisterwijk,2016JJ00,2016,13090,,110,,132,,-22,895,,205,690,787,,56,-14,731,108,88,,13178
279613,4000,Female,GM0824,Oisterwijk,2017JJ00,2017,13178,,101,,145,,-44,973,,85,888,840,,52,-13,788,133,88,,13266
279614,4000,Female,GM0824,Oisterwijk,2018JJ00,2018,13266,,89,,139,,-50,884,,86,798,825,,48,-3,777,59,11,,13277
279615,4000,Female,GM0824,Oisterwijk,2019JJ00,2019,13277,,98,,143,,-45,814,,92,722,703,,58,-12,645,111,67,,13344
279616,4000,Female,GM0824,Oisterwijk,2020JJ00,2020,13344,,108,,137,,-29,873,,59,814,712,,28,0,684,161,132,,13476
279617,4000,Female,GM0824,Oisterwijk,2021JJ00,2021,16317,,150,,208,,-58,935,,76,859,864,,66,-5,798,71,10,,16327
279618,4000,Female,GM0824,Oisterwijk,2022JJ00,2022,16327,,129,,176,,-47,1167,,276,891,893,,64,6,829,274,227,,16554
279619,4000,Female,GM0824,Oisterwijk,2023JJ00,2023,16554,,149,,189,,-40,1225,,186,1039,1144,,122,-12,1022,81,42,,16596
279690,4000,Female,GM1895,Oldambt,2012JJ00,2012,19764,,165,,241,,-76,678,,63,615,744,,69,-13,675,-66,-144,,19620
279691,4000,Female,GM1895,Oldambt,2013JJ00,2013,19620,,191,,241,,-50,733,,67,666,789,,56,0,733,-56,-107,,19513
279692,4000,Female,GM1895,Oldambt,2014JJ00,2014,19513,,140,,253,,-113,718,,79,639,744,,54,-13,690,-26,-142,,19371
279693,4000,Female,GM1895,Oldambt,2015JJ00,2015,19371,,130,,245,,-115,756,,63,693,737,,52,-5,685,19,-96,,19275
279694,4000,Female,GM1895,Oldambt,2016JJ00,2016,19275,,152,,254,,-102,884,,116,768,861,,62,-6,799,23,-81,,19194
279695,4000,Female,GM1895,Oldambt,2017JJ00,2017,19194,,131,,220,,-89,799,,65,734,739,,37,3,702,60,-32,,19162
279696,4000,Female,GM1895,Oldambt,2018JJ00,2018,19162,,143,,279,,-136,874,,86,788,751,,41,-4,710,123,-13,,19149
279697,4000,Female,GM1895,Oldambt,2019JJ00,2019,19149,,156,,229,,-73,887,,81,806,802,,40,1,762,85,11,,19160
279698,4000,Female,GM1895,Oldambt,2020JJ00,2020,19160,,129,,254,,-125,911,,64,847,798,,55,-10,743,113,-12,,19148
279699,4000,Female,GM1895,Oldambt,2021JJ00,2021,19148,,123,,282,,-159,984,,83,901,764,,49,4,715,220,61,,19209
279700,4000,Female,GM1895,Oldambt,2022JJ00,2022,19209,,164,,275,,-111,1188,,225,963,833,,106,-18,727,355,238,,19447
279701,4000,Female,GM1895,Oldambt,2023JJ00,2023,19447,,163,,242,,-79,1153,,151,1002,888,,82,-23,806,265,185,,19632
279772,4000,Female,GM0269,Oldebroek,2012JJ00,2012,11263,,116,,82,,34,408,,27,381,406,,34,-10,372,2,36,,11299
279773,4000,Female,GM0269,Oldebroek,2013JJ00,2013,11299,,114,,62,,52,366,,26,340,379,,14,2,365,-13,40,,11339
279774,4000,Female,GM0269,Oldebroek,2014JJ00,2014,11339,,114,,69,,45,443,,61,382,412,,21,2,391,31,77,,11416
279775,4000,Female,GM0269,Oldebroek,2015JJ00,2015,11416,,115,,80,,35,456,,49,407,473,,35,-10,438,-17,18,,11434
279776,4000,Female,GM0269,Oldebroek,2016JJ00,2016,11434,,118,,96,,22,517,,50,467,452,,39,-18,413,65,86,,11520
279777,4000,Female,GM0269,Oldebroek,2017JJ00,2017,11520,,140,,85,,55,543,,45,498,432,,40,-10,392,111,163,,11683
279778,4000,Female,GM0269,Oldebroek,2018JJ00,2018,11683,,137,,96,,41,556,,56,500,546,,51,-7,495,10,51,,11734
279779,4000,Female,GM0269,Oldebroek,2019JJ00,2019,11734,,139,,94,,45,469,,47,422,527,,33,-3,494,-58,-13,,11721
279780,4000,Female,GM0269,Oldebroek,2020JJ00,2020,11721,,103,,107,,-4,574,,64,510,481,,35,-5,446,93,88,,11809
279781,4000,Female,GM0269,Oldebroek,2021JJ00,2021,11809,,133,,96,,37,542,,40,502,490,,38,-7,452,52,88,,11897
279782,4000,Female,GM0269,Oldebroek,2022JJ00,2022,11897,,133,,95,,38,720,,263,457,563,,76,-23,487,157,194,,12091
279783,4000,Female,GM0269,Oldebroek,2023JJ00,2023,12091,,118,,87,,31,506,,64,442,526,,64,-10,462,-20,11,,12102
280100,4000,Female,GM0173,Oldenzaal,2012JJ00,2012,16102,,189,,133,,56,491,,60,431,524,,43,-2,481,-33,22,,16124
280101,4000,Female,GM0173,Oldenzaal,2013JJ00,2013,16124,,148,,153,,-5,468,,57,411,489,,53,3,436,-21,-25,,16099
280102,4000,Female,GM0173,Oldenzaal,2014JJ00,2014,16099,,149,,150,,-1,535,,57,478,502,,66,-7,436,33,33,,16132
280103,4000,Female,GM0173,Oldenzaal,2015JJ00,2015,16132,,152,,163,,-11,532,,64,468,504,,50,-4,454,28,18,,16150
280104,4000,Female,GM0173,Oldenzaal,2016JJ00,2016,16150,,143,,165,,-22,492,,57,435,497,,41,-6,456,-5,-30,,16120
280105,4000,Female,GM0173,Oldenzaal,2017JJ00,2017,16120,,122,,170,,-48,572,,61,511,539,,36,2,503,33,-17,,16103
280106,4000,Female,GM0173,Oldenzaal,2018JJ00,2018,16103,,128,,160,,-32,543,,64,479,561,,50,-1,511,-18,-51,,16052
280107,4000,Female,GM0173,Oldenzaal,2019JJ00,2019,16052,,130,,173,,-43,590,,68,522,548,,45,-5,503,42,-2,,16050
280108,4000,Female,GM0173,Oldenzaal,2020JJ00,2020,16050,,113,,171,,-58,524,,51,473,506,,36,-1,470,18,-42,,16008
280109,4000,Female,GM0173,Oldenzaal,2021JJ00,2021,16008,,121,,192,,-71,559,,46,513,488,,43,2,445,71,2,,16010
280110,4000,Female,GM0173,Oldenzaal,2022JJ00,2022,16010,,125,,180,,-55,640,,157,483,479,,50,-13,429,161,106,,16116
280111,4000,Female,GM0173,Oldenzaal,2023JJ00,2023,16116,,118,,174,,-56,549,,67,482,569,,70,-8,499,-20,-79,,16037
280264,4000,Female,GM1773,Olst-Wijhe,2012JJ00,2012,8737,,79,,67,,12,383,,23,360,349,,20,-5,329,34,46,,8783
280265,4000,Female,GM1773,Olst-Wijhe,2013JJ00,2013,8783,,63,,77,,-14,349,,18,331,334,,8,2,326,15,1,,8784
280266,4000,Female,GM1773,Olst-Wijhe,2014JJ00,2014,8784,,74,,80,,-6,385,,22,363,321,,14,-1,307,64,57,,8841
280267,4000,Female,GM1773,Olst-Wijhe,2015JJ00,2015,8841,,72,,98,,-26,396,,18,378,355,,14,2,341,41,15,,8856
280268,4000,Female,GM1773,Olst-Wijhe,2016JJ00,2016,8856,,74,,84,,-10,418,,13,405,378,,19,2,359,40,30,,8886
280269,4000,Female,GM1773,Olst-Wijhe,2017JJ00,2017,8886,,53,,93,,-40,512,,29,483,449,,27,2,422,63,23,,8909
280270,4000,Female,GM1773,Olst-Wijhe,2018JJ00,2018,8909,,83,,96,,-13,436,,19,417,406,,17,2,389,30,17,,8926
280271,4000,Female,GM1773,Olst-Wijhe,2019JJ00,2019,8926,,89,,91,,-2,466,,29,437,398,,18,-4,380,68,66,,8992
280272,4000,Female,GM1773,Olst-Wijhe,2020JJ00,2020,8992,,80,,101,,-21,463,,23,440,409,,17,-1,392,54,33,,9025
280273,4000,Female,GM1773,Olst-Wijhe,2021JJ00,2021,9025,,77,,106,,-29,484,,15,469,370,,15,1,355,114,86,,9111
280274,4000,Female,GM1773,Olst-Wijhe,2022JJ00,2022,9111,,77,,103,,-26,486,,50,436,380,,33,0,347,106,79,,9190
280275,4000,Female,GM1773,Olst-Wijhe,2023JJ00,2023,9190,,85,,117,,-32,520,,71,449,403,,53,-17,350,117,85,,9275
280346,4000,Female,GM0175,Ommen,2012JJ00,2012,8682,,85,,85,,0,388,,66,322,423,,31,1,392,-35,-36,,8646
280347,4000,Female,GM0175,Ommen,2013JJ00,2013,8646,,82,,62,,20,354,,67,287,395,,22,6,373,-41,-19,,8627
280348,4000,Female,GM0175,Ommen,2014JJ00,2014,8627,,90,,90,,0,393,,78,315,433,,52,-11,381,-40,-34,,8593
280349,4000,Female,GM0175,Ommen,2015JJ00,2015,8593,,86,,82,,4,605,,188,417,487,,35,4,452,118,123,,8716
280350,4000,Female,GM0175,Ommen,2016JJ00,2016,8716,,91,,90,,1,463,,73,390,504,,34,1,470,-41,-40,,8676
280351,4000,Female,GM0175,Ommen,2017JJ00,2017,8676,,66,,85,,-19,528,,78,450,440,,48,-16,392,88,70,,8746
280352,4000,Female,GM0175,Ommen,2018JJ00,2018,8746,,82,,78,,4,538,,60,478,477,,45,-11,432,61,65,,8811
280353,4000,Female,GM0175,Ommen,2019JJ00,2019,8811,,84,,79,,5,508,,84,424,437,,39,-3,398,71,76,,8887
280354,4000,Female,GM0175,Ommen,2020JJ00,2020,8887,,74,,91,,-17,572,,105,467,416,,28,-4,388,156,138,,9025
280355,4000,Female,GM0175,Ommen,2021JJ00,2021,9025,,79,,84,,-5,474,,72,402,396,,72,-16,324,78,73,,9098
280356,4000,Female,GM0175,Ommen,2022JJ00,2022,9098,,95,,96,,-1,726,,270,456,428,,71,-10,357,298,295,,9393
280357,4000,Female,GM0175,Ommen,2023JJ00,2023,9393,,87,,107,,-20,534,,124,410,503,,71,-9,432,31,12,,9405
280428,4000,Female,GM0881,Onderbanken,2012JJ00,2012,4015,,25,,33,,-8,169,,16,153,214,,14,1,200,-45,-52,,3963
280429,4000,Female,GM0881,Onderbanken,2013JJ00,2013,3963,,23,,31,,-8,178,,19,159,179,,14,5,165,-1,-9,,3954
280430,4000,Female,GM0881,Onderbanken,2014JJ00,2014,3954,,30,,30,,0,177,,23,154,203,,12,2,191,-26,-26,,3928
280431,4000,Female,GM0881,Onderbanken,2015JJ00,2015,3928,,21,,40,,-19,179,,10,169,176,,10,-2,166,3,-16,,3912
280432,4000,Female,GM0881,Onderbanken,2016JJ00,2016,3912,,21,,36,,-15,198,,16,182,184,,29,-2,155,14,-1,,3911
280433,4000,Female,GM0881,Onderbanken,2017JJ00,2017,3911,,23,,44,,-21,210,,16,194,205,,12,-3,193,5,-16,,3895
280434,4000,Female,GM0881,Onderbanken,2018JJ00,2018,3895,,21,,38,,-17,247,,27,220,253,,14,-2,239,-6,-18,,3877
280674,4000,Female,GM1586,Oost Gelre,2012JJ00,2012,14711,,125,,137,,-12,430,,30,400,477,,19,2,458,-47,-60,,14651
280675,4000,Female,GM1586,Oost Gelre,2013JJ00,2013,14651,,138,,146,,-8,410,,26,384,462,,37,2,425,-52,-57,,14594
280676,4000,Female,GM1586,Oost Gelre,2014JJ00,2014,14594,,125,,137,,-12,454,,20,434,469,,34,-2,435,-15,-27,,14567
280677,4000,Female,GM1586,Oost Gelre,2015JJ00,2015,14567,,143,,140,,3,501,,38,463,474,,23,1,451,27,32,,14599
280678,4000,Female,GM1586,Oost Gelre,2016JJ00,2016,14599,,114,,145,,-31,558,,44,514,488,,21,-1,467,70,38,,14637
280679,4000,Female,GM1586,Oost Gelre,2017JJ00,2017,14637,,131,,151,,-20,622,,43,579,589,,26,-1,563,33,11,,14648
280680,4000,Female,GM1586,Oost Gelre,2018JJ00,2018,14648,,152,,147,,5,545,,36,509,560,,29,-5,531,-15,-9,,14639
280681,4000,Female,GM1586,Oost Gelre,2019JJ00,2019,14639,,137,,163,,-26,526,,41,485,524,,27,-5,497,2,-25,,14614
280682,4000,Female,GM1586,Oost Gelre,2020JJ00,2020,14614,,136,,164,,-28,520,,33,487,503,,20,-4,483,17,-13,,14601
280683,4000,Female,GM1586,Oost Gelre,2021JJ00,2021,14601,,140,,162,,-22,501,,31,470,452,,23,-5,429,49,27,,14628
280684,4000,Female,GM1586,Oost Gelre,2022JJ00,2022,14628,,126,,148,,-22,653,,131,522,474,,52,-4,422,179,157,,14785
280685,4000,Female,GM1586,Oost Gelre,2023JJ00,2023,14785,,152,,176,,-24,658,,68,590,504,,33,-7,471,154,128,,14913
281248,4000,Female,GM0826,Oosterhout,2012JJ00,2012,27398,,238,,254,,-16,883,,113,770,1035,,111,-19,924,-152,-169,,27229
281249,4000,Female,GM0826,Oosterhout,2013JJ00,2013,27229,,245,,211,,34,1012,,127,885,998,,118,-10,880,14,50,,27279
281250,4000,Female,GM0826,Oosterhout,2014JJ00,2014,27279,,230,,253,,-23,1052,,120,932,999,,119,-27,880,53,29,,27308
281251,4000,Female,GM0826,Oosterhout,2015JJ00,2015,27308,,233,,245,,-12,1208,,144,1064,1095,,104,-10,991,113,98,,27406
281252,4000,Female,GM0826,Oosterhout,2016JJ00,2016,27406,,243,,255,,-12,1437,,153,1284,1100,,99,-10,1001,337,326,,27732
281253,4000,Female,GM0826,Oosterhout,2017JJ00,2017,27732,,247,,281,,-34,1439,,134,1305,1189,,128,-29,1061,250,213,,27945
281254,4000,Female,GM0826,Oosterhout,2018JJ00,2018,27945,,247,,261,,-14,1404,,165,1239,1157,,95,-12,1062,247,232,,28177
281255,4000,Female,GM0826,Oosterhout,2019JJ00,2019,28177,,244,,243,,1,1313,,172,1141,1125,,97,-22,1028,188,188,,28365
281256,4000,Female,GM0826,Oosterhout,2020JJ00,2020,28365,,272,,274,,-2,1301,,158,1143,1184,,112,-19,1072,117,114,,28479
281257,4000,Female,GM0826,Oosterhout,2021JJ00,2021,28479,,279,,296,,-17,1338,,193,1145,1142,,91,-9,1051,196,181,,28660
281258,4000,Female,GM0826,Oosterhout,2022JJ00,2022,28660,,277,,328,,-51,1671,,426,1245,1104,,200,-16,904,567,518,,29178
281259,4000,Female,GM0826,Oosterhout,2023JJ00,2023,29178,,295,,262,,33,1440,,224,1216,1162,,175,-27,987,278,309,,29487
281412,4000,Female,GM0580,Oostflakkee,2012JJ00,2012,5204,,45,,35,,10,142,,23,119,179,,7,2,172,-37,-30,,5174
281658,4000,Female,GM0085,Ooststellingwerf,2012JJ00,2012,12918,,102,,122,,-20,472,,28,444,470,,26,-5,444,2,-15,,12903
281659,4000,Female,GM0085,Ooststellingwerf,2013JJ00,2013,12903,,113,,130,,-17,460,,31,429,532,,29,-1,503,-72,-90,,12813
281660,4000,Female,GM0085,Ooststellingwerf,2014JJ00,2014,12813,,107,,123,,-16,551,,30,521,530,,30,-2,500,21,5,,12818
281661,4000,Female,GM0085,Ooststellingwerf,2015JJ00,2015,12818,,111,,164,,-53,547,,28,519,508,,30,4,478,39,-13,,12805
281662,4000,Female,GM0085,Ooststellingwerf,2016JJ00,2016,12805,,86,,160,,-74,630,,25,605,597,,31,-3,566,33,-42,,12763
281663,4000,Female,GM0085,Ooststellingwerf,2017JJ00,2017,12763,,104,,184,,-80,623,,28,595,590,,31,-3,559,33,-47,,12716
281664,4000,Female,GM0085,Ooststellingwerf,2018JJ00,2018,12716,,94,,171,,-77,623,,39,584,563,,23,-1,540,60,-19,,12697
281665,4000,Female,GM0085,Ooststellingwerf,2019JJ00,2019,12697,,100,,154,,-54,585,,32,553,557,,23,-1,534,28,-24,,12673
281666,4000,Female,GM0085,Ooststellingwerf,2020JJ00,2020,12673,,102,,133,,-31,623,,43,580,571,,15,-1,556,52,21,,12694
281667,4000,Female,GM0085,Ooststellingwerf,2021JJ00,2021,12694,,108,,152,,-44,684,,34,650,509,,16,1,493,175,129,,12823
281668,4000,Female,GM0085,Ooststellingwerf,2022JJ00,2022,12823,,93,,185,,-92,748,,167,581,567,,68,-21,499,181,89,,12912
281669,4000,Female,GM0085,Ooststellingwerf,2023JJ00,2023,12912,,78,,175,,-97,683,,105,578,587,,71,-21,516,96,-2,,12910
281822,4000,Female,GM0431,Oostzaan,2012JJ00,2012,4648,,34,,25,,9,175,,13,162,156,,11,3,145,19,28,,4676
281823,4000,Female,GM0431,Oostzaan,2013JJ00,2013,4676,,32,,33,,-1,126,,11,115,129,,9,0,120,-3,-4,,4672
281824,4000,Female,GM0431,Oostzaan,2014JJ00,2014,4672,,38,,35,,3,209,,11,198,183,,14,-3,169,26,30,,4702
281825,4000,Female,GM0431,Oostzaan,2015JJ00,2015,4702,,34,,29,,5,293,,12,281,130,,16,-4,114,163,167,,4869
281826,4000,Female,GM0431,Oostzaan,2016JJ00,2016,4869,,47,,40,,7,235,,15,220,189,,11,3,178,46,51,,4920
281827,4000,Female,GM0431,Oostzaan,2017JJ00,2017,4920,,35,,48,,-13,225,,12,213,187,,16,1,171,38,26,,4946
281828,4000,Female,GM0431,Oostzaan,2018JJ00,2018,4946,,49,,44,,5,224,,19,205,208,,8,-1,200,16,21,,4967
281829,4000,Female,GM0431,Oostzaan,2019JJ00,2019,4967,,47,,42,,5,196,,14,182,235,,9,0,226,-39,-35,,4932
281830,4000,Female,GM0431,Oostzaan,2020JJ00,2020,4932,,34,,45,,-11,223,,19,204,222,,16,-3,206,1,-10,,4922
281831,4000,Female,GM0431,Oostzaan,2021JJ00,2021,4922,,49,,50,,-1,201,,12,189,225,,13,-2,212,-24,-24,,4898
281832,4000,Female,GM0431,Oostzaan,2022JJ00,2022,4898,,42,,45,,-3,254,,43,211,196,,23,-3,173,58,55,,4953
281833,4000,Female,GM0431,Oostzaan,2023JJ00,2023,4953,,37,,46,,-9,247,,51,196,266,,22,1,244,-19,-27,,4926
282232,4000,Female,GM0432,Opmeer,2012JJ00,2012,5622,,56,,37,,19,193,,28,165,181,,10,5,171,12,31,,5653
282233,4000,Female,GM0432,Opmeer,2013JJ00,2013,5653,,34,,49,,-15,200,,20,180,218,,15,2,203,-18,-33,,5620
282234,4000,Female,GM0432,Opmeer,2014JJ00,2014,5620,,41,,37,,4,191,,19,172,214,,13,0,201,-23,-19,,5601
282235,4000,Female,GM0432,Opmeer,2015JJ00,2015,5601,,37,,36,,1,254,,30,224,244,,8,0,236,10,11,,5612
282236,4000,Female,GM0432,Opmeer,2016JJ00,2016,5612,,51,,49,,2,245,,18,227,231,,14,-2,217,14,16,,5628
282237,4000,Female,GM0432,Opmeer,2017JJ00,2017,5628,,52,,64,,-12,284,,38,246,228,,20,0,208,56,45,,5673
282238,4000,Female,GM0432,Opmeer,2018JJ00,2018,5673,,56,,51,,5,366,,86,280,249,,17,-2,232,117,121,,5794
282239,4000,Female,GM0432,Opmeer,2019JJ00,2019,5794,,62,,42,,20,308,,78,230,299,,59,-16,240,9,29,,5823
282240,4000,Female,GM0432,Opmeer,2020JJ00,2020,5823,,60,,50,,10,354,,53,301,290,,54,-14,236,64,74,,5897
282241,4000,Female,GM0432,Opmeer,2021JJ00,2021,5897,,56,,42,,14,340,,50,290,300,,53,-11,247,40,52,,5949
282242,4000,Female,GM0432,Opmeer,2022JJ00,2022,5949,,63,,62,,1,362,,103,259,318,,79,-11,239,44,46,,5995
282243,4000,Female,GM0432,Opmeer,2023JJ00,2023,5995,,53,,56,,-3,347,,92,255,336,,92,-8,244,11,8,,6003
282396,4000,Female,GM0086,Opsterland,2012JJ00,2012,15007,,144,,143,,1,609,,38,571,655,,34,-8,621,-46,-46,,14961
282397,4000,Female,GM0086,Opsterland,2013JJ00,2013,14961,,112,,127,,-15,635,,40,595,629,,34,-10,595,6,-11,,14950
282398,4000,Female,GM0086,Opsterland,2014JJ00,2014,14950,,136,,125,,11,612,,47,565,660,,32,-10,628,-48,-39,,14911
282399,4000,Female,GM0086,Opsterland,2015JJ00,2015,14911,,133,,134,,-1,677,,48,629,667,,36,-6,631,10,7,,14918
282400,4000,Female,GM0086,Opsterland,2016JJ00,2016,14918,,100,,145,,-45,705,,42,663,739,,32,-4,707,-34,-79,,14839
282401,4000,Female,GM0086,Opsterland,2017JJ00,2017,14839,,109,,149,,-40,773,,42,731,771,,41,-10,730,2,-37,,14802
282402,4000,Female,GM0086,Opsterland,2018JJ00,2018,14802,,116,,149,,-33,774,,30,744,770,,43,-4,727,4,-29,,14773
282403,4000,Female,GM0086,Opsterland,2019JJ00,2019,14773,,139,,142,,-3,777,,51,726,738,,26,-2,712,39,35,,14808
282404,4000,Female,GM0086,Opsterland,2020JJ00,2020,14808,,127,,147,,-20,766,,47,719,695,,16,-4,679,71,50,,14858
282405,4000,Female,GM0086,Opsterland,2021JJ00,2021,14858,,129,,148,,-19,716,,32,684,732,,46,-2,686,-16,-34,,14824
282406,4000,Female,GM0086,Opsterland,2022JJ00,2022,14824,,127,,149,,-22,824,,147,677,664,,62,-12,602,160,138,,14962
282407,4000,Female,GM0086,Opsterland,2023JJ00,2023,14962,,102,,133,,-31,687,,41,646,648,,35,-5,613,39,5,,14967
282478,4000,Female,GM0828,Oss,2012JJ00,2012,42359,,431,,327,,104,1290,,236,1054,1274,,180,-37,1094,16,122,,42481
282479,4000,Female,GM0828,Oss,2013JJ00,2013,42481,,388,,333,,55,1282,,228,1054,1301,,193,-27,1108,-19,37,,42518
282480,4000,Female,GM0828,Oss,2014JJ00,2014,42518,,409,,317,,92,1382,,265,1117,1424,,200,-30,1224,-42,53,,42571
282481,4000,Female,GM0828,Oss,2015JJ00,2015,44864,,462,,382,,80,1461,,246,1215,1485,,209,-42,1276,-24,60,,44924
282482,4000,Female,GM0828,Oss,2016JJ00,2016,44924,,400,,352,,48,1568,,300,1268,1513,,186,-18,1327,55,102,,45026
282483,4000,Female,GM0828,Oss,2017JJ00,2017,45026,,451,,352,,99,1785,,359,1426,1519,,192,-39,1327,266,361,,45387
282484,4000,Female,GM0828,Oss,2018JJ00,2018,45387,,418,,381,,37,1693,,359,1334,1556,,199,-45,1357,137,173,,45560
282485,4000,Female,GM0828,Oss,2019JJ00,2019,45560,,411,,360,,51,1760,,432,1328,1662,,226,-52,1436,98,142,,45702
282486,4000,Female,GM0828,Oss,2020JJ00,2020,45702,,413,,472,,-59,1807,,399,1408,1486,,166,-18,1320,321,260,,45962
282487,4000,Female,GM0828,Oss,2021JJ00,2021,45962,,459,,417,,42,1994,,411,1583,1649,,253,-23,1396,345,376,,46338
282488,4000,Female,GM0828,Oss,2022JJ00,2022,46338,,416,,414,,2,2066,,631,1435,1597,,253,-40,1344,469,468,,46806
282489,4000,Female,GM0828,Oss,2023JJ00,2023,46806,,411,,387,,24,1985,,462,1523,1878,,346,-83,1532,107,125,,46931
283052,4000,Female,GM0584,Oud-Beijerland,2012JJ00,2012,11911,,101,,98,,3,437,,24,413,391,,20,0,371,46,49,,11960
283053,4000,Female,GM0584,Oud-Beijerland,2013JJ00,2013,11960,,103,,87,,16,501,,34,467,356,,16,1,340,145,161,,12121
283054,4000,Female,GM0584,Oud-Beijerland,2014JJ00,2014,12121,,103,,102,,1,411,,36,375,423,,32,-1,391,-12,-10,,12111
283055,4000,Female,GM0584,Oud-Beijerland,2015JJ00,2015,12111,,117,,119,,-2,522,,31,491,466,,20,-2,446,56,54,,12165
283056,4000,Female,GM0584,Oud-Beijerland,2016JJ00,2016,12165,,98,,103,,-5,554,,31,523,484,,29,-5,455,70,66,,12231
283057,4000,Female,GM0584,Oud-Beijerland,2017JJ00,2017,12231,,106,,96,,10,589,,46,543,468,,23,-3,445,121,131,,12362
283058,4000,Female,GM0584,Oud-Beijerland,2018JJ00,2018,12362,,92,,108,,-16,517,,37,480,466,,26,-3,440,51,60,,12422
283216,4000,Female,GM1509,Oude IJsselstreek,2012JJ00,2012,19947,,162,,249,,-87,661,,52,609,639,,61,-10,578,22,-66,,19881
283217,4000,Female,GM1509,Oude IJsselstreek,2013JJ00,2013,19881,,143,,237,,-94,661,,53,608,682,,55,-6,627,-21,-115,,19766
283218,4000,Female,GM1509,Oude IJsselstreek,2014JJ00,2014,19766,,158,,202,,-44,665,,57,608,680,,58,-3,622,-15,-60,,19706
283219,4000,Female,GM1509,Oude IJsselstreek,2015JJ00,2015,19706,,153,,231,,-78,802,,82,720,635,,60,-12,575,167,88,,19794
283220,4000,Female,GM1509,Oude IJsselstreek,2016JJ00,2016,19794,,114,,236,,-122,739,,79,660,711,,65,-3,646,28,-92,,19702
283221,4000,Female,GM1509,Oude IJsselstreek,2017JJ00,2017,19702,,122,,234,,-112,820,,50,770,756,,61,-2,695,64,-48,,19654
283222,4000,Female,GM1509,Oude IJsselstreek,2018JJ00,2018,19654,,137,,253,,-116,771,,87,684,687,,55,-2,632,84,-32,,19622
283223,4000,Female,GM1509,Oude IJsselstreek,2019JJ00,2019,19622,,136,,261,,-125,791,,78,713,771,,50,-10,721,20,-105,,19517
283224,4000,Female,GM1509,Oude IJsselstreek,2020JJ00,2020,19517,,152,,262,,-110,781,,70,711,699,,52,-4,647,82,-27,,19490
283225,4000,Female,GM1509,Oude IJsselstreek,2021JJ00,2021,19490,,133,,237,,-104,813,,70,743,683,,55,-4,628,130,22,,19512
283226,4000,Female,GM1509,Oude IJsselstreek,2022JJ00,2022,19512,,136,,285,,-149,879,,175,704,613,,73,-8,540,266,118,,19630
283227,4000,Female,GM1509,Oude IJsselstreek,2023JJ00,2023,19630,,131,,256,,-125,822,,128,694,833,,80,-12,753,-11,-135,,19495
283872,4000,Female,GM0437,Ouder-Amstel,2012JJ00,2012,6780,,53,,75,,-22,351,,40,311,313,,48,-5,265,38,15,,6795
283873,4000,Female,GM0437,Ouder-Amstel,2013JJ00,2013,6795,,64,,64,,0,380,,55,325,353,,50,-7,303,27,25,,6820
283874,4000,Female,GM0437,Ouder-Amstel,2014JJ00,2014,6820,,50,,68,,-18,413,,37,376,364,,37,0,327,49,32,,6852
283875,4000,Female,GM0437,Ouder-Amstel,2015JJ00,2015,6852,,62,,71,,-9,451,,63,388,411,,46,1,365,40,31,,6883
283876,4000,Female,GM0437,Ouder-Amstel,2016JJ00,2016,6883,,66,,66,,0,464,,77,387,481,,58,-6,423,-17,-18,,6865
283877,4000,Female,GM0437,Ouder-Amstel,2017JJ00,2017,6865,,44,,50,,-6,469,,70,399,444,,55,-2,389,25,21,,6886
283878,4000,Female,GM0437,Ouder-Amstel,2018JJ00,2018,6886,,56,,56,,0,643,,75,568,415,,47,-2,368,228,228,,7114
283879,4000,Female,GM0437,Ouder-Amstel,2019JJ00,2019,7114,,80,,51,,29,513,,89,424,486,,64,1,422,27,56,,7170
283880,4000,Female,GM0437,Ouder-Amstel,2020JJ00,2020,7170,,71,,42,,29,551,,67,484,534,,70,-1,464,17,45,,7215
283881,4000,Female,GM0437,Ouder-Amstel,2021JJ00,2021,7215,,70,,70,,0,551,,65,486,510,,50,-4,460,41,41,,7256
283882,4000,Female,GM0437,Ouder-Amstel,2022JJ00,2022,7256,,56,,60,,-4,617,,168,449,557,,91,-1,466,60,53,,7309
283883,4000,Female,GM0437,Ouder-Amstel,2023JJ00,2023,7309,,51,,78,,-27,720,,169,551,615,,85,-7,530,105,76,,7385
283954,4000,Female,GM0644,Ouderkerk,2012JJ00,2012,4074,,42,,30,,12,191,,8,183,163,,7,-1,156,28,42,,4116
283955,4000,Female,GM0644,Ouderkerk,2013JJ00,2013,4116,,47,,25,,22,155,,14,141,143,,3,2,140,12,34,,4150
283956,4000,Female,GM0644,Ouderkerk,2014JJ00,2014,4150,,39,,27,,12,154,,6,148,154,,5,0,149,0,8,,4158
284200,4000,Female,GM0589,Oudewater,2012JJ00,2012,4999,,65,,52,,13,170,,19,151,164,,13,-3,151,6,19,,5018
284201,4000,Female,GM0589,Oudewater,2013JJ00,2013,5018,,50,,48,,2,143,,13,130,147,,13,-2,134,-4,-2,,5016
284202,4000,Female,GM0589,Oudewater,2014JJ00,2014,5016,,43,,36,,7,192,,24,168,165,,19,-1,146,27,34,,5050
284203,4000,Female,GM0589,Oudewater,2015JJ00,2015,5050,,53,,58,,-5,239,,17,222,165,,19,-1,146,74,68,,5118
284204,4000,Female,GM0589,Oudewater,2016JJ00,2016,5118,,59,,46,,13,260,,26,234,193,,15,-3,178,67,80,,5198
284205,4000,Female,GM0589,Oudewater,2017JJ00,2017,5198,,49,,46,,3,211,,22,189,236,,19,-5,217,-25,-19,,5179
284206,4000,Female,GM0589,Oudewater,2018JJ00,2018,5179,,45,,46,,-1,200,,29,171,194,,17,0,177,6,4,,5183
284207,4000,Female,GM0589,Oudewater,2019JJ00,2019,5183,,50,,46,,4,179,,21,158,182,,20,-4,162,-3,1,,5184
284208,4000,Female,GM0589,Oudewater,2020JJ00,2020,5184,,46,,50,,-4,157,,13,144,212,,9,0,203,-55,-58,,5126
284209,4000,Female,GM0589,Oudewater,2021JJ00,2021,5126,,45,,46,,-1,196,,17,179,193,,7,1,186,3,2,,5128
284210,4000,Female,GM0589,Oudewater,2022JJ00,2022,5128,,38,,39,,-1,245,,71,174,215,,15,-1,200,30,29,,5157
284211,4000,Female,GM0589,Oudewater,2023JJ00,2023,5157,,37,,60,,-23,211,,28,183,203,,19,-5,184,8,-14,,5143
284610,4000,Female,GM1734,Overbetuwe,2012JJ00,2012,23275,,224,,148,,76,1053,,72,981,957,,64,-8,893,96,172,,23447
284611,4000,Female,GM1734,Overbetuwe,2013JJ00,2013,23447,,217,,161,,56,975,,81,894,994,,83,-21,911,-19,39,,23486
284612,4000,Female,GM1734,Overbetuwe,2014JJ00,2014,23486,,229,,148,,81,916,,65,851,955,,61,2,894,-39,45,,23531
284613,4000,Female,GM1734,Overbetuwe,2015JJ00,2015,23531,,239,,164,,75,1108,,85,1023,1064,,73,-4,991,44,121,,23652
284614,4000,Female,GM1734,Overbetuwe,2016JJ00,2016,23652,,227,,180,,47,1283,,89,1194,1148,,64,4,1084,135,181,,23833
284615,4000,Female,GM1734,Overbetuwe,2017JJ00,2017,23833,,241,,143,,98,1225,,72,1153,1246,,61,0,1185,-21,74,,23907
284616,4000,Female,GM1734,Overbetuwe,2018JJ00,2018,23907,,210,,165,,45,1128,,83,1045,1177,,56,-5,1121,-49,-2,,23905
284617,4000,Female,GM1734,Overbetuwe,2019JJ00,2019,23905,,253,,170,,83,1195,,81,1114,1105,,52,0,1053,90,172,,24077
284618,4000,Female,GM1734,Overbetuwe,2020JJ00,2020,24077,,221,,204,,17,1269,,70,1199,1090,,46,2,1044,179,197,,24274
284619,4000,Female,GM1734,Overbetuwe,2021JJ00,2021,24274,,236,,186,,50,1110,,82,1028,1093,,58,-2,1035,17,67,,24341
284620,4000,Female,GM1734,Overbetuwe,2022JJ00,2022,24341,,229,,199,,30,1334,,234,1100,1177,,112,-4,1065,157,188,,24529
284621,4000,Female,GM1734,Overbetuwe,2023JJ00,2023,24529,,212,,150,,62,1198,,120,1078,1130,,65,-6,1065,68,127,,24656
285020,4000,Female,GM0590,Papendrecht,2012JJ00,2012,16284,,165,,116,,49,617,,54,563,618,,41,-2,577,-1,45,,16329
285021,4000,Female,GM0590,Papendrecht,2013JJ00,2013,16329,,141,,121,,20,532,,46,486,559,,50,-10,509,-27,-4,,16325
285022,4000,Female,GM0590,Papendrecht,2014JJ00,2014,16325,,159,,121,,38,550,,53,497,574,,41,2,533,-24,15,,16340
285023,4000,Female,GM0590,Papendrecht,2015JJ00,2015,16340,,139,,141,,-2,633,,52,581,600,,38,4,562,33,31,,16371
285024,4000,Female,GM0590,Papendrecht,2016JJ00,2016,16371,,147,,127,,20,639,,51,588,607,,51,-15,556,32,50,,16421
285025,4000,Female,GM0590,Papendrecht,2017JJ00,2017,16421,,141,,133,,8,735,,54,681,760,,42,-6,718,-25,-17,,16404
285026,4000,Female,GM0590,Papendrecht,2018JJ00,2018,16404,,146,,147,,-1,726,,75,651,737,,49,-16,688,-11,-12,,16392
285027,4000,Female,GM0590,Papendrecht,2019JJ00,2019,16392,,159,,133,,26,669,,65,604,751,,61,-14,690,-82,-55,,16337
285028,4000,Female,GM0590,Papendrecht,2020JJ00,2020,16337,,134,,146,,-12,776,,50,726,730,,33,0,697,46,33,,16370
285029,4000,Female,GM0590,Papendrecht,2021JJ00,2021,16370,,149,,145,,4,748,,53,695,753,,39,-4,714,-5,1,,16371
285030,4000,Female,GM0590,Papendrecht,2022JJ00,2022,16371,,132,,158,,-26,765,,141,624,711,,85,-12,626,54,29,,16400
285031,4000,Female,GM0590,Papendrecht,2023JJ00,2023,16400,,148,,160,,-12,688,,78,610,750,,56,-6,694,-62,-80,,16320
285102,4000,Female,GM1894,Peel en Maas,2012JJ00,2012,21301,,203,,139,,64,530,,96,434,572,,58,-3,514,-42,23,,21324
285103,4000,Female,GM1894,Peel en Maas,2013JJ00,2013,21324,,178,,178,,0,657,,176,481,621,,73,-7,548,36,38,,21362
285104,4000,Female,GM1894,Peel en Maas,2014JJ00,2014,21362,,180,,165,,15,703,,163,540,703,,97,-6,606,0,16,,21378
285105,4000,Female,GM1894,Peel en Maas,2015JJ00,2015,21378,,166,,174,,-8,687,,153,534,729,,125,-16,604,-42,-50,,21328
285106,4000,Female,GM1894,Peel en Maas,2016JJ00,2016,21328,,179,,182,,-3,704,,126,578,678,,107,-12,571,26,20,,21348
285107,4000,Female,GM1894,Peel en Maas,2017JJ00,2017,21348,,163,,177,,-14,694,,106,588,701,,73,-8,628,-7,-24,,21324
285108,4000,Female,GM1894,Peel en Maas,2018JJ00,2018,21324,,191,,203,,-12,668,,116,552,666,,78,-12,588,2,-10,,21314
285109,4000,Female,GM1894,Peel en Maas,2019JJ00,2019,21314,,176,,188,,-12,724,,122,602,663,,62,3,601,61,50,,21364
285110,4000,Female,GM1894,Peel en Maas,2020JJ00,2020,21364,,166,,237,,-71,906,,239,667,736,,142,-2,594,170,99,,21463
285111,4000,Female,GM1894,Peel en Maas,2021JJ00,2021,21463,,196,,202,,-6,940,,287,653,710,,153,-22,557,230,225,,21688
285112,4000,Female,GM1894,Peel en Maas,2022JJ00,2022,21688,,203,,193,,10,1340,,675,665,822,,246,-45,576,518,528,,22216
285113,4000,Female,GM1894,Peel en Maas,2023JJ00,2023,22216,,180,,231,,-51,1257,,594,663,1056,,311,-58,745,201,149,,22365
285266,4000,Female,GM0765,Pekela,2012JJ00,2012,6416,,66,,70,,-4,328,,45,283,371,,16,-5,355,-43,-45,,6371
285267,4000,Female,GM0765,Pekela,2013JJ00,2013,6371,,68,,97,,-29,332,,103,229,360,,14,-2,346,-28,-55,,6316
285268,4000,Female,GM0765,Pekela,2014JJ00,2014,6316,,60,,68,,-8,402,,123,279,447,,9,1,438,-45,-50,,6266
285269,4000,Female,GM0765,Pekela,2015JJ00,2015,6266,,63,,72,,-9,441,,135,306,438,,14,-5,424,3,-5,,6261
285270,4000,Female,GM0765,Pekela,2016JJ00,2016,6261,,65,,77,,-12,389,,69,320,461,,15,0,446,-72,-85,,6176
285271,4000,Female,GM0765,Pekela,2017JJ00,2017,6176,,51,,72,,-21,405,,45,360,492,,43,-34,449,-87,-105,,6071
285272,4000,Female,GM0765,Pekela,2018JJ00,2018,6071,,42,,65,,-23,314,,15,299,319,,5,1,314,-5,-27,,6044
285273,4000,Female,GM0765,Pekela,2019JJ00,2019,6044,,55,,45,,10,355,,23,332,356,,11,-1,345,-1,8,,6052
285274,4000,Female,GM0765,Pekela,2020JJ00,2020,6052,,51,,56,,-5,344,,23,321,366,,22,-3,344,-22,-27,,6025
285275,4000,Female,GM0765,Pekela,2021JJ00,2021,6025,,55,,79,,-24,383,,9,374,343,,10,-3,333,40,15,,6040
285276,4000,Female,GM0765,Pekela,2022JJ00,2022,6040,,47,,78,,-31,516,,173,343,354,,21,-11,333,162,132,,6172
285277,4000,Female,GM0765,Pekela,2023JJ00,2023,6172,,51,,84,,-33,503,,182,321,401,,69,-15,332,102,69,,6241
285676,4000,Female,GM1926,Pijnacker-Nootdorp,2012JJ00,2012,25080,,287,,131,,156,1098,,132,966,1028,,127,1,901,70,225,,25305
285677,4000,Female,GM1926,Pijnacker-Nootdorp,2013JJ00,2013,25305,,295,,137,,158,1213,,109,1104,1054,,120,2,934,159,316,,25621
285678,4000,Female,GM1926,Pijnacker-Nootdorp,2014JJ00,2014,25621,,255,,134,,121,1164,,132,1032,1190,,101,-10,1089,-26,98,,25719
285679,4000,Female,GM1926,Pijnacker-Nootdorp,2015JJ00,2015,25719,,256,,151,,105,1470,,130,1340,1234,,121,-6,1113,236,347,,26066
285680,4000,Female,GM1926,Pijnacker-Nootdorp,2016JJ00,2016,26066,,247,,160,,87,1521,,161,1360,1232,,126,-3,1106,289,375,,26441
285681,4000,Female,GM1926,Pijnacker-Nootdorp,2017JJ00,2017,26441,,245,,153,,92,1696,,116,1580,1317,,99,-3,1218,379,470,,26911
285682,4000,Female,GM1926,Pijnacker-Nootdorp,2018JJ00,2018,26911,,235,,141,,94,1545,,133,1412,1235,,117,-10,1118,310,403,,27314
285683,4000,Female,GM1926,Pijnacker-Nootdorp,2019JJ00,2019,27314,,260,,160,,100,1579,,149,1430,1201,,93,4,1108,378,474,,27788
285684,4000,Female,GM1926,Pijnacker-Nootdorp,2020JJ00,2020,27788,,275,,176,,99,1445,,125,1320,1360,,96,-10,1264,85,182,,27970
285685,4000,Female,GM1926,Pijnacker-Nootdorp,2021JJ00,2021,27970,,279,,196,,83,1726,,128,1598,1346,,107,-4,1239,380,464,,28434
285686,4000,Female,GM1926,Pijnacker-Nootdorp,2022JJ00,2022,28434,,244,,183,,61,1837,,401,1436,1329,,142,0,1187,508,564,,28998
285687,4000,Female,GM1926,Pijnacker-Nootdorp,2023JJ00,2023,28998,,276,,165,,111,1440,,238,1202,1431,,200,-17,1231,9,120,,29118
286250,4000,Female,GM0439,Purmerend,2012JJ00,2012,40535,,361,,397,,-36,1363,,210,1153,1266,,173,-35,1093,97,61,,40596
286251,4000,Female,GM0439,Purmerend,2013JJ00,2013,40596,,356,,358,,-2,1353,,178,1175,1246,,157,-11,1089,107,102,,40698
286252,4000,Female,GM0439,Purmerend,2014JJ00,2014,40698,,344,,364,,-20,1386,,206,1180,1333,,186,-35,1147,53,34,,40732
286253,4000,Female,GM0439,Purmerend,2015JJ00,2015,40732,,328,,359,,-31,1626,,201,1425,1415,,177,-25,1238,211,177,,40909
286254,4000,Female,GM0439,Purmerend,2016JJ00,2016,40909,,366,,389,,-23,1619,,212,1407,1546,,143,-20,1403,73,46,,40955
286255,4000,Female,GM0439,Purmerend,2017JJ00,2017,40955,,339,,369,,-30,1617,,227,1390,1538,,155,-20,1383,79,42,,40997
286256,4000,Female,GM0439,Purmerend,2018JJ00,2018,40997,,347,,407,,-60,1724,,254,1470,1609,,188,-35,1421,115,55,,41052
286257,4000,Female,GM0439,Purmerend,2019JJ00,2019,41052,,364,,381,,-17,2113,,259,1854,1540,,137,-13,1403,573,555,,41607
286258,4000,Female,GM0439,Purmerend,2020JJ00,2020,41607,,390,,428,,-38,1957,,231,1726,1654,,153,-32,1501,303,259,,41866
286259,4000,Female,GM0439,Purmerend,2021JJ00,2021,41866,,392,,493,,-101,1818,,190,1628,1880,,156,-14,1724,-62,-159,,41707
286260,4000,Female,GM0439,Purmerend,2022JJ00,2022,47073,,444,,450,,-6,2553,,619,1934,1681,,239,-22,1442,872,861,,47934
286261,4000,Female,GM0439,Purmerend,2023JJ00,2023,47934,,419,,436,,-17,2343,,446,1897,1752,,273,-32,1479,591,573,,48507
286414,4000,Female,GM0273,Putten,2012JJ00,2012,12027,,122,,84,,38,407,,63,344,403,,27,-1,376,4,43,,12070
286415,4000,Female,GM0273,Putten,2013JJ00,2013,12070,,129,,94,,35,389,,54,335,471,,62,-3,409,-82,-50,,12020
286416,4000,Female,GM0273,Putten,2014JJ00,2014,12020,,129,,76,,53,650,,208,442,482,,60,2,422,168,223,,12243
286417,4000,Female,GM0273,Putten,2015JJ00,2015,12243,,125,,103,,22,638,,156,482,537,,86,-20,451,101,124,,12367
286418,4000,Female,GM0273,Putten,2016JJ00,2016,12367,,119,,109,,10,501,,77,424,577,,117,-23,460,-76,-68,,12299
286419,4000,Female,GM0273,Putten,2017JJ00,2017,12299,,120,,115,,5,502,,74,428,534,,73,-12,461,-32,-27,,12272
286420,4000,Female,GM0273,Putten,2018JJ00,2018,12272,,128,,113,,15,408,,52,356,488,,64,-15,424,-80,-66,,12206
286421,4000,Female,GM0273,Putten,2019JJ00,2019,12206,,111,,102,,9,464,,55,409,510,,49,-5,461,-46,-35,,12171
286422,4000,Female,GM0273,Putten,2020JJ00,2020,12171,,122,,116,,6,554,,49,505,454,,46,-7,408,100,106,,12277
286423,4000,Female,GM0273,Putten,2021JJ00,2021,12277,,115,,118,,-3,558,,52,506,442,,35,-5,407,116,115,,12392
286424,4000,Female,GM0273,Putten,2022JJ00,2022,12392,,120,,148,,-28,571,,120,451,403,,48,-6,355,168,140,,12532
286425,4000,Female,GM0273,Putten,2023JJ00,2023,12532,,119,,125,,-6,497,,78,419,447,,62,-8,385,50,45,,12577
286578,4000,Female,GM0177,Raalte,2012JJ00,2012,18275,,144,,157,,-13,523,,38,485,607,,25,3,582,-84,-97,,18178
286579,4000,Female,GM0177,Raalte,2013JJ00,2013,18178,,154,,162,,-8,572,,37,535,567,,34,-4,533,5,-4,,18174
286580,4000,Female,GM0177,Raalte,2014JJ00,2014,18174,,178,,154,,24,586,,50,536,544,,27,1,517,42,66,,18240
286581,4000,Female,GM0177,Raalte,2015JJ00,2015,18240,,140,,159,,-19,648,,23,625,595,,46,0,549,53,34,,18274
286582,4000,Female,GM0177,Raalte,2016JJ00,2016,18274,,172,,174,,-2,699,,53,646,612,,29,4,583,87,84,,18358
286583,4000,Female,GM0177,Raalte,2017JJ00,2017,18358,,178,,167,,11,749,,29,720,598,,27,-1,571,151,162,,18520
286584,4000,Female,GM0177,Raalte,2018JJ00,2018,18520,,168,,197,,-29,782,,52,730,613,,30,-4,583,169,138,,18658
286585,4000,Female,GM0177,Raalte,2019JJ00,2019,18658,,185,,186,,-1,702,,75,627,574,,23,-2,551,128,127,,18785
286586,4000,Female,GM0177,Raalte,2020JJ00,2020,18785,,163,,197,,-34,749,,46,703,610,,27,-1,583,139,105,,18890
286587,4000,Female,GM0177,Raalte,2021JJ00,2021,18890,,170,,198,,-28,740,,61,679,581,,46,-4,535,159,131,,19021
286588,4000,Female,GM0177,Raalte,2022JJ00,2022,19021,,173,,189,,-16,776,,197,579,580,,62,2,518,196,174,,19195
286589,4000,Female,GM0177,Raalte,2023JJ00,2023,19195,,147,,215,,-68,694,,110,584,710,,86,-4,624,-16,-84,,19111
287152,4000,Female,GM0703,Reimerswaal,2012JJ00,2012,10802,,156,,75,,81,423,,129,294,432,,51,-21,381,-9,81,,10883
287153,4000,Female,GM0703,Reimerswaal,2013JJ00,2013,10883,,147,,84,,63,411,,129,282,443,,81,-19,362,-32,32,,10915
287154,4000,Female,GM0703,Reimerswaal,2014JJ00,2014,10915,,153,,84,,69,415,,111,304,398,,62,-3,336,17,85,,11000
287155,4000,Female,GM0703,Reimerswaal,2015JJ00,2015,11000,,154,,76,,78,423,,114,309,429,,76,1,353,-6,73,,11073
287156,4000,Female,GM0703,Reimerswaal,2016JJ00,2016,11073,,142,,96,,46,481,,139,342,500,,90,-17,410,-19,26,,11099
287157,4000,Female,GM0703,Reimerswaal,2017JJ00,2017,11099,,160,,84,,76,564,,184,380,521,,82,-13,439,43,121,,11220
287158,4000,Female,GM0703,Reimerswaal,2018JJ00,2018,11220,,137,,84,,53,517,,193,324,519,,106,-20,413,-2,54,,11274
287159,4000,Female,GM0703,Reimerswaal,2019JJ00,2019,11274,,135,,77,,58,570,,161,409,610,,155,-10,455,-40,18,,11292
287160,4000,Female,GM0703,Reimerswaal,2020JJ00,2020,11292,,148,,90,,58,528,,131,397,557,,120,-13,437,-29,29,,11321
287161,4000,Female,GM0703,Reimerswaal,2021JJ00,2021,11321,,140,,85,,55,481,,136,345,523,,100,-11,423,-42,11,,11332
287162,4000,Female,GM0703,Reimerswaal,2022JJ00,2022,11332,,155,,88,,67,725,,309,416,580,,165,-15,415,145,213,,11545
287163,4000,Female,GM0703,Reimerswaal,2023JJ00,2023,11545,,130,,86,,44,540,,158,382,575,,137,-16,438,-35,8,,11553
287316,4000,Female,GM0274,Renkum,2012JJ00,2012,16357,,113,,239,,-126,981,,64,917,939,,86,-4,853,42,-83,,16274
287317,4000,Female,GM0274,Renkum,2013JJ00,2013,16274,,117,,221,,-104,1038,,97,941,929,,64,-4,865,109,7,,16281
287318,4000,Female,GM0274,Renkum,2014JJ00,2014,16281,,111,,250,,-139,1094,,98,996,1060,,79,-8,981,34,-103,,16178
287319,4000,Female,GM0274,Renkum,2015JJ00,2015,16178,,94,,218,,-124,1032,,100,932,1021,,54,20,967,11,-108,,16070
287320,4000,Female,GM0274,Renkum,2016JJ00,2016,16070,,113,,227,,-114,1188,,88,1100,1072,,68,-1,1004,116,3,,16073
287321,4000,Female,GM0274,Renkum,2017JJ00,2017,16073,,102,,217,,-115,1159,,83,1076,1102,,50,-2,1052,57,-58,,16015
287322,4000,Female,GM0274,Renkum,2018JJ00,2018,16015,,89,,209,,-120,1061,,79,982,944,,50,-2,894,117,-6,,16009
287323,4000,Female,GM0274,Renkum,2019JJ00,2019,16009,,96,,201,,-105,1088,,91,997,934,,62,-1,872,154,52,,16061
287324,4000,Female,GM0274,Renkum,2020JJ00,2020,16061,,103,,243,,-140,1040,,76,964,901,,53,-3,848,139,0,,16061
287325,4000,Female,GM0274,Renkum,2021JJ00,2021,16061,,89,,204,,-115,1024,,83,941,953,,52,-5,901,71,-41,,16020
287326,4000,Female,GM0274,Renkum,2022JJ00,2022,16020,,110,,254,,-144,978,,177,801,790,,68,0,722,188,45,,16065
287327,4000,Female,GM0274,Renkum,2023JJ00,2023,16065,,78,,226,,-148,986,,107,879,886,,60,-1,826,100,-48,,16017
287398,4000,Female,GM0339,Renswoude,2012JJ00,2012,2427,,37,,9,,28,103,,1,102,109,,2,-1,107,-6,22,,2449
287399,4000,Female,GM0339,Renswoude,2013JJ00,2013,2449,,52,,11,,41,94,,6,88,119,,13,-1,106,-25,16,,2465
287400,4000,Female,GM0339,Renswoude,2014JJ00,2014,2465,,49,,13,,36,113,,16,97,118,,16,-2,102,-5,36,,2501
287401,4000,Female,GM0339,Renswoude,2015JJ00,2015,2501,,31,,16,,15,131,,11,120,111,,3,0,108,20,34,,2535
287402,4000,Female,GM0339,Renswoude,2016JJ00,2016,2535,,34,,16,,18,131,,6,125,123,,1,0,122,8,26,,2561
287403,4000,Female,GM0339,Renswoude,2017JJ00,2017,2561,,37,,17,,20,166,,12,154,163,,5,-4,158,3,23,,2584
287404,4000,Female,GM0339,Renswoude,2018JJ00,2018,2584,,38,,6,,32,159,,3,156,141,,6,0,135,18,50,,2634
287405,4000,Female,GM0339,Renswoude,2019JJ00,2019,2634,,42,,12,,30,204,,8,196,148,,4,-2,144,56,88,,2722
287406,4000,Female,GM0339,Renswoude,2020JJ00,2020,2722,,38,,22,,16,188,,14,174,152,,8,0,144,36,51,,2773
287407,4000,Female,GM0339,Renswoude,2021JJ00,2021,2773,,42,,14,,28,203,,10,193,189,,4,0,185,14,42,,2815
287408,4000,Female,GM0339,Renswoude,2022JJ00,2022,2815,,36,,20,,16,279,,193,86,259,,34,-19,225,20,37,,2852
287409,4000,Female,GM0339,Renswoude,2023JJ00,2023,2852,,42,,16,,26,149,,20,129,175,,30,-14,145,-26,0,,2852
287644,4000,Female,GM1667,Reusel-De Mierden,2012JJ00,2012,6193,,56,,35,,21,201,,28,173,210,,23,-4,187,-9,12,,6205
287645,4000,Female,GM1667,Reusel-De Mierden,2013JJ00,2013,6205,,61,,44,,17,221,,44,177,241,,25,1,216,-20,-2,,6203
287646,4000,Female,GM1667,Reusel-De Mierden,2014JJ00,2014,6203,,75,,30,,45,201,,29,172,215,,22,-9,193,-14,32,,6235
287647,4000,Female,GM1667,Reusel-De Mierden,2015JJ00,2015,6235,,65,,37,,28,229,,32,197,258,,23,-2,235,-29,-1,,6234
287648,4000,Female,GM1667,Reusel-De Mierden,2016JJ00,2016,6234,,64,,56,,8,262,,39,223,231,,18,-5,213,31,39,,6273
287649,4000,Female,GM1667,Reusel-De Mierden,2017JJ00,2017,6273,,68,,43,,25,306,,43,263,270,,26,-2,244,36,59,,6332
287650,4000,Female,GM1667,Reusel-De Mierden,2018JJ00,2018,6332,,73,,40,,33,235,,25,210,254,,29,-4,225,-19,14,,6346
287651,4000,Female,GM1667,Reusel-De Mierden,2019JJ00,2019,6346,,72,,37,,35,248,,33,215,246,,22,0,224,2,37,,6383
287652,4000,Female,GM1667,Reusel-De Mierden,2020JJ00,2020,6383,,66,,49,,17,255,,32,223,240,,25,-1,215,15,32,,6415
287653,4000,Female,GM1667,Reusel-De Mierden,2021JJ00,2021,6415,,69,,49,,20,305,,37,268,264,,27,-2,237,41,61,,6476
287654,4000,Female,GM1667,Reusel-De Mierden,2022JJ00,2022,6476,,76,,50,,26,328,,85,243,227,,34,-6,193,101,127,,6603
287655,4000,Female,GM1667,Reusel-De Mierden,2023JJ00,2023,6603,,55,,45,,10,246,,38,208,276,,47,-3,229,-30,-19,,6584
287726,4000,Female,GM0275,Rheden,2012JJ00,2012,22396,,163,,324,,-161,1234,,100,1134,1092,,102,-31,990,142,-19,,22377
287727,4000,Female,GM0275,Rheden,2013JJ00,2013,22377,,169,,315,,-146,1179,,76,1103,1072,,72,-7,1000,107,-43,,22334
287728,4000,Female,GM0275,Rheden,2014JJ00,2014,22334,,160,,295,,-135,1225,,116,1109,1142,,103,-14,1039,83,-50,,22284
287729,4000,Female,GM0275,Rheden,2015JJ00,2015,22284,,168,,294,,-126,1412,,233,1179,1209,,79,1,1130,203,79,,22363
287730,4000,Female,GM0275,Rheden,2016JJ00,2016,22363,,171,,285,,-114,1423,,158,1265,1368,,116,-5,1252,55,-59,,22304
287731,4000,Female,GM0275,Rheden,2017JJ00,2017,22304,,201,,336,,-135,1511,,180,1331,1424,,107,-37,1317,87,-51,,22253
287732,4000,Female,GM0275,Rheden,2018JJ00,2018,22253,,165,,326,,-161,1464,,124,1340,1238,,103,-13,1135,226,62,,22315
287733,4000,Female,GM0275,Rheden,2019JJ00,2019,22315,,148,,341,,-193,1433,,223,1210,1256,,121,-25,1135,177,-17,,22298
287734,4000,Female,GM0275,Rheden,2020JJ00,2020,22298,,174,,338,,-164,1368,,126,1242,1263,,130,-60,1133,105,-59,,22239
287735,4000,Female,GM0275,Rheden,2021JJ00,2021,22239,,174,,349,,-175,1289,,155,1134,1163,,88,-22,1075,126,-50,,22189
287736,4000,Female,GM0275,Rheden,2022JJ00,2022,22189,,162,,343,,-181,1591,,248,1343,1336,,131,-22,1205,255,72,,22261
287737,4000,Female,GM0275,Rheden,2023JJ00,2023,22261,,155,,380,,-225,1616,,271,1345,1387,,139,-14,1248,229,2,,22263
287808,4000,Female,GM0340,Rhenen,2012JJ00,2012,9625,,106,,71,,35,446,,27,419,449,,26,-1,423,-3,-8,,9617
287809,4000,Female,GM0340,Rhenen,2013JJ00,2013,9617,,95,,58,,37,397,,21,376,406,,34,-5,372,-9,28,,9645
287810,4000,Female,GM0340,Rhenen,2014JJ00,2014,9645,,106,,68,,38,559,,34,525,438,,16,-2,422,121,160,,9805
287811,4000,Female,GM0340,Rhenen,2015JJ00,2015,9805,,98,,79,,19,493,,40,453,475,,27,-2,448,18,35,,9840
287812,4000,Female,GM0340,Rhenen,2016JJ00,2016,9840,,104,,77,,27,576,,44,532,499,,23,-1,476,77,104,,9944
287813,4000,Female,GM0340,Rhenen,2017JJ00,2017,9944,,106,,75,,31,579,,36,543,536,,29,-1,507,43,75,,10019
287814,4000,Female,GM0340,Rhenen,2018JJ00,2018,10019,,98,,93,,5,554,,49,505,518,,28,-7,490,36,41,,10060
287815,4000,Female,GM0340,Rhenen,2019JJ00,2019,10060,,95,,93,,2,573,,40,533,549,,17,3,532,24,25,,10085
287816,4000,Female,GM0340,Rhenen,2020JJ00,2020,10085,,111,,97,,14,602,,36,566,554,,31,0,523,48,64,,10149
287817,4000,Female,GM0340,Rhenen,2021JJ00,2021,10149,,111,,107,,4,492,,32,460,471,,30,-1,441,21,25,,10174
287818,4000,Female,GM0340,Rhenen,2022JJ00,2022,10174,,106,,88,,18,530,,92,438,489,,25,-4,464,41,58,,10232
287819,4000,Female,GM0340,Rhenen,2023JJ00,2023,10232,,104,,96,,8,514,,46,468,566,,41,-9,525,-52,-44,,10188
287972,4000,Female,GM0597,Ridderkerk,2012JJ00,2012,23342,,202,,210,,-8,809,,62,747,707,,52,-7,655,102,94,,23436
287973,4000,Female,GM0597,Ridderkerk,2013JJ00,2013,23436,,185,,205,,-20,736,,73,663,769,,63,-15,706,-33,-52,,23384
287974,4000,Female,GM0597,Ridderkerk,2014JJ00,2014,23384,,205,,189,,16,734,,62,672,811,,58,-3,753,-77,-61,,23323
287975,4000,Female,GM0597,Ridderkerk,2015JJ00,2015,23323,,188,,244,,-56,890,,74,816,862,,64,3,798,28,-27,,23296
287976,4000,Female,GM0597,Ridderkerk,2016JJ00,2016,23296,,218,,235,,-17,1023,,55,968,899,,76,-16,823,124,109,,23405
287977,4000,Female,GM0597,Ridderkerk,2017JJ00,2017,23405,,195,,264,,-69,1176,,82,1094,911,,52,-5,859,265,197,,23602
287978,4000,Female,GM0597,Ridderkerk,2018JJ00,2018,23602,,214,,252,,-38,1270,,106,1164,1004,,73,-17,931,266,227,,23829
287979,4000,Female,GM0597,Ridderkerk,2019JJ00,2019,23829,,242,,227,,15,990,,93,897,989,,63,-24,926,1,20,,23849
287980,4000,Female,GM0597,Ridderkerk,2020JJ00,2020,23849,,211,,312,,-101,1333,,100,1233,978,,61,-8,917,355,255,,24104
287981,4000,Female,GM0597,Ridderkerk,2021JJ00,2021,24104,,219,,291,,-72,1274,,102,1172,968,,44,-1,924,306,236,,24340
287982,4000,Female,GM0597,Ridderkerk,2022JJ00,2022,24340,,218,,289,,-71,1312,,202,1110,1044,,75,-11,969,268,197,,24537
287983,4000,Female,GM0597,Ridderkerk,2023JJ00,2023,24537,,208,,279,,-71,1114,,116,998,956,,65,7,891,158,88,,24625
288546,4000,Female,GM0196,Rijnwaarden,2012JJ00,2012,5547,,38,,61,,-23,216,,20,196,229,,12,1,217,-13,-36,,5511
288547,4000,Female,GM0196,Rijnwaarden,2013JJ00,2013,5511,,45,,58,,-13,179,,20,159,185,,19,1,166,-6,-19,,5492
288548,4000,Female,GM0196,Rijnwaarden,2014JJ00,2014,5492,,45,,58,,-13,229,,25,204,223,,18,2,205,6,-6,,5486
288549,4000,Female,GM0196,Rijnwaarden,2015JJ00,2015,5486,,50,,54,,-4,189,,20,169,205,,19,-3,186,-16,-19,,5467
288550,4000,Female,GM0196,Rijnwaarden,2016JJ00,2016,5467,,38,,50,,-12,225,,25,200,216,,18,-2,198,9,-3,,5464
288551,4000,Female,GM0196,Rijnwaarden,2017JJ00,2017,5464,,46,,49,,-3,285,,21,264,281,,13,-1,268,4,-7,,5457
288628,4000,Female,GM1672,Rijnwoude,2012JJ00,2012,9250,,103,,61,,42,253,,21,232,306,,17,0,289,-53,-11,,9239
288629,4000,Female,GM1672,Rijnwoude,2013JJ00,2013,9239,,68,,58,,10,274,,34,240,310,,23,-2,287,-36,-33,,9206
288956,4000,Female,GM1742,Rijssen-Holten,2012JJ00,2012,18896,,222,,147,,75,423,,32,391,481,,26,6,455,-58,18,,18914
288957,4000,Female,GM1742,Rijssen-Holten,2013JJ00,2013,18914,,231,,133,,98,443,,42,401,518,,37,2,481,-75,23,,18937
288958,4000,Female,GM1742,Rijssen-Holten,2014JJ00,2014,18937,,268,,153,,115,406,,39,367,490,,39,-3,451,-84,34,,18971
288959,4000,Female,GM1742,Rijssen-Holten,2015JJ00,2015,18971,,233,,155,,78,430,,41,389,509,,34,-5,475,-79,-1,,18970
288960,4000,Female,GM1742,Rijssen-Holten,2016JJ00,2016,18970,,229,,160,,69,545,,43,502,542,,41,0,501,3,72,,19042
288961,4000,Female,GM1742,Rijssen-Holten,2017JJ00,2017,19042,,241,,149,,92,558,,33,525,580,,35,-3,545,-22,69,,19111
288962,4000,Female,GM1742,Rijssen-Holten,2018JJ00,2018,19111,,213,,176,,37,563,,21,542,495,,28,1,467,68,105,,19216
288963,4000,Female,GM1742,Rijssen-Holten,2019JJ00,2019,19216,,198,,149,,49,442,,51,391,582,,27,-1,555,-140,-91,,19125
288964,4000,Female,GM1742,Rijssen-Holten,2020JJ00,2020,19125,,206,,178,,28,496,,46,450,507,,23,-3,484,-11,16,,19141
288965,4000,Female,GM1742,Rijssen-Holten,2021JJ00,2021,19141,,236,,181,,55,466,,29,437,503,,28,1,475,-37,17,,19158
288966,4000,Female,GM1742,Rijssen-Holten,2022JJ00,2022,19158,,199,,197,,2,644,,191,453,537,,95,-10,442,107,107,,19265
288967,4000,Female,GM1742,Rijssen-Holten,2023JJ00,2023,19265,,219,,197,,22,602,,75,527,571,,58,-5,513,31,56,,19321
289120,4000,Female,GM0603,Rijswijk (ZH.),2012JJ00,2012,24812,,251,,335,,-84,1738,,200,1538,1489,,208,-38,1281,249,164,,24976
289121,4000,Female,GM0603,Rijswijk (ZH.),2013JJ00,2013,24976,,275,,281,,-6,1609,,230,1379,1499,,214,-26,1285,110,105,,25081
289122,4000,Female,GM0603,Rijswijk (ZH.),2014JJ00,2014,25081,,287,,304,,-17,1938,,242,1696,1595,,229,-56,1366,343,323,,25404
289123,4000,Female,GM0603,Rijswijk (ZH.),2015JJ00,2015,25404,,270,,369,,-99,2277,,292,1985,1647,,222,-20,1425,630,531,,25935
289124,4000,Female,GM0603,Rijswijk (ZH.),2016JJ00,2016,25935,,298,,330,,-32,2647,,315,2332,1849,,254,-47,1595,798,768,,26703
289125,4000,Female,GM0603,Rijswijk (ZH.),2017JJ00,2017,26703,,326,,302,,24,2710,,323,2387,2196,,208,-20,1988,514,532,,27235
289126,4000,Female,GM0603,Rijswijk (ZH.),2018JJ00,2018,27235,,325,,335,,-10,2701,,368,2333,2089,,201,-25,1888,612,600,,27835
289127,4000,Female,GM0603,Rijswijk (ZH.),2019JJ00,2019,27835,,343,,331,,12,2585,,375,2210,2145,,232,-29,1913,440,448,,28283
289128,4000,Female,GM0603,Rijswijk (ZH.),2020JJ00,2020,28283,,308,,376,,-68,2577,,280,2297,2151,,207,-28,1944,426,353,,28636
289129,4000,Female,GM0603,Rijswijk (ZH.),2021JJ00,2021,28636,,328,,322,,6,3068,,377,2691,2230,,221,-15,2009,838,841,,29477
289130,4000,Female,GM0603,Rijswijk (ZH.),2022JJ00,2022,29477,,345,,337,,8,2821,,672,2149,2228,,251,-22,1977,593,599,,30076
289131,4000,Female,GM0603,Rijswijk (ZH.),2023JJ00,2023,30076,,314,,331,,-17,2781,,496,2285,2019,,239,-15,1780,762,747,,30823
289530,4000,Female,GM1669,Roerdalen,2012JJ00,2012,10528,,78,,96,,-18,405,,64,341,419,,37,-4,382,-14,-33,,10495
289531,4000,Female,GM1669,Roerdalen,2013JJ00,2013,10495,,73,,96,,-23,399,,52,347,462,,59,-10,403,-63,-83,,10412
289532,4000,Female,GM1669,Roerdalen,2014JJ00,2014,10412,,76,,102,,-26,407,,61,346,433,,36,-7,397,-26,-53,,10359
289533,4000,Female,GM1669,Roerdalen,2015JJ00,2015,10359,,69,,108,,-39,491,,63,428,480,,65,-19,415,11,-27,,10332
289534,4000,Female,GM1669,Roerdalen,2016JJ00,2016,10332,,78,,91,,-13,463,,65,398,431,,38,-2,393,32,16,,10348
289535,4000,Female,GM1669,Roerdalen,2017JJ00,2017,10348,,74,,117,,-43,497,,77,420,436,,42,2,394,61,19,,10367
289536,4000,Female,GM1669,Roerdalen,2018JJ00,2018,10367,,62,,104,,-42,540,,89,451,549,,47,-4,502,-9,-52,,10315
289537,4000,Female,GM1669,Roerdalen,2019JJ00,2019,10315,,68,,100,,-32,530,,74,456,549,,66,-14,483,-19,-51,,10264
289538,4000,Female,GM1669,Roerdalen,2020JJ00,2020,10264,,56,,115,,-59,533,,63,470,486,,37,-2,449,47,-13,,10251
289539,4000,Female,GM1669,Roerdalen,2021JJ00,2021,10251,,84,,129,,-45,461,,53,408,419,,43,-9,376,42,-3,,10248
289540,4000,Female,GM1669,Roerdalen,2022JJ00,2022,10248,,88,,114,,-26,540,,101,439,442,,66,-6,376,98,72,,10320
289541,4000,Female,GM1669,Roerdalen,2023JJ00,2023,10320,,67,,119,,-52,499,,84,415,385,,35,-9,350,114,61,,10381
289612,4000,Female,GM0957,Roermond,2012JJ00,2012,28422,,308,,282,,26,1328,,252,1076,1101,,165,8,936,227,249,,28671
289613,4000,Female,GM0957,Roermond,2013JJ00,2013,28671,,286,,284,,2,1257,,224,1033,1128,,201,-18,927,129,130,,28801
289614,4000,Female,GM0957,Roermond,2014JJ00,2014,28801,,269,,270,,-1,1180,,207,973,1128,,187,-17,941,52,44,,28845
289615,4000,Female,GM0957,Roermond,2015JJ00,2015,28845,,270,,322,,-52,1274,,208,1066,1199,,205,-15,994,75,32,,28877
289616,4000,Female,GM0957,Roermond,2016JJ00,2016,28877,,265,,279,,-14,1375,,217,1158,1180,,194,-16,986,195,175,,29052
289617,4000,Female,GM0957,Roermond,2017JJ00,2017,29052,,298,,298,,0,1457,,255,1202,1267,,189,-11,1078,190,189,,29241
289618,4000,Female,GM0957,Roermond,2018JJ00,2018,29241,,273,,289,,-16,1439,,279,1160,1199,,170,-15,1029,240,228,,29469
289619,4000,Female,GM0957,Roermond,2019JJ00,2019,29469,,249,,319,,-70,1430,,320,1110,1383,,245,-47,1138,47,-30,,29439
289620,4000,Female,GM0957,Roermond,2020JJ00,2020,29439,,304,,328,,-24,1593,,333,1260,1342,,188,-27,1154,251,224,,29663
289621,4000,Female,GM0957,Roermond,2021JJ00,2021,29663,,283,,337,,-54,1571,,345,1226,1291,,192,-33,1099,280,224,,29887
289622,4000,Female,GM0957,Roermond,2022JJ00,2022,29887,,260,,303,,-43,1765,,558,1207,1371,,278,-48,1093,394,352,,30239
289623,4000,Female,GM0957,Roermond,2023JJ00,2023,30239,,257,,304,,-47,1770,,455,1315,1362,,264,-49,1098,408,361,,30600
289940,4000,Female,GM0736,De Ronde Venen,2012JJ00,2012,21622,,146,,147,,-1,651,,88,563,728,,90,-8,638,-77,-78,,21544
289941,4000,Female,GM0736,De Ronde Venen,2013JJ00,2013,21544,,152,,148,,4,710,,129,581,773,,113,-11,660,-63,-59,,21485
289942,4000,Female,GM0736,De Ronde Venen,2014JJ00,2014,21485,,163,,142,,21,728,,104,624,774,,90,-13,684,-46,-26,,21459
289943,4000,Female,GM0736,De Ronde Venen,2015JJ00,2015,21459,,170,,153,,17,901,,124,777,840,,106,-3,734,61,78,,21537
289944,4000,Female,GM0736,De Ronde Venen,2016JJ00,2016,21537,,162,,144,,18,969,,122,847,902,,100,-13,802,67,82,,21619
289945,4000,Female,GM0736,De Ronde Venen,2017JJ00,2017,21619,,173,,153,,20,1330,,152,1178,945,,114,-5,831,385,403,,22022
289946,4000,Female,GM0736,De Ronde Venen,2018JJ00,2018,22022,,193,,197,,-4,1127,,161,966,908,,117,1,791,219,214,,22236
289947,4000,Female,GM0736,De Ronde Venen,2019JJ00,2019,22236,,187,,185,,2,1082,,158,924,891,,104,-8,787,191,192,,22428
289948,4000,Female,GM0736,De Ronde Venen,2020JJ00,2020,22428,,188,,174,,14,1052,,120,932,914,,80,-3,834,138,152,,22580
289949,4000,Female,GM0736,De Ronde Venen,2021JJ00,2021,22580,,196,,217,,-21,1139,,123,1016,993,,98,-2,895,146,124,,22704
289950,4000,Female,GM0736,De Ronde Venen,2022JJ00,2022,22704,,192,,197,,-5,1313,,305,1008,956,,156,-6,800,357,353,,23057
289951,4000,Female,GM0736,De Ronde Venen,2023JJ00,2023,23057,,218,,215,,3,1093,,201,892,1024,,153,-5,871,69,73,,23130
290022,4000,Female,GM1674,Roosendaal,2012JJ00,2012,39180,,366,,395,,-29,1273,,290,983,1350,,235,-46,1115,-77,-111,,39069
290023,4000,Female,GM1674,Roosendaal,2013JJ00,2013,39069,,368,,392,,-24,1329,,297,1032,1383,,246,-34,1137,-54,-78,,38991
290024,4000,Female,GM1674,Roosendaal,2014JJ00,2014,38991,,373,,414,,-41,1403,,312,1091,1447,,290,-43,1157,-44,-82,,38909
290025,4000,Female,GM1674,Roosendaal,2015JJ00,2015,38909,,369,,406,,-37,1539,,357,1182,1486,,298,-43,1188,53,18,,38927
290026,4000,Female,GM1674,Roosendaal,2016JJ00,2016,38927,,385,,382,,3,1641,,338,1303,1550,,286,-45,1264,91,89,,39016
290027,4000,Female,GM1674,Roosendaal,2017JJ00,2017,39016,,325,,400,,-75,1597,,366,1231,1642,,234,-38,1408,-45,-121,,38895
290028,4000,Female,GM1674,Roosendaal,2018JJ00,2018,38895,,350,,422,,-72,1552,,384,1168,1542,,244,-44,1298,10,-63,,38832
290029,4000,Female,GM1674,Roosendaal,2019JJ00,2019,38832,,348,,387,,-39,1682,,465,1217,1633,,298,-63,1335,49,10,,38842
290030,4000,Female,GM1674,Roosendaal,2020JJ00,2020,38842,,330,,391,,-61,1579,,374,1205,1600,,273,-52,1327,-21,-78,,38764
290031,4000,Female,GM1674,Roosendaal,2021JJ00,2021,38764,,335,,437,,-102,1626,,414,1212,1557,,298,-69,1259,69,-36,,38728
290032,4000,Female,GM1674,Roosendaal,2022JJ00,2022,38728,,310,,434,,-124,1855,,650,1205,1544,,321,-44,1223,311,187,,38915
290033,4000,Female,GM1674,Roosendaal,2023JJ00,2023,38915,,318,,461,,-143,1656,,480,1176,1659,,303,-42,1356,-3,-146,,38769
290432,4000,Female,GM0599,Rotterdam,2012JJ00,2012,312491,,3975,,2969,,1006,16038,,5227,10811,16489,,5428,-2094,11061,-451,546,,313037
290433,4000,Female,GM0599,Rotterdam,2013JJ00,2013,313037,,3907,,3028,,879,16042,,5089,10953,15988,,5071,-1451,10917,54,967,,314004
290434,4000,Female,GM0599,Rotterdam,2014JJ00,2014,314004,,3938,,2775,,1163,17263,,5471,11792,15812,,4587,-800,11225,1451,2647,,316651
290435,4000,Female,GM0599,Rotterdam,2015JJ00,2015,316651,,3781,,2961,,820,18291,,5776,12515,16429,,4585,-661,11844,1862,2755,,319406
290436,4000,Female,GM0599,Rotterdam,2016JJ00,2016,319406,,3933,,2898,,1035,19081,,6007,13074,17657,,4687,-845,12970,1424,2473,,321879
290437,4000,Female,GM0599,Rotterdam,2017JJ00,2017,321879,,3750,,2998,,752,20312,,6671,13641,18961,,4973,-1112,13988,1351,2067,,323946
290438,4000,Female,GM0599,Rotterdam,2018JJ00,2018,323946,,3701,,2821,,880,19976,,7101,12875,18100,,4266,-351,13834,1876,2737,,326683
290439,4000,Female,GM0599,Rotterdam,2019JJ00,2019,326683,,3860,,2760,,1100,21000,,8094,12906,18966,,4670,-532,14296,2034,3141,,329824
290440,4000,Female,GM0599,Rotterdam,2020JJ00,2020,329818,,3640,,3342,,298,20431,,6776,13655,20892,,4811,-662,16081,-461,-227,,329591
290441,4000,Female,GM0599,Rotterdam,2021JJ00,2021,329591,,3739,,3054,,685,22126,,8073,14053,21211,,4319,-528,16892,915,1568,,331159
290442,4000,Female,GM0599,Rotterdam,2022JJ00,2022,331159,,3430,,2965,,465,24774,,11073,13701,21028,,4896,-531,16132,3746,4119,,335278
290443,4000,Female,GM0599,Rotterdam,2023JJ00,2023,335278,,3325,,2942,,383,23779,,9424,14355,21035,,5252,-698,15783,2744,3065,,338343
290596,4000,Female,GM0277,Rozendaal,2012JJ00,2012,765,,2,,6,,-4,39,,4,35,46,,8,-1,38,-7,-11,,754
290597,4000,Female,GM0277,Rozendaal,2013JJ00,2013,754,,7,,2,,5,36,,2,34,32,,3,-1,29,4,9,,763
290598,4000,Female,GM0277,Rozendaal,2014JJ00,2014,763,,2,,3,,-1,33,,2,31,30,,3,0,27,3,2,,765
290599,4000,Female,GM0277,Rozendaal,2015JJ00,2015,765,,4,,6,,-2,34,,7,27,36,,6,0,30,-2,-4,,761
290600,4000,Female,GM0277,Rozendaal,2016JJ00,2016,761,,7,,6,,1,40,,5,35,47,,1,0,46,-7,-6,,755
290601,4000,Female,GM0277,Rozendaal,2017JJ00,2017,755,,3,,7,,-4,109,,7,102,62,,7,0,55,47,42,,797
290602,4000,Female,GM0277,Rozendaal,2018JJ00,2018,797,,9,,8,,1,77,,8,69,36,,3,0,33,41,42,,839
290603,4000,Female,GM0277,Rozendaal,2019JJ00,2019,839,,9,,9,,0,89,,8,81,59,,6,-1,53,30,30,,869
290604,4000,Female,GM0277,Rozendaal,2020JJ00,2020,869,,2,,5,,-3,58,,3,55,47,,3,0,44,11,8,,877
290605,4000,Female,GM0277,Rozendaal,2021JJ00,2021,877,,5,,2,,3,60,,5,55,59,,1,0,58,1,4,,881
290606,4000,Female,GM0277,Rozendaal,2022JJ00,2022,881,,5,,6,,-1,72,,11,61,64,,1,0,63,8,7,,888
290607,4000,Female,GM0277,Rozendaal,2023JJ00,2023,888,,8,,6,,2,94,,29,65,59,,7,-2,52,35,37,,925
290678,4000,Female,GM0840,Rucphen,2012JJ00,2012,11151,,75,,114,,-39,327,,52,275,306,,21,7,285,21,-14,,11137
290679,4000,Female,GM0840,Rucphen,2013JJ00,2013,11137,,70,,106,,-36,347,,44,303,393,,36,-5,357,-46,-82,,11055
290680,4000,Female,GM0840,Rucphen,2014JJ00,2014,11055,,78,,116,,-38,403,,56,347,350,,42,-5,308,53,16,,11071
290681,4000,Female,GM0840,Rucphen,2015JJ00,2015,11071,,68,,133,,-65,431,,53,378,365,,44,-2,321,66,1,,11072
290682,4000,Female,GM0840,Rucphen,2016JJ00,2016,11072,,87,,155,,-68,495,,60,435,426,,44,-2,382,69,3,,11075
290683,4000,Female,GM0840,Rucphen,2017JJ00,2017,11075,,91,,138,,-47,518,,70,448,408,,55,-2,353,110,64,,11139
290684,4000,Female,GM0840,Rucphen,2018JJ00,2018,11139,,90,,139,,-49,555,,71,484,452,,54,-2,398,103,53,,11192
290685,4000,Female,GM0840,Rucphen,2019JJ00,2019,11192,,86,,122,,-36,648,,110,538,459,,85,0,374,189,155,,11347
290686,4000,Female,GM0840,Rucphen,2020JJ00,2020,11347,,107,,141,,-34,627,,102,525,527,,80,-2,447,100,67,,11414
290687,4000,Female,GM0840,Rucphen,2021JJ00,2021,11414,,105,,156,,-51,611,,108,503,425,,80,-10,345,186,135,,11549
290688,4000,Female,GM0840,Rucphen,2022JJ00,2022,11549,,93,,142,,-49,644,,150,494,427,,90,-10,337,217,170,,11719
290689,4000,Female,GM0840,Rucphen,2023JJ00,2023,11719,,100,,127,,-27,647,,69,578,489,,79,-8,410,158,129,,11848
291498,4000,Female,GM0441,Schagen,2012JJ00,2012,9548,,74,,104,,-30,344,,22,322,372,,27,0,345,-28,-42,,9506
291499,4000,Female,GM0441,Schagen,2013JJ00,2013,23080,,194,,176,,18,742,,134,608,886,,99,-17,787,-144,-136,,22944
291500,4000,Female,GM0441,Schagen,2014JJ00,2014,22944,,182,,169,,13,887,,135,752,861,,88,-15,773,26,39,,22983
291501,4000,Female,GM0441,Schagen,2015JJ00,2015,22983,,174,,172,,2,934,,136,798,853,,105,-14,748,81,90,,23073
291502,4000,Female,GM0441,Schagen,2016JJ00,2016,23073,,179,,211,,-32,999,,140,859,955,,77,0,878,44,12,,23085
291503,4000,Female,GM0441,Schagen,2017JJ00,2017,23085,,176,,196,,-20,1102,,140,962,993,,85,-9,908,109,90,,23175
291504,4000,Female,GM0441,Schagen,2018JJ00,2018,23175,,186,,226,,-40,1090,,131,959,962,,101,-4,861,128,87,,23262
291505,4000,Female,GM0441,Schagen,2019JJ00,2019,23262,,187,,224,,-37,950,,134,816,930,,72,-5,858,20,-20,,23242
291506,4000,Female,GM0441,Schagen,2020JJ00,2020,23242,,159,,226,,-67,992,,105,887,865,,73,-10,792,127,60,,23302
291507,4000,Female,GM0441,Schagen,2021JJ00,2021,23302,,212,,250,,-38,1077,,106,971,879,,94,-9,785,198,161,,23463
291508,4000,Female,GM0441,Schagen,2022JJ00,2022,23463,,186,,244,,-58,1383,,357,1026,911,,176,-35,735,472,414,,23877
291509,4000,Female,GM0441,Schagen,2023JJ00,2023,23877,,149,,276,,-127,1188,,218,970,961,,156,-45,805,227,92,,23969
292072,4000,Female,GM0458,Schermer,2012JJ00,2012,2682,,24,,11,,13,134,,9,125,131,,3,2,128,3,16,,2698
292073,4000,Female,GM0458,Schermer,2013JJ00,2013,2698,,29,,10,,19,104,,11,93,108,,3,0,105,-4,15,,2713
292074,4000,Female,GM0458,Schermer,2014JJ00,2014,2713,,35,,14,,21,120,,14,106,170,,22,-5,148,-50,-29,,2684
292318,4000,Female,GM0279,Scherpenzeel,2012JJ00,2012,4716,,82,,28,,54,165,,23,142,174,,12,0,162,-9,45,,4761
292319,4000,Female,GM0279,Scherpenzeel,2013JJ00,2013,4761,,63,,38,,25,187,,18,169,159,,9,-2,150,28,52,,4813
292320,4000,Female,GM0279,Scherpenzeel,2014JJ00,2014,4813,,68,,36,,32,174,,18,156,194,,12,-3,182,-20,12,,4825
292321,4000,Female,GM0279,Scherpenzeel,2015JJ00,2015,4825,,56,,33,,23,174,,24,150,199,,12,-1,187,-25,-1,,4824
292322,4000,Female,GM0279,Scherpenzeel,2016JJ00,2016,4824,,60,,31,,29,281,,33,248,240,,13,4,227,41,70,,4894
292323,4000,Female,GM0279,Scherpenzeel,2017JJ00,2017,4894,,49,,39,,10,288,,29,259,281,,16,-3,265,7,16,,4910
292324,4000,Female,GM0279,Scherpenzeel,2018JJ00,2018,4910,,66,,31,,35,242,,26,216,203,,10,0,193,39,73,,4983
292325,4000,Female,GM0279,Scherpenzeel,2019JJ00,2019,4983,,55,,39,,16,226,,21,205,240,,28,-4,212,-14,0,,4983
292326,4000,Female,GM0279,Scherpenzeel,2020JJ00,2020,4983,,63,,60,,3,317,,17,300,219,,18,-2,201,98,101,,5084
292327,4000,Female,GM0279,Scherpenzeel,2021JJ00,2021,5084,,74,,43,,31,279,,17,262,196,,9,-2,187,83,113,,5197
292328,4000,Female,GM0279,Scherpenzeel,2022JJ00,2022,5197,,78,,45,,33,217,,53,164,216,,30,-11,186,1,34,,5231
292329,4000,Female,GM0279,Scherpenzeel,2023JJ00,2023,5231,,71,,39,,32,191,,14,177,222,,14,-1,208,-31,0,,5231
292400,4000,Female,GM0606,Schiedam,2012JJ00,2012,38752,,434,,410,,24,2321,,581,1740,2325,,544,-172,1781,-4,18,,38770
292401,4000,Female,GM0606,Schiedam,2013JJ00,2013,38770,,401,,396,,5,2383,,577,1806,2312,,530,-142,1782,71,72,,38842
292402,4000,Female,GM0606,Schiedam,2014JJ00,2014,38842,,426,,380,,46,2477,,618,1859,2354,,541,-199,1813,123,163,,39005
292403,4000,Female,GM0606,Schiedam,2015JJ00,2015,39005,,450,,398,,52,2448,,599,1849,2420,,556,-155,1864,28,77,,39082
292404,4000,Female,GM0606,Schiedam,2016JJ00,2016,39082,,411,,420,,-9,2641,,608,2033,2340,,415,-93,1925,301,296,,39378
292405,4000,Female,GM0606,Schiedam,2017JJ00,2017,39378,,455,,427,,28,2544,,662,1882,2650,,502,-172,2148,-106,-77,,39301
292406,4000,Female,GM0606,Schiedam,2018JJ00,2018,39301,,449,,418,,31,2562,,662,1900,2567,,375,-94,2192,-5,23,,39324
292407,4000,Female,GM0606,Schiedam,2019JJ00,2019,39324,,419,,410,,9,2828,,851,1977,2667,,394,-49,2273,161,162,,39486
292408,4000,Female,GM0606,Schiedam,2020JJ00,2020,39486,,407,,370,,37,2900,,678,2222,2638,,430,-63,2208,262,297,,39783
292409,4000,Female,GM0606,Schiedam,2021JJ00,2021,39783,,476,,409,,67,2946,,730,2216,2807,,481,-118,2326,139,204,,39987
292410,4000,Female,GM0606,Schiedam,2022JJ00,2022,39987,,453,,413,,40,3260,,1046,2214,2780,,512,-114,2268,480,521,,40508
292411,4000,Female,GM0606,Schiedam,2023JJ00,2023,40508,,423,,410,,13,3222,,931,2291,2801,,447,-69,2354,421,432,,40940
292482,4000,Female,GM0088,Schiermonnikoog,2012JJ00,2012,468,,3,,7,,-4,35,,1,34,22,,1,0,21,13,8,,476
292483,4000,Female,GM0088,Schiermonnikoog,2013JJ00,2013,476,,3,,6,,-3,27,,2,25,32,,4,-1,28,-5,-8,,468
292484,4000,Female,GM0088,Schiermonnikoog,2014JJ00,2014,468,,1,,7,,-6,22,,2,20,32,,1,2,31,-10,-14,,454
292485,4000,Female,GM0088,Schiermonnikoog,2015JJ00,2015,454,,1,,3,,-2,34,,6,28,35,,2,-1,33,-1,-3,,451
292486,4000,Female,GM0088,Schiermonnikoog,2016JJ00,2016,451,,4,,5,,-1,35,,4,31,27,,1,0,26,8,7,,458
292487,4000,Female,GM0088,Schiermonnikoog,2017JJ00,2017,458,,4,,6,,-2,37,,3,34,45,,4,1,41,-8,-10,,448
292488,4000,Female,GM0088,Schiermonnikoog,2018JJ00,2018,448,,4,,10,,-6,40,,7,33,34,,6,0,28,6,0,,448
292489,4000,Female,GM0088,Schiermonnikoog,2019JJ00,2019,448,,5,,5,,0,47,,6,41,34,,6,0,28,13,13,,461
292490,4000,Female,GM0088,Schiermonnikoog,2020JJ00,2020,461,,1,,5,,-4,26,,2,24,33,,2,1,31,-7,-11,,450
292491,4000,Female,GM0088,Schiermonnikoog,2021JJ00,2021,450,,1,,8,,-7,41,,4,37,38,,2,0,36,3,-4,,446
292492,4000,Female,GM0088,Schiermonnikoog,2022JJ00,2022,446,,2,,4,,-2,52,,23,29,33,,6,-2,27,19,17,,463
292493,4000,Female,GM0088,Schiermonnikoog,2023JJ00,2023,463,,2,,4,,-2,56,,24,32,57,,21,-5,36,-1,-3,,460
292564,4000,Female,GM0844,Schijndel,2012JJ00,2012,11489,,101,,87,,14,479,,61,418,354,,27,-16,327,125,142,,11631
292565,4000,Female,GM0844,Schijndel,2013JJ00,2013,11631,,109,,104,,5,437,,45,392,421,,42,-15,379,16,22,,11653
292566,4000,Female,GM0844,Schijndel,2014JJ00,2014,11653,,121,,89,,32,437,,49,388,400,,21,-9,379,37,68,,11721
292567,4000,Female,GM0844,Schijndel,2015JJ00,2015,11721,,111,,110,,1,517,,84,433,445,,50,-21,395,72,72,,11793
292568,4000,Female,GM0844,Schijndel,2016JJ00,2016,11793,,104,,84,,20,440,,65,375,463,,36,1,427,-23,39,,11832
292728,4000,Female,GM0962,Schinnen,2012JJ00,2012,6558,,50,,56,,-6,296,,28,268,336,,49,-32,287,-40,-46,,6512
292729,4000,Female,GM0962,Schinnen,2013JJ00,2013,6512,,35,,67,,-32,297,,21,276,314,,29,-10,285,-17,-48,,6464
292730,4000,Female,GM0962,Schinnen,2014JJ00,2014,6464,,43,,51,,-8,495,,187,308,455,,19,1,436,40,33,,6497
292731,4000,Female,GM0962,Schinnen,2015JJ00,2015,6497,,54,,59,,-5,470,,130,340,480,,34,-11,446,-10,-17,,6480
292732,4000,Female,GM0962,Schinnen,2016JJ00,2016,6480,,51,,61,,-10,438,,68,370,423,,30,-9,393,15,6,,6486
292733,4000,Female,GM0962,Schinnen,2017JJ00,2017,6486,,44,,59,,-15,496,,49,447,490,,25,-8,465,6,-9,,6477
292734,4000,Female,GM0962,Schinnen,2018JJ00,2018,6477,,42,,89,,-47,412,,32,380,425,,11,5,414,-13,-61,,6416
293138,4000,Female,GM0608,Schoonhoven,2012JJ00,2012,5986,,64,,35,,29,236,,17,219,245,,12,2,233,-9,19,,6005
293139,4000,Female,GM0608,Schoonhoven,2013JJ00,2013,6005,,48,,36,,12,288,,20,268,268,,15,-3,253,20,33,,6038
293140,4000,Female,GM0608,Schoonhoven,2014JJ00,2014,6038,,59,,53,,6,260,,18,242,268,,15,-4,253,-8,-19,,6019
293384,4000,Female,GM1676,Schouwen-Duiveland,2012JJ00,2012,17287,,120,,186,,-66,478,,68,410,494,,56,-8,438,-16,-84,,17203
293385,4000,Female,GM1676,Schouwen-Duiveland,2013JJ00,2013,17203,,139,,175,,-36,464,,78,386,532,,48,-5,484,-68,-103,,17100
293386,4000,Female,GM1676,Schouwen-Duiveland,2014JJ00,2014,17100,,141,,161,,-20,538,,79,459,518,,38,1,480,20,-2,,17098
293387,4000,Female,GM1676,Schouwen-Duiveland,2015JJ00,2015,17098,,132,,188,,-56,529,,74,455,539,,61,-1,478,-10,-64,,17034
293388,4000,Female,GM1676,Schouwen-Duiveland,2016JJ00,2016,17034,,125,,157,,-32,574,,77,497,531,,50,-3,481,43,10,,17044
293389,4000,Female,GM1676,Schouwen-Duiveland,2017JJ00,2017,17044,,150,,207,,-57,621,,56,565,557,,57,-7,500,64,0,,17044
293390,4000,Female,GM1676,Schouwen-Duiveland,2018JJ00,2018,17044,,140,,194,,-54,608,,74,534,544,,48,2,496,64,10,,17054
293391,4000,Female,GM1676,Schouwen-Duiveland,2019JJ00,2019,17054,,151,,197,,-46,615,,73,542,512,,46,1,466,103,61,,17115
293392,4000,Female,GM1676,Schouwen-Duiveland,2020JJ00,2020,17115,,132,,192,,-60,729,,79,650,557,,49,-13,508,172,111,,17226
293393,4000,Female,GM1676,Schouwen-Duiveland,2021JJ00,2021,17226,,150,,231,,-81,620,,69,551,477,,47,-5,430,143,60,,17286
293394,4000,Female,GM1676,Schouwen-Duiveland,2022JJ00,2022,17286,,144,,199,,-55,851,,276,575,547,,93,-6,454,304,251,,17537
293395,4000,Female,GM1676,Schouwen-Duiveland,2023JJ00,2023,17537,,153,,213,,-60,671,,154,517,592,,90,4,502,79,17,,17554
293794,4000,Female,GM0965,Simpelveld,2012JJ00,2012,5484,,29,,52,,-23,293,,28,265,243,,27,-2,216,50,23,,5507
293795,4000,Female,GM0965,Simpelveld,2013JJ00,2013,5507,,44,,70,,-26,197,,16,181,211,,23,1,188,-14,-39,,5468
293796,4000,Female,GM0965,Simpelveld,2014JJ00,2014,5468,,34,,55,,-21,233,,31,202,194,,16,1,178,39,19,,5487
293797,4000,Female,GM0965,Simpelveld,2015JJ00,2015,5487,,39,,61,,-22,220,,20,200,259,,24,0,235,-39,-61,,5426
293798,4000,Female,GM0965,Simpelveld,2016JJ00,2016,5426,,38,,50,,-12,223,,18,205,302,,10,0,292,-79,-91,,5335
293799,4000,Female,GM0965,Simpelveld,2017JJ00,2017,5335,,35,,43,,-8,276,,18,258,268,,20,0,248,8,-1,,5334
293800,4000,Female,GM0965,Simpelveld,2018JJ00,2018,5334,,44,,57,,-13,271,,30,241,305,,31,-1,274,-34,-49,,5285
293801,4000,Female,GM0965,Simpelveld,2019JJ00,2019,5285,,37,,28,,9,278,,25,253,260,,18,0,242,18,28,,5313
293802,4000,Female,GM0965,Simpelveld,2020JJ00,2020,5313,,37,,41,,-4,277,,30,247,301,,24,-5,277,-24,-29,,5284
293803,4000,Female,GM0965,Simpelveld,2021JJ00,2021,5284,,36,,50,,-14,277,,29,248,266,,13,0,253,11,-2,,5282
293804,4000,Female,GM0965,Simpelveld,2022JJ00,2022,5282,,35,,59,,-24,265,,65,200,273,,34,-6,239,-8,-32,,5250
293805,4000,Female,GM0965,Simpelveld,2023JJ00,2023,5250,,37,,52,,-15,235,,32,203,279,,34,-9,245,-44,-59,,5191
293876,4000,Female,GM1702,Sint Anthonis,2012JJ00,2012,5741,,35,,45,,-10,198,,19,179,227,,12,3,215,-29,-39,,5702
293877,4000,Female,GM1702,Sint Anthonis,2013JJ00,2013,5702,,59,,45,,14,206,,27,179,262,,17,-1,245,-56,-40,,5662
293878,4000,Female,GM1702,Sint Anthonis,2014JJ00,2014,5662,,38,,48,,-10,223,,18,205,258,,22,-3,236,-35,-45,,5617
293879,4000,Female,GM1702,Sint Anthonis,2015JJ00,2015,5617,,47,,48,,-1,217,,15,202,221,,9,0,212,-4,-5,,5612
293880,4000,Female,GM1702,Sint Anthonis,2016JJ00,2016,5612,,49,,43,,6,233,,20,213,263,,14,-1,249,-30,-25,,5587
293881,4000,Female,GM1702,Sint Anthonis,2017JJ00,2017,5587,,53,,65,,-12,278,,25,253,274,,15,0,259,4,-8,,5579
293882,4000,Female,GM1702,Sint Anthonis,2018JJ00,2018,5579,,51,,45,,6,265,,24,241,250,,12,0,238,15,21,,5600
293883,4000,Female,GM1702,Sint Anthonis,2019JJ00,2019,5600,,58,,52,,6,305,,43,262,248,,14,-5,234,57,62,,5662
293884,4000,Female,GM1702,Sint Anthonis,2020JJ00,2020,5662,,38,,58,,-20,288,,10,278,274,,21,0,253,14,-5,,5657
293885,4000,Female,GM1702,Sint Anthonis,2021JJ00,2021,5657,,37,,56,,-19,308,,21,287,264,,14,-2,250,44,23,,5680
294696,4000,Female,GM0845,Sint-Michielsgestel,2012JJ00,2012,13985,,103,,121,,-18,526,,60,466,547,,34,-6,513,-21,-38,,13947
294697,4000,Female,GM0845,Sint-Michielsgestel,2013JJ00,2013,13947,,99,,120,,-21,583,,51,532,514,,28,-4,486,69,46,,13993
294698,4000,Female,GM0845,Sint-Michielsgestel,2014JJ00,2014,13993,,117,,128,,-11,690,,53,637,556,,34,-2,522,134,125,,14118
294699,4000,Female,GM0845,Sint-Michielsgestel,2015JJ00,2015,14118,,106,,149,,-43,654,,43,611,582,,47,-2,535,72,31,,14149
294700,4000,Female,GM0845,Sint-Michielsgestel,2016JJ00,2016,14149,,118,,126,,-8,655,,61,594,584,,35,-7,549,71,63,,14212
294701,4000,Female,GM0845,Sint-Michielsgestel,2017JJ00,2017,14212,,111,,145,,-34,776,,37,739,674,,41,-6,633,102,67,,14279
294702,4000,Female,GM0845,Sint-Michielsgestel,2018JJ00,2018,14279,,128,,143,,-15,734,,43,691,568,,29,-2,539,166,151,,14430
294703,4000,Female,GM0845,Sint-Michielsgestel,2019JJ00,2019,14430,,144,,158,,-14,706,,65,641,591,,30,0,561,115,101,,14531
294704,4000,Female,GM0845,Sint-Michielsgestel,2020JJ00,2020,14531,,123,,132,,-9,781,,51,730,637,,28,-3,609,144,136,,14667
294705,4000,Female,GM0845,Sint-Michielsgestel,2021JJ00,2021,14667,,141,,147,,-6,719,,35,684,608,,26,-5,582,111,107,,14774
294706,4000,Female,GM0845,Sint-Michielsgestel,2022JJ00,2022,14774,,126,,122,,4,822,,128,694,614,,54,-8,560,208,211,,14985
294707,4000,Female,GM0845,Sint-Michielsgestel,2023JJ00,2023,14985,,141,,151,,-10,660,,57,603,689,,40,-1,649,-29,-42,,14943
294778,4000,Female,GM0846,Sint-Oedenrode,2012JJ00,2012,8960,,97,,85,,12,295,,47,248,286,,23,-1,263,9,20,,8980
294779,4000,Female,GM0846,Sint-Oedenrode,2013JJ00,2013,8980,,88,,88,,0,298,,52,246,282,,33,-5,249,16,16,,8996
294780,4000,Female,GM0846,Sint-Oedenrode,2014JJ00,2014,8996,,79,,69,,10,343,,63,280,335,,28,3,307,8,19,,9015
294781,4000,Female,GM0846,Sint-Oedenrode,2015JJ00,2015,9015,,80,,78,,2,292,,27,265,317,,27,-9,290,-25,-24,,8991
294782,4000,Female,GM0846,Sint-Oedenrode,2016JJ00,2016,8991,,80,,96,,-16,339,,42,297,329,,42,-3,287,10,-18,,8973
294942,4000,Female,GM1883,Sittard-Geleen,2012JJ00,2012,48031,,356,,596,,-240,1672,,291,1381,1728,,268,11,1460,-56,-296,,47735
294943,4000,Female,GM1883,Sittard-Geleen,2013JJ00,2013,47735,,376,,551,,-175,1655,,286,1369,1645,,226,16,1419,10,-170,,47565
294944,4000,Female,GM1883,Sittard-Geleen,2014JJ00,2014,47565,,361,,503,,-142,1816,,273,1543,1648,,228,-9,1420,168,17,,47582
294945,4000,Female,GM1883,Sittard-Geleen,2015JJ00,2015,47582,,343,,520,,-177,1858,,276,1582,1757,,238,15,1519,101,-77,,47505
294946,4000,Female,GM1883,Sittard-Geleen,2016JJ00,2016,47505,,342,,560,,-218,1844,,277,1567,1814,,261,-16,1553,30,-191,,47314
294947,4000,Female,GM1883,Sittard-Geleen,2017JJ00,2017,47314,,347,,576,,-229,1901,,288,1613,1886,,319,-71,1567,15,-217,,47097
294948,4000,Female,GM1883,Sittard-Geleen,2018JJ00,2018,47097,,346,,548,,-202,1902,,324,1578,1819,,255,-20,1564,83,-121,,46976
294949,4000,Female,GM1883,Sittard-Geleen,2019JJ00,2019,46976,,350,,614,,-264,1925,,356,1569,1894,,267,0,1627,31,-237,,46739
294950,4000,Female,GM1883,Sittard-Geleen,2020JJ00,2020,46739,,324,,672,,-348,1847,,301,1546,1967,,234,-10,1733,-120,-468,,46271
294951,4000,Female,GM1883,Sittard-Geleen,2021JJ00,2021,46271,,399,,634,,-235,2047,,320,1727,1810,,282,-17,1528,237,2,,46273
294952,4000,Female,GM1883,Sittard-Geleen,2022JJ00,2022,46273,,356,,581,,-225,2238,,649,1589,1825,,304,-23,1521,413,189,,46462
294953,4000,Female,GM1883,Sittard-Geleen,2023JJ00,2023,46462,,366,,654,,-288,2237,,482,1755,1876,,297,-29,1579,361,70,,46532
295024,4000,Female,GM0051,Skarsterlân,2012JJ00,2012,13723,,130,,105,,25,448,,53,395,503,,31,-3,472,-55,-30,,13693
295025,4000,Female,GM0051,Skarsterlân,2013JJ00,2013,13693,,118,,124,,-6,468,,45,423,469,,22,0,447,-1,24,,13717
295270,4000,Female,GM0610,Sliedrecht,2012JJ00,2012,12337,,132,,121,,11,513,,43,470,435,,34,-1,401,78,89,,12426
295271,4000,Female,GM0610,Sliedrecht,2013JJ00,2013,12426,,143,,144,,-1,466,,28,438,423,,34,-5,389,43,43,,12469
295272,4000,Female,GM0610,Sliedrecht,2014JJ00,2014,12469,,145,,124,,21,459,,38,421,377,,53,-10,324,82,102,,12571
295273,4000,Female,GM0610,Sliedrecht,2015JJ00,2015,12571,,162,,154,,8,511,,41,470,415,,37,-6,378,96,104,,12675
295274,4000,Female,GM0610,Sliedrecht,2016JJ00,2016,12675,,140,,160,,-20,550,,53,497,521,,50,-7,471,29,9,,12684
295275,4000,Female,GM0610,Sliedrecht,2017JJ00,2017,12684,,151,,148,,3,533,,55,478,526,,38,-3,488,7,11,,12695
295276,4000,Female,GM0610,Sliedrecht,2018JJ00,2018,12695,,135,,168,,-33,580,,39,541,560,,37,-2,523,20,-13,,12682
295277,4000,Female,GM0610,Sliedrecht,2019JJ00,2019,12682,,137,,147,,-10,557,,46,511,484,,30,-3,454,73,61,,12743
295278,4000,Female,GM0610,Sliedrecht,2020JJ00,2020,12743,,149,,166,,-17,722,,44,678,505,,13,1,492,217,202,,12945
295279,4000,Female,GM0610,Sliedrecht,2021JJ00,2021,12945,,155,,166,,-11,663,,40,623,514,,29,-5,485,149,137,,13082
295280,4000,Female,GM0610,Sliedrecht,2022JJ00,2022,13082,,149,,148,,1,683,,221,462,547,,65,-15,482,136,134,,13216
295281,4000,Female,GM0610,Sliedrecht,2023JJ00,2023,13216,,145,,158,,-13,632,,76,556,598,,53,-14,545,34,24,,13240
295352,4000,Female,GM0040,Slochteren,2012JJ00,2012,7626,,80,,65,,15,337,,18,319,288,,15,0,273,49,62,,7688
295353,4000,Female,GM0040,Slochteren,2013JJ00,2013,7688,,54,,69,,-15,280,,14,266,316,,12,3,304,-36,-52,,7636
295354,4000,Female,GM0040,Slochteren,2014JJ00,2014,7636,,77,,55,,22,330,,15,315,325,,16,-3,309,5,28,,7664
295355,4000,Female,GM0040,Slochteren,2015JJ00,2015,7664,,74,,80,,-6,406,,17,389,360,,21,1,339,46,40,,7704
295356,4000,Female,GM0040,Slochteren,2016JJ00,2016,7704,,77,,59,,18,465,,27,438,463,,15,-2,448,2,20,,7724
295357,4000,Female,GM0040,Slochteren,2017JJ00,2017,7222,,67,,54,,13,409,,13,396,374,,4,1,370,35,47,,7269
295516,4000,Female,GM1714,Sluis,2012JJ00,2012,12164,,90,,177,,-87,443,,179,264,353,,79,-14,274,90,1,,12165
295517,4000,Female,GM1714,Sluis,2013JJ00,2013,12165,,83,,158,,-75,423,,145,278,435,,121,-22,314,-12,-90,,12075
295518,4000,Female,GM1714,Sluis,2014JJ00,2014,12075,,92,,143,,-51,440,,183,257,417,,140,-31,277,23,-27,,12048
295519,4000,Female,GM1714,Sluis,2015JJ00,2015,12048,,96,,168,,-72,395,,139,256,395,,104,-10,291,0,-72,,11976
295520,4000,Female,GM1714,Sluis,2016JJ00,2016,11976,,79,,128,,-49,469,,176,293,404,,107,-10,297,65,13,,11989
295521,4000,Female,GM1714,Sluis,2017JJ00,2017,11989,,91,,162,,-71,408,,153,255,403,,98,-15,305,5,-69,,11920
295522,4000,Female,GM1714,Sluis,2018JJ00,2018,11920,,84,,141,,-57,381,,162,219,434,,133,-6,301,-53,-106,,11814
295523,4000,Female,GM1714,Sluis,2019JJ00,2019,11814,,77,,155,,-78,394,,159,235,431,,141,-19,290,-37,-116,,11698
295524,4000,Female,GM1714,Sluis,2020JJ00,2020,11698,,77,,154,,-77,496,,191,305,431,,140,-5,291,65,-14,,11684
295525,4000,Female,GM1714,Sluis,2021JJ00,2021,11684,,82,,163,,-81,471,,153,318,412,,125,-16,287,59,-21,,11663
295526,4000,Female,GM1714,Sluis,2022JJ00,2022,11663,,95,,146,,-51,569,,280,289,452,,159,-25,293,117,62,,11725
295527,4000,Female,GM1714,Sluis,2023JJ00,2023,11725,,88,,151,,-63,531,,241,290,483,,170,-26,313,48,-14,,11711
295762,4000,Female,GM0090,Smallingerland,2012JJ00,2012,27885,,285,,233,,52,1046,,141,905,1132,,85,-16,1047,-86,-32,,27853
295763,4000,Female,GM0090,Smallingerland,2013JJ00,2013,27853,,277,,218,,59,1126,,177,949,1164,,71,4,1093,-38,18,,27871
295764,4000,Female,GM0090,Smallingerland,2014JJ00,2014,27871,,251,,213,,38,1235,,218,1017,1205,,74,-6,1131,30,74,,27945
295765,4000,Female,GM0090,Smallingerland,2015JJ00,2015,27945,,287,,226,,61,1158,,196,962,1280,,70,-13,1210,-122,-58,,27887
295766,4000,Female,GM0090,Smallingerland,2016JJ00,2016,27887,,246,,257,,-11,1293,,161,1132,1189,,84,-18,1105,104,96,,27983
295767,4000,Female,GM0090,Smallingerland,2017JJ00,2017,27983,,274,,248,,26,1311,,98,1213,1226,,55,-1,1171,85,111,,28094
295768,4000,Female,GM0090,Smallingerland,2018JJ00,2018,28094,,258,,232,,26,1207,,126,1081,1270,,78,-14,1192,-63,-32,,28062
295769,4000,Female,GM0090,Smallingerland,2019JJ00,2019,28062,,245,,260,,-15,1259,,172,1087,1173,,63,-2,1110,86,70,,28132
295770,4000,Female,GM0090,Smallingerland,2020JJ00,2020,28132,,232,,227,,5,1137,,107,1030,1211,,56,-10,1155,-74,-70,,28062
295771,4000,Female,GM0090,Smallingerland,2021JJ00,2021,28062,,272,,281,,-9,1137,,69,1068,1184,,56,-22,1128,-47,-54,,28008
295772,4000,Female,GM0090,Smallingerland,2022JJ00,2022,28008,,250,,278,,-28,1392,,263,1129,1236,,116,-27,1120,156,127,,28135
295773,4000,Female,GM0090,Smallingerland,2023JJ00,2023,28135,,227,,303,,-76,1481,,296,1185,1257,,117,-33,1140,224,144,,28279
296090,4000,Female,GM0342,Soest,2012JJ00,2012,23403,,205,,237,,-32,931,,135,796,987,,109,-16,878,-56,-89,,23314
296091,4000,Female,GM0342,Soest,2013JJ00,2013,23314,,186,,227,,-41,1045,,126,919,982,,133,-9,849,63,21,,23335
296092,4000,Female,GM0342,Soest,2014JJ00,2014,23335,,184,,258,,-74,1092,,108,984,1090,,124,-9,966,2,-71,,23264
296093,4000,Female,GM0342,Soest,2015JJ00,2015,23264,,172,,228,,-56,1180,,126,1054,1137,,120,-17,1017,43,-13,,23251
296094,4000,Female,GM0342,Soest,2016JJ00,2016,23251,,207,,234,,-27,1379,,116,1263,1141,,108,-10,1033,238,210,,23461
296095,4000,Female,GM0342,Soest,2017JJ00,2017,23461,,205,,211,,-6,1378,,136,1242,1189,,101,-7,1088,189,182,,23643
296096,4000,Female,GM0342,Soest,2018JJ00,2018,23643,,191,,248,,-57,1303,,159,1144,1248,,109,-3,1139,55,-1,,23642
296097,4000,Female,GM0342,Soest,2019JJ00,2019,23642,,204,,215,,-11,1397,,154,1243,1192,,87,-6,1105,205,192,,23834
296098,4000,Female,GM0342,Soest,2020JJ00,2020,23834,,192,,256,,-64,1427,,138,1289,1252,,88,-4,1164,175,111,,23945
296099,4000,Female,GM0342,Soest,2021JJ00,2021,23945,,205,,235,,-30,1426,,147,1279,1273,,103,-10,1170,153,123,,24068
296100,4000,Female,GM0342,Soest,2022JJ00,2022,24068,,215,,282,,-67,1432,,241,1191,1180,,103,-5,1077,252,184,,24252
296101,4000,Female,GM0342,Soest,2023JJ00,2023,24252,,222,,257,,-35,1461,,200,1261,1303,,132,-6,1171,158,123,,24375
296172,4000,Female,GM0847,Someren,2012JJ00,2012,9123,,75,,73,,2,314,,77,237,275,,28,1,247,39,42,,9165
296173,4000,Female,GM0847,Someren,2013JJ00,2013,9165,,80,,67,,13,336,,61,275,320,,64,-19,256,16,29,,9194
296174,4000,Female,GM0847,Someren,2014JJ00,2014,9194,,67,,74,,-7,374,,101,273,388,,61,-5,327,-14,-20,,9174
296175,4000,Female,GM0847,Someren,2015JJ00,2015,9174,,104,,84,,20,421,,96,325,349,,72,-18,277,72,92,,9266
296176,4000,Female,GM0847,Someren,2016JJ00,2016,9266,,80,,75,,5,422,,90,332,371,,82,-7,289,51,56,,9322
296177,4000,Female,GM0847,Someren,2017JJ00,2017,9322,,88,,101,,-13,462,,90,372,415,,71,-15,344,47,34,,9356
296178,4000,Female,GM0847,Someren,2018JJ00,2018,9356,,105,,92,,13,483,,121,362,399,,67,-9,332,84,96,,9452
296179,4000,Female,GM0847,Someren,2019JJ00,2019,9452,,86,,74,,12,407,,88,319,369,,69,-15,300,38,48,,9500
296180,4000,Female,GM0847,Someren,2020JJ00,2020,9500,,110,,124,,-14,416,,104,312,391,,52,-6,339,25,11,,9511
296181,4000,Female,GM0847,Someren,2021JJ00,2021,9511,,117,,83,,34,536,,93,443,422,,75,-12,347,114,148,,9659
296182,4000,Female,GM0847,Someren,2022JJ00,2022,9659,,107,,86,,21,544,,149,395,371,,74,-15,297,173,194,,9853
296183,4000,Female,GM0847,Someren,2023JJ00,2023,9853,,106,,97,,9,465,,87,378,386,,83,-17,303,79,88,,9941
296336,4000,Female,GM0848,Son en Breugel,2012JJ00,2012,8006,,77,,63,,14,408,,27,381,265,,31,-4,234,143,157,,8163
296337,4000,Female,GM0848,Son en Breugel,2013JJ00,2013,8163,,74,,69,,5,347,,43,304,300,,37,0,263,47,51,,8214
296338,4000,Female,GM0848,Son en Breugel,2014JJ00,2014,8214,,87,,72,,15,375,,36,339,332,,40,-4,292,43,58,,8272
296339,4000,Female,GM0848,Son en Breugel,2015JJ00,2015,8272,,70,,78,,-8,371,,33,338,322,,32,-4,290,49,41,,8313
296340,4000,Female,GM0848,Son en Breugel,2016JJ00,2016,8313,,68,,67,,1,456,,30,426,348,,34,-5,314,108,109,,8422
296341,4000,Female,GM0848,Son en Breugel,2017JJ00,2017,8422,,86,,88,,-2,463,,34,429,423,,26,0,397,40,38,,8460
296342,4000,Female,GM0848,Son en Breugel,2018JJ00,2018,8460,,61,,76,,-15,514,,34,480,381,,23,0,358,133,119,,8579
296343,4000,Female,GM0848,Son en Breugel,2019JJ00,2019,8579,,78,,74,,4,532,,64,468,328,,23,-2,305,204,208,,8787
296344,4000,Female,GM0848,Son en Breugel,2020JJ00,2020,8787,,92,,90,,2,527,,40,487,396,,25,-3,371,131,133,,8920
296345,4000,Female,GM0848,Son en Breugel,2021JJ00,2021,8920,,92,,93,,-1,503,,45,458,393,,32,-1,361,110,108,,9028
296346,4000,Female,GM0848,Son en Breugel,2022JJ00,2022,9028,,74,,97,,-23,523,,116,407,407,,45,-2,362,116,93,,9121
296347,4000,Female,GM0848,Son en Breugel,2023JJ00,2023,9121,,81,,110,,-29,407,,48,359,414,,48,-9,366,-7,-35,,9086
296582,4000,Female,GM0612,Spijkenisse,2012JJ00,2012,36803,,367,,235,,132,1383,,145,1238,1356,,153,-34,1203,27,165,,36968
296583,4000,Female,GM0612,Spijkenisse,2013JJ00,2013,36968,,323,,256,,67,1343,,148,1195,1344,,181,-70,1163,-1,69,,37037
296584,4000,Female,GM0612,Spijkenisse,2014JJ00,2014,37037,,360,,249,,111,1309,,140,1169,1310,,142,-13,1168,-1,93,,37130
296992,4000,Female,GM0037,Stadskanaal,2012JJ00,2012,16706,,155,,202,,-47,688,,86,602,710,,27,10,683,-22,-72,,16634
296993,4000,Female,GM0037,Stadskanaal,2013JJ00,2013,16634,,139,,178,,-39,740,,189,551,712,,38,-1,674,28,-16,,16618
296994,4000,Female,GM0037,Stadskanaal,2014JJ00,2014,16618,,145,,199,,-54,711,,159,552,834,,48,-2,786,-123,-190,,16428
296995,4000,Female,GM0037,Stadskanaal,2015JJ00,2015,16428,,149,,213,,-64,1015,,357,658,922,,73,-9,849,93,12,,16440
296996,4000,Female,GM0037,Stadskanaal,2016JJ00,2016,16440,,163,,217,,-54,875,,143,732,993,,48,-5,945,-118,-191,,16249
296997,4000,Female,GM0037,Stadskanaal,2017JJ00,2017,16249,,128,,207,,-79,968,,88,880,845,,47,-28,798,123,37,,16286
296998,4000,Female,GM0037,Stadskanaal,2018JJ00,2018,16286,,115,,233,,-118,776,,54,722,891,,77,-24,814,-115,-227,,16059
296999,4000,Female,GM0037,Stadskanaal,2019JJ00,2019,16059,,121,,209,,-88,776,,49,727,701,,40,-6,661,75,-16,,16043
297000,4000,Female,GM0037,Stadskanaal,2020JJ00,2020,16043,,120,,226,,-106,850,,36,814,693,,22,-3,671,157,52,,16095
297001,4000,Female,GM0037,Stadskanaal,2021JJ00,2021,16095,,116,,219,,-103,920,,30,890,800,,21,4,779,120,19,,16114
297002,4000,Female,GM0037,Stadskanaal,2022JJ00,2022,16114,,133,,232,,-99,1156,,277,879,881,,67,-9,814,275,177,,16291
297003,4000,Female,GM0037,Stadskanaal,2023JJ00,2023,16291,,114,,258,,-144,926,,181,745,907,,113,-18,794,19,-125,,16166
297238,4000,Female,GM0180,Staphorst,2012JJ00,2012,7900,,112,,36,,76,231,,16,215,271,,20,-1,251,-40,36,,7936
297239,4000,Female,GM0180,Staphorst,2013JJ00,2013,7936,,108,,47,,61,259,,18,241,267,,16,-6,251,-8,53,,7989
297240,4000,Female,GM0180,Staphorst,2014JJ00,2014,7989,,108,,51,,57,243,,21,222,280,,20,-6,260,-37,18,,8007
297241,4000,Female,GM0180,Staphorst,2015JJ00,2015,8007,,115,,42,,73,252,,22,230,269,,20,-11,249,-17,57,,8064
297242,4000,Female,GM0180,Staphorst,2016JJ00,2016,8064,,129,,52,,77,290,,19,271,289,,9,1,280,1,78,,8142
297243,4000,Female,GM0180,Staphorst,2017JJ00,2017,8142,,112,,76,,36,340,,24,316,346,,19,-7,327,-6,31,,8173
297244,4000,Female,GM0180,Staphorst,2018JJ00,2018,8173,,113,,58,,55,345,,25,320,311,,7,-1,304,34,87,,8260
297245,4000,Female,GM0180,Staphorst,2019JJ00,2019,8260,,127,,49,,78,339,,32,307,310,,15,-6,295,29,108,,8368
297246,4000,Female,GM0180,Staphorst,2020JJ00,2020,8368,,126,,65,,61,307,,25,282,332,,15,-3,317,-25,36,,8404
297247,4000,Female,GM0180,Staphorst,2021JJ00,2021,8404,,102,,59,,43,281,,17,264,308,,14,-1,294,-27,17,,8421
297248,4000,Female,GM0180,Staphorst,2022JJ00,2022,8421,,140,,64,,76,476,,184,292,347,,48,-2,299,129,205,,8626
297249,4000,Female,GM0180,Staphorst,2023JJ00,2023,8626,,106,,46,,60,377,,111,266,397,,54,-18,343,-20,39,,8665
297484,4000,Female,GM0532,Stede Broec,2012JJ00,2012,10608,,108,,71,,37,413,,53,360,467,,38,-11,429,-54,-17,,10591
297485,4000,Female,GM0532,Stede Broec,2013JJ00,2013,10591,,128,,71,,57,443,,49,394,426,,24,5,402,17,73,,10664
297486,4000,Female,GM0532,Stede Broec,2014JJ00,2014,10664,,100,,86,,14,486,,59,427,521,,54,-6,467,-35,-22,,10642
297487,4000,Female,GM0532,Stede Broec,2015JJ00,2015,10642,,105,,80,,25,502,,79,423,505,,33,2,472,-3,25,,10667
297488,4000,Female,GM0532,Stede Broec,2016JJ00,2016,10667,,115,,79,,36,543,,69,474,531,,41,-6,490,12,48,,10715
297489,4000,Female,GM0532,Stede Broec,2017JJ00,2017,10715,,117,,95,,22,592,,64,528,555,,39,-3,516,37,60,,10775
297490,4000,Female,GM0532,Stede Broec,2018JJ00,2018,10775,,99,,79,,20,548,,50,498,548,,39,-7,509,0,19,,10794
297491,4000,Female,GM0532,Stede Broec,2019JJ00,2019,10794,,103,,99,,4,520,,59,461,519,,39,-4,480,1,6,,10800
297492,4000,Female,GM0532,Stede Broec,2020JJ00,2020,10800,,101,,83,,18,540,,59,481,573,,56,-6,517,-33,-16,,10784
297493,4000,Female,GM0532,Stede Broec,2021JJ00,2021,10784,,109,,80,,29,521,,59,462,447,,41,-5,406,74,100,,10884
297494,4000,Female,GM0532,Stede Broec,2022JJ00,2022,10884,,105,,88,,17,647,,164,483,554,,61,-5,493,93,108,,10992
297495,4000,Female,GM0532,Stede Broec,2023JJ00,2023,10992,,97,,102,,-5,597,,73,524,548,,59,-13,489,49,43,,11035
297648,4000,Female,GM0851,Steenbergen,2012JJ00,2012,11609,,95,,90,,5,467,,86,381,425,,59,-9,366,42,46,,11655
297649,4000,Female,GM0851,Steenbergen,2013JJ00,2013,11655,,97,,103,,-6,445,,93,352,458,,52,-7,406,-13,-20,,11635
297650,4000,Female,GM0851,Steenbergen,2014JJ00,2014,11635,,93,,100,,-7,608,,232,376,492,,75,-11,417,116,110,,11745
297651,4000,Female,GM0851,Steenbergen,2015JJ00,2015,11745,,89,,101,,-12,540,,166,374,619,,168,-94,451,-79,-91,,11654
297652,4000,Female,GM0851,Steenbergen,2016JJ00,2016,11654,,91,,116,,-25,740,,334,406,604,,164,-93,440,136,111,,11765
297653,4000,Female,GM0851,Steenbergen,2017JJ00,2017,11765,,107,,145,,-38,1098,,607,491,755,,272,-168,483,343,305,,12070
297654,4000,Female,GM0851,Steenbergen,2018JJ00,2018,12070,,96,,117,,-21,1097,,559,538,934,,446,-173,488,163,139,,12209
297655,4000,Female,GM0851,Steenbergen,2019JJ00,2019,12209,,89,,120,,-31,797,,284,513,1013,,503,-265,510,-216,-247,,11962
297656,4000,Female,GM0851,Steenbergen,2020JJ00,2020,11962,,95,,126,,-31,651,,143,508,677,,150,-26,527,-26,-59,,11903
297657,4000,Female,GM0851,Steenbergen,2021JJ00,2021,11903,,113,,142,,-29,758,,162,596,651,,180,-63,471,107,82,,11985
297658,4000,Female,GM0851,Steenbergen,2022JJ00,2022,11985,,120,,133,,-13,815,,242,573,607,,162,-46,445,208,196,,12181
297659,4000,Female,GM0851,Steenbergen,2023JJ00,2023,12181,,90,,169,,-79,635,,156,479,620,,187,-76,433,15,-64,,12117
297976,4000,Female,GM1708,Steenwijkerland,2012JJ00,2012,21694,,207,,199,,8,691,,60,631,695,,62,-14,633,-4,6,,21700
297977,4000,Female,GM1708,Steenwijkerland,2013JJ00,2013,21700,,207,,190,,17,704,,62,642,731,,57,-8,674,-27,-11,,21689
297978,4000,Female,GM1708,Steenwijkerland,2014JJ00,2014,21689,,208,,200,,8,750,,78,672,797,,61,0,736,-47,-37,,21652
297979,4000,Female,GM1708,Steenwijkerland,2015JJ00,2015,21652,,195,,216,,-21,795,,82,713,763,,58,-10,705,32,12,,21664
297980,4000,Female,GM1708,Steenwijkerland,2016JJ00,2016,21664,,201,,249,,-48,885,,88,797,838,,70,-9,768,47,-3,,21661
297981,4000,Female,GM1708,Steenwijkerland,2017JJ00,2017,21661,,181,,217,,-36,997,,84,913,868,,50,-3,818,129,91,,21752
297982,4000,Female,GM1708,Steenwijkerland,2018JJ00,2018,21752,,191,,215,,-24,993,,101,892,916,,64,-6,852,77,50,,21802
297983,4000,Female,GM1708,Steenwijkerland,2019JJ00,2019,21802,,194,,231,,-37,1012,,99,913,884,,84,-9,800,128,91,,21893
297984,4000,Female,GM1708,Steenwijkerland,2020JJ00,2020,21893,,174,,197,,-23,1049,,75,974,906,,48,2,858,143,124,,22017
297985,4000,Female,GM1708,Steenwijkerland,2021JJ00,2021,22017,,211,,238,,-27,1116,,103,1013,876,,49,-1,827,240,214,,22231
297986,4000,Female,GM1708,Steenwijkerland,2022JJ00,2022,22231,,188,,252,,-64,1263,,338,925,870,,93,-7,777,393,329,,22560
297987,4000,Female,GM1708,Steenwijkerland,2023JJ00,2023,22560,,174,,249,,-75,1097,,209,888,969,,123,-21,846,128,51,,22611
298140,4000,Female,GM0971,Stein (L.),2012JJ00,2012,12885,,78,,128,,-50,402,,39,363,432,,37,0,395,-30,-80,,12805
298141,4000,Female,GM0971,Stein (L.),2013JJ00,2013,12805,,93,,103,,-10,410,,41,369,427,,40,-2,387,-17,-27,,12778
298142,4000,Female,GM0971,Stein (L.),2014JJ00,2014,12778,,70,,134,,-64,387,,46,341,475,,46,3,429,-88,-153,,12625
298143,4000,Female,GM0971,Stein (L.),2015JJ00,2015,12625,,87,,144,,-57,447,,62,385,416,,37,2,379,31,-29,,12596
298144,4000,Female,GM0971,Stein (L.),2016JJ00,2016,12596,,93,,129,,-36,517,,49,468,442,,41,1,401,75,38,,12634
298145,4000,Female,GM0971,Stein (L.),2017JJ00,2017,12634,,78,,140,,-62,500,,53,447,471,,45,-3,426,29,-32,,12602
298146,4000,Female,GM0971,Stein (L.),2018JJ00,2018,12602,,84,,135,,-51,532,,36,496,493,,49,0,444,39,-11,,12591
298147,4000,Female,GM0971,Stein (L.),2019JJ00,2019,12591,,87,,122,,-35,542,,59,483,467,,39,1,428,75,40,,12631
298148,4000,Female,GM0971,Stein (L.),2020JJ00,2020,12631,,89,,151,,-62,482,,32,450,481,,37,1,444,1,-61,,12570
298149,4000,Female,GM0971,Stein (L.),2021JJ00,2021,12570,,101,,166,,-65,543,,46,497,518,,61,-2,457,25,-41,,12529
298150,4000,Female,GM0971,Stein (L.),2022JJ00,2022,12529,,90,,167,,-77,606,,123,483,544,,95,-4,449,62,-16,,12513
298151,4000,Female,GM0971,Stein (L.),2023JJ00,2023,12513,,86,,154,,-68,533,,61,472,457,,39,1,418,76,8,,12521
298386,4000,Female,GM1904,Stichtse Vecht,2012JJ00,2012,32288,,334,,230,,104,1417,,221,1196,1402,,132,-4,1270,15,115,,32403
298387,4000,Female,GM1904,Stichtse Vecht,2013JJ00,2013,32403,,309,,224,,85,1484,,225,1259,1368,,176,-21,1192,116,204,,32607
298388,4000,Female,GM1904,Stichtse Vecht,2014JJ00,2014,32607,,312,,257,,55,1563,,211,1352,1572,,163,-6,1409,-9,49,,32656
298389,4000,Female,GM1904,Stichtse Vecht,2015JJ00,2015,32656,,310,,271,,39,1695,,216,1479,1607,,185,3,1422,88,130,,32786
298390,4000,Female,GM1904,Stichtse Vecht,2016JJ00,2016,32786,,298,,292,,6,1870,,234,1636,1764,,173,-4,1591,106,115,,32901
298391,4000,Female,GM1904,Stichtse Vecht,2017JJ00,2017,32901,,324,,278,,46,1749,,235,1514,1740,,154,-6,1586,9,56,,32957
298392,4000,Female,GM1904,Stichtse Vecht,2018JJ00,2018,32957,,300,,287,,13,1628,,243,1385,1722,,183,-23,1539,-94,-82,,32875
298393,4000,Female,GM1904,Stichtse Vecht,2019JJ00,2019,32875,,303,,260,,43,1907,,260,1647,1672,,147,-7,1525,235,275,,33150
298394,4000,Female,GM1904,Stichtse Vecht,2020JJ00,2020,33150,,299,,297,,2,1816,,214,1602,1707,,123,-14,1584,109,113,,33263
298395,4000,Female,GM1904,Stichtse Vecht,2021JJ00,2021,33263,,311,,309,,2,1837,,229,1608,1866,,134,-13,1732,-29,-29,,33234
298396,4000,Female,GM1904,Stichtse Vecht,2022JJ00,2022,33234,,305,,297,,8,2008,,561,1447,1677,,192,-16,1485,331,333,,33567
298397,4000,Female,GM1904,Stichtse Vecht,2023JJ00,2023,33567,,301,,308,,-7,1952,,326,1626,1911,,298,-51,1613,41,26,,33593
298878,4000,Female,GM0617,Strijen,2012JJ00,2012,4430,,35,,33,,2,137,,10,127,189,,15,-1,174,-52,-50,,4380
298879,4000,Female,GM0617,Strijen,2013JJ00,2013,4380,,25,,31,,-6,150,,8,142,181,,11,-1,170,-31,-37,,4343
298880,4000,Female,GM0617,Strijen,2014JJ00,2014,4343,,27,,42,,-15,214,,8,206,155,,11,-4,144,59,44,,4387
298881,4000,Female,GM0617,Strijen,2015JJ00,2015,4387,,29,,36,,-7,214,,20,194,167,,10,-1,157,47,39,,4426
298882,4000,Female,GM0617,Strijen,2016JJ00,2016,4426,,28,,39,,-11,218,,11,207,194,,14,0,180,24,13,,4439
298883,4000,Female,GM0617,Strijen,2017JJ00,2017,4439,,39,,51,,-12,253,,14,239,236,,3,8,233,17,5,,4444
298884,4000,Female,GM0617,Strijen,2018JJ00,2018,4444,,29,,40,,-11,246,,15,231,244,,6,3,238,2,-15,,4429
298960,4000,Female,GM1900,Súdwest-Fryslân,2012JJ00,2012,41346,,414,,391,,23,1230,,137,1093,1196,,118,-27,1078,34,55,,41401
298961,4000,Female,GM1900,Súdwest-Fryslân,2013JJ00,2013,41401,,389,,423,,-34,1237,,132,1105,1301,,127,-14,1174,-64,-100,,41301
298962,4000,Female,GM1900,Súdwest-Fryslân,2014JJ00,2014,42104,,378,,384,,-6,1293,,110,1183,1321,,82,1,1239,-28,-26,,42078
298963,4000,Female,GM1900,Súdwest-Fryslân,2015JJ00,2015,42078,,355,,404,,-49,1235,,124,1111,1309,,84,-1,1225,-74,-120,,41958
298964,4000,Female,GM1900,Súdwest-Fryslân,2016JJ00,2016,41958,,401,,398,,3,1433,,148,1285,1417,,109,-7,1308,16,17,,41975
298965,4000,Female,GM1900,Súdwest-Fryslân,2017JJ00,2017,41975,,335,,411,,-76,1624,,167,1457,1613,,110,-9,1503,11,-56,,41919
298966,4000,Female,GM1900,Súdwest-Fryslân,2018JJ00,2018,44569,,387,,444,,-57,1670,,199,1471,1578,,136,-13,1442,92,32,,44601
298967,4000,Female,GM1900,Súdwest-Fryslân,2019JJ00,2019,44601,,409,,450,,-41,1591,,195,1396,1456,,129,-20,1327,135,94,,44695
298968,4000,Female,GM1900,Súdwest-Fryslân,2020JJ00,2020,44695,,411,,423,,-12,1641,,173,1468,1616,,98,-15,1518,25,10,,44705
298969,4000,Female,GM1900,Súdwest-Fryslân,2021JJ00,2021,44705,,410,,463,,-53,1755,,166,1589,1611,,95,-5,1516,144,88,,44793
298970,4000,Female,GM1900,Súdwest-Fryslân,2022JJ00,2022,44793,,385,,485,,-100,2181,,584,1597,1816,,214,-21,1602,365,266,,45059
298971,4000,Female,GM1900,Súdwest-Fryslân,2023JJ00,2023,45059,,350,,529,,-179,1724,,253,1471,1855,,207,-25,1648,-131,-303,,44756
299452,4000,Female,GM0715,Terneuzen,2012JJ00,2012,27492,,248,,301,,-53,925,,332,593,850,,226,-30,624,75,21,,27513
299453,4000,Female,GM0715,Terneuzen,2013JJ00,2013,27513,,248,,298,,-50,901,,337,564,833,,192,-24,641,68,16,,27529
299454,4000,Female,GM0715,Terneuzen,2014JJ00,2014,27529,,235,,255,,-20,902,,295,607,916,,248,-37,668,-14,-34,,27495
299455,4000,Female,GM0715,Terneuzen,2015JJ00,2015,27495,,240,,325,,-85,921,,342,579,841,,222,-27,619,80,-9,,27486
299456,4000,Female,GM0715,Terneuzen,2016JJ00,2016,27486,,260,,324,,-64,1100,,433,667,1073,,259,-35,814,27,-37,,27449
299457,4000,Female,GM0715,Terneuzen,2017JJ00,2017,27449,,223,,316,,-93,1027,,382,645,979,,235,-25,744,48,-51,,27398
299458,4000,Female,GM0715,Terneuzen,2018JJ00,2018,27398,,206,,340,,-134,1154,,499,655,973,,237,-13,736,181,50,,27448
299459,4000,Female,GM0715,Terneuzen,2019JJ00,2019,27448,,192,,335,,-143,1057,,439,618,999,,240,-22,759,58,-87,,27361
299460,4000,Female,GM0715,Terneuzen,2020JJ00,2020,27361,,212,,332,,-120,1024,,371,653,936,,226,-16,710,88,-35,,27326
299461,4000,Female,GM0715,Terneuzen,2021JJ00,2021,27326,,268,,348,,-80,994,,355,639,924,,239,-17,685,70,-7,,27319
299462,4000,Female,GM0715,Terneuzen,2022JJ00,2022,27319,,189,,378,,-189,1411,,673,738,965,,321,-45,644,446,255,,27574
299463,4000,Female,GM0715,Terneuzen,2023JJ00,2023,27574,,232,,357,,-125,1186,,476,710,1030,,281,-42,749,156,32,,27606
299534,4000,Female,GM0093,Terschelling,2012JJ00,2012,2236,,27,,27,,0,120,,4,116,96,,7,-1,89,24,25,,2261
299535,4000,Female,GM0093,Terschelling,2013JJ00,2013,2261,,19,,29,,-10,130,,6,124,137,,10,-6,127,-7,-17,,2244
299536,4000,Female,GM0093,Terschelling,2014JJ00,2014,2244,,29,,18,,11,153,,16,137,130,,13,-3,117,23,33,,2277
299537,4000,Female,GM0093,Terschelling,2015JJ00,2015,2277,,17,,28,,-11,159,,13,146,146,,13,-1,133,13,2,,2279
299538,4000,Female,GM0093,Terschelling,2016JJ00,2016,2279,,19,,23,,-4,162,,13,149,157,,13,-2,144,5,1,,2280
299539,4000,Female,GM0093,Terschelling,2017JJ00,2017,2280,,22,,19,,3,162,,12,150,131,,5,-2,126,31,34,,2314
299540,4000,Female,GM0093,Terschelling,2018JJ00,2018,2314,,7,,14,,-7,172,,20,152,139,,22,-9,117,33,25,,2339
299541,4000,Female,GM0093,Terschelling,2019JJ00,2019,2339,,17,,17,,0,161,,20,141,137,,16,0,121,24,24,,2363
299542,4000,Female,GM0093,Terschelling,2020JJ00,2020,2363,,15,,18,,-3,160,,21,139,144,,15,-3,129,16,14,,2377
299543,4000,Female,GM0093,Terschelling,2021JJ00,2021,2377,,24,,26,,-2,175,,27,148,141,,9,-1,132,34,31,,2408
299544,4000,Female,GM0093,Terschelling,2022JJ00,2022,2408,,14,,26,,-12,197,,56,141,163,,32,-5,131,34,23,,2431
299545,4000,Female,GM0093,Terschelling,2023JJ00,2023,2431,,19,,30,,-11,170,,39,131,174,,34,-4,140,-4,-15,,2416
299698,4000,Female,GM0448,Texel,2012JJ00,2012,6895,,46,,60,,-14,268,,39,229,252,,23,0,229,16,1,,6896
299699,4000,Female,GM0448,Texel,2013JJ00,2013,6896,,48,,73,,-25,265,,25,240,310,,29,-1,281,-45,-69,,6827
299700,4000,Female,GM0448,Texel,2014JJ00,2014,6827,,50,,62,,-12,297,,31,266,294,,34,-2,260,3,-8,,6819
299701,4000,Female,GM0448,Texel,2015JJ00,2015,6819,,41,,66,,-25,323,,46,277,284,,26,1,258,39,14,,6833
299702,4000,Female,GM0448,Texel,2016JJ00,2016,6833,,51,,72,,-21,329,,23,306,328,,44,-5,284,1,-20,,6813
299703,4000,Female,GM0448,Texel,2017JJ00,2017,6813,,41,,69,,-28,344,,49,295,294,,30,-3,264,50,20,,6833
299704,4000,Female,GM0448,Texel,2018JJ00,2018,6833,,51,,75,,-24,308,,45,263,300,,27,4,273,8,-12,,6821
299705,4000,Female,GM0448,Texel,2019JJ00,2019,6821,,47,,70,,-23,319,,41,278,277,,19,-1,258,42,14,,6835
299706,4000,Female,GM0448,Texel,2020JJ00,2020,6835,,50,,66,,-16,330,,63,267,256,,20,0,236,74,58,,6893
299707,4000,Female,GM0448,Texel,2021JJ00,2021,6893,,58,,54,,4,331,,50,281,307,,33,2,274,24,29,,6922
299708,4000,Female,GM0448,Texel,2022JJ00,2022,6922,,64,,79,,-15,489,,215,274,329,,81,-12,248,160,145,,7067
299709,4000,Female,GM0448,Texel,2023JJ00,2023,7067,,46,,99,,-53,311,,83,228,337,,53,-16,284,-26,-80,,6987
299780,4000,Female,GM1525,Teylingen,2012JJ00,2012,17888,,150,,166,,-16,858,,98,760,774,,85,-1,689,84,68,,17956
299781,4000,Female,GM1525,Teylingen,2013JJ00,2013,17956,,174,,144,,30,819,,77,742,879,,62,3,817,-60,-32,,17924
299782,4000,Female,GM1525,Teylingen,2014JJ00,2014,17924,,157,,168,,-11,810,,83,727,875,,71,-6,804,-65,-75,,17849
299783,4000,Female,GM1525,Teylingen,2015JJ00,2015,17849,,153,,167,,-14,1079,,94,985,849,,71,-4,778,230,216,,18065
299784,4000,Female,GM1525,Teylingen,2016JJ00,2016,18065,,167,,178,,-11,1019,,126,893,995,,79,3,916,24,12,,18077
299785,4000,Female,GM1525,Teylingen,2017JJ00,2017,18077,,154,,160,,-6,1230,,128,1102,1007,,74,-5,933,223,218,,18295
299786,4000,Female,GM1525,Teylingen,2018JJ00,2018,18295,,187,,138,,49,1039,,123,916,803,,69,-2,734,236,283,,18578
299787,4000,Female,GM1525,Teylingen,2019JJ00,2019,18578,,170,,159,,11,991,,92,899,796,,92,-2,704,195,206,,18784
299788,4000,Female,GM1525,Teylingen,2020JJ00,2020,18784,,154,,158,,-4,1039,,88,951,872,,62,-6,810,167,163,,18947
299789,4000,Female,GM1525,Teylingen,2021JJ00,2021,18947,,204,,178,,26,940,,97,843,883,,73,0,810,57,85,,19032
299790,4000,Female,GM1525,Teylingen,2022JJ00,2022,19032,,171,,206,,-35,1200,,209,991,848,,101,-4,747,352,318,,19350
299791,4000,Female,GM1525,Teylingen,2023JJ00,2023,19350,,175,,212,,-37,972,,144,828,1014,,113,-23,901,-42,-78,,19272
299862,4000,Female,GM0716,Tholen,2012JJ00,2012,12744,,175,,113,,62,333,,36,297,371,,28,-2,343,-38,25,,12769
299863,4000,Female,GM0716,Tholen,2013JJ00,2013,12769,,125,,92,,33,317,,38,279,393,,22,-1,371,-76,-43,,12726
299864,4000,Female,GM0716,Tholen,2014JJ00,2014,12726,,166,,107,,59,389,,46,343,422,,42,-8,380,-33,31,,12757
299865,4000,Female,GM0716,Tholen,2015JJ00,2015,12757,,128,,99,,29,354,,53,301,406,,37,-4,369,-52,-24,,12733
299866,4000,Female,GM0716,Tholen,2016JJ00,2016,12733,,144,,99,,45,444,,66,378,443,,35,-4,408,1,46,,12779
299867,4000,Female,GM0716,Tholen,2017JJ00,2017,12779,,132,,121,,11,482,,43,439,475,,46,-2,429,7,17,,12796
299868,4000,Female,GM0716,Tholen,2018JJ00,2018,12796,,140,,120,,20,506,,51,455,426,,33,-1,393,80,101,,12897
299869,4000,Female,GM0716,Tholen,2019JJ00,2019,12897,,145,,110,,35,444,,49,395,506,,38,-2,468,-62,-27,,12870
299870,4000,Female,GM0716,Tholen,2020JJ00,2020,12870,,130,,129,,1,568,,49,519,421,,28,-3,393,147,146,,13016
299871,4000,Female,GM0716,Tholen,2021JJ00,2021,13016,,161,,115,,46,607,,45,562,463,,35,-4,428,144,191,,13207
299872,4000,Female,GM0716,Tholen,2022JJ00,2022,13207,,161,,120,,41,665,,240,425,481,,99,-3,382,184,224,,13431
299873,4000,Female,GM0716,Tholen,2023JJ00,2023,13431,,156,,118,,38,521,,93,428,565,,98,-13,467,-44,-8,,13423
300026,4000,Female,GM0281,Tiel,2012JJ00,2012,20905,,204,,164,,40,801,,71,730,770,,58,4,712,31,71,,20976
300027,4000,Female,GM0281,Tiel,2013JJ00,2013,20976,,229,,175,,54,758,,90,668,791,,107,-26,684,-33,21,,20997
300028,4000,Female,GM0281,Tiel,2014JJ00,2014,21004,,224,,175,,49,754,,109,645,908,,86,1,822,-154,-106,,20898
300029,4000,Female,GM0281,Tiel,2015JJ00,2015,20898,,194,,195,,-1,831,,111,720,875,,91,1,784,-44,-44,,20854
300030,4000,Female,GM0281,Tiel,2016JJ00,2016,20854,,209,,168,,41,846,,120,726,897,,77,-1,820,-51,-11,,20843
300031,4000,Female,GM0281,Tiel,2017JJ00,2017,20843,,209,,208,,1,973,,126,847,989,,109,-14,880,-16,-13,,20830
300032,4000,Female,GM0281,Tiel,2018JJ00,2018,20830,,171,,183,,-12,1172,,441,731,926,,117,-16,809,246,234,,21064
300033,4000,Female,GM0281,Tiel,2019JJ00,2019,21064,,177,,198,,-21,1122,,316,806,1014,,212,-58,802,108,88,,21152
300034,4000,Female,GM0281,Tiel,2020JJ00,2020,21152,,190,,234,,-44,1160,,351,809,1280,,347,-78,933,-120,-166,,20986
300035,4000,Female,GM0281,Tiel,2021JJ00,2021,20986,,188,,215,,-27,1232,,372,860,1083,,252,-28,831,149,123,,21109
300036,4000,Female,GM0281,Tiel,2022JJ00,2022,21109,,169,,200,,-31,1351,,561,790,1178,,341,-49,837,173,139,,21248
300037,4000,Female,GM0281,Tiel,2023JJ00,2023,21248,,171,,205,,-34,1221,,284,937,1252,,417,-255,835,-31,-69,,21179
300354,4000,Female,GM0855,Tilburg,2012JJ00,2012,104565,,1055,,895,,160,5307,,1209,4098,5187,,975,-104,4212,120,280,,104845
300355,4000,Female,GM0855,Tilburg,2013JJ00,2013,104845,,1093,,887,,206,5770,,1347,4423,5153,,1031,-59,4122,617,829,,105674
300356,4000,Female,GM0855,Tilburg,2014JJ00,2014,105674,,1119,,862,,257,5909,,1333,4576,5367,,1140,-239,4227,542,795,,106469
300357,4000,Female,GM0855,Tilburg,2015JJ00,2015,106469,,1029,,910,,119,6012,,1632,4380,5668,,1141,-200,4527,344,464,,106933
300358,4000,Female,GM0855,Tilburg,2016JJ00,2016,106933,,1068,,940,,128,6508,,1800,4708,6192,,1260,-245,4932,316,443,,107376
300359,4000,Female,GM0855,Tilburg,2017JJ00,2017,107376,,1001,,946,,55,6679,,1955,4724,6020,,1190,-87,4830,659,715,,108091
300360,4000,Female,GM0855,Tilburg,2018JJ00,2018,108060,,1013,,968,,45,6826,,2286,4540,5950,,1404,-281,4546,876,916,,108976
300361,4000,Female,GM0855,Tilburg,2019JJ00,2019,108976,,978,,958,,20,7093,,2486,4607,5777,,1319,-149,4458,1316,1326,,110302
300362,4000,Female,GM0855,Tilburg,2020JJ00,2020,110302,,1023,,1080,,-57,6747,,2045,4702,6333,,1642,-322,4691,414,337,,110639
300363,4000,Female,GM0855,Tilburg,2021JJ00,2021,111257,,1087,,964,,123,6831,,2414,4417,5637,,1253,-126,4384,1194,1315,,112572
300364,4000,Female,GM0855,Tilburg,2022JJ00,2022,112572,,1039,,1032,,7,7427,,3020,4407,5802,,1460,-130,4342,1625,1626,,114198
300365,4000,Female,GM0855,Tilburg,2023JJ00,2023,114198,,1031,,1031,,0,7334,,2694,4640,6255,,1759,-286,4496,1079,1064,,115262
300436,4000,Female,GM0183,Tubbergen,2012JJ00,2012,10426,,104,,82,,22,256,,25,231,318,,26,-7,292,-62,-41,,10385
300437,4000,Female,GM0183,Tubbergen,2013JJ00,2013,10385,,92,,78,,14,299,,29,270,297,,16,3,281,2,16,,10401
300438,4000,Female,GM0183,Tubbergen,2014JJ00,2014,10401,,91,,91,,0,283,,32,251,325,,16,1,309,-42,-42,,10359
300439,4000,Female,GM0183,Tubbergen,2015JJ00,2015,10359,,85,,80,,5,307,,18,289,320,,17,1,303,-13,-10,,10349
300440,4000,Female,GM0183,Tubbergen,2016JJ00,2016,10349,,83,,77,,6,328,,22,306,328,,17,-1,311,0,7,,10356
300441,4000,Female,GM0183,Tubbergen,2017JJ00,2017,10356,,87,,73,,14,386,,27,359,345,,8,0,337,41,53,,10409
300442,4000,Female,GM0183,Tubbergen,2018JJ00,2018,10409,,95,,93,,2,315,,24,291,318,,21,-3,297,-3,-1,,10408
300443,4000,Female,GM0183,Tubbergen,2019JJ00,2019,10408,,94,,97,,-3,334,,31,303,336,,27,-2,309,-2,-6,,10402
300444,4000,Female,GM0183,Tubbergen,2020JJ00,2020,10402,,93,,111,,-18,373,,20,353,336,,20,0,316,37,19,,10421
300445,4000,Female,GM0183,Tubbergen,2021JJ00,2021,10421,,104,,114,,-10,316,,23,293,333,,15,-1,318,-17,-27,,10394
300446,4000,Female,GM0183,Tubbergen,2022JJ00,2022,10394,,99,,100,,-1,352,,58,294,307,,25,-2,282,45,44,,10438
300447,4000,Female,GM0183,Tubbergen,2023JJ00,2023,10438,,114,,116,,-2,364,,90,274,382,,26,-3,356,-18,-21,,10417
300682,4000,Female,GM1700,Twenterand,2012JJ00,2012,16736,,187,,159,,28,416,,29,387,434,,18,-4,416,-18,10,,16746
300683,4000,Female,GM1700,Twenterand,2013JJ00,2013,16746,,189,,169,,20,415,,26,389,450,,32,-1,418,-35,-11,,16735
300684,4000,Female,GM1700,Twenterand,2014JJ00,2014,16735,,178,,150,,28,412,,26,386,431,,26,-1,405,-19,8,,16743
300685,4000,Female,GM1700,Twenterand,2015JJ00,2015,16743,,180,,152,,28,426,,28,398,473,,28,-4,445,-47,-20,,16723
300686,4000,Female,GM1700,Twenterand,2016JJ00,2016,16723,,162,,162,,0,432,,25,407,457,,16,-2,441,-25,-24,,16699
300687,4000,Female,GM1700,Twenterand,2017JJ00,2017,16699,,165,,132,,33,458,,26,432,475,,16,-1,459,-17,15,,16714
300688,4000,Female,GM1700,Twenterand,2018JJ00,2018,16714,,170,,168,,2,483,,39,444,567,,21,-6,546,-84,-83,,16631
300689,4000,Female,GM1700,Twenterand,2019JJ00,2019,16631,,156,,178,,-22,478,,27,451,461,,24,3,437,17,-7,,16624
300690,4000,Female,GM1700,Twenterand,2020JJ00,2020,16624,,148,,158,,-10,477,,22,455,504,,14,-3,490,-27,-37,,16587
300691,4000,Female,GM1700,Twenterand,2021JJ00,2021,16587,,164,,174,,-10,452,,15,437,417,,18,0,399,35,25,,16612
300692,4000,Female,GM1700,Twenterand,2022JJ00,2022,16612,,145,,149,,-4,596,,137,459,491,,50,1,441,105,101,,16713
300693,4000,Female,GM1700,Twenterand,2023JJ00,2023,16713,,152,,174,,-22,621,,76,545,513,,30,-6,483,108,86,,16799
300846,4000,Female,GM1730,Tynaarlo,2012JJ00,2012,16446,,144,,191,,-47,801,,45,756,677,,7,9,670,124,76,,16522
300847,4000,Female,GM1730,Tynaarlo,2013JJ00,2013,16522,,122,,190,,-68,765,,40,725,731,,20,8,711,34,-34,,16488
300848,4000,Female,GM1730,Tynaarlo,2014JJ00,2014,16488,,140,,162,,-22,845,,52,793,778,,28,1,750,67,46,,16534
300849,4000,Female,GM1730,Tynaarlo,2015JJ00,2015,16534,,120,,199,,-79,1049,,53,996,824,,59,-1,765,225,140,,16674
300850,4000,Female,GM1730,Tynaarlo,2016JJ00,2016,16674,,149,,186,,-37,1064,,48,1016,818,,40,2,778,246,210,,16884
300851,4000,Female,GM1730,Tynaarlo,2017JJ00,2017,16884,,127,,208,,-81,1161,,56,1105,917,,32,1,885,244,165,,17049
300852,4000,Female,GM1730,Tynaarlo,2018JJ00,2018,17049,,155,,199,,-44,1121,,68,1053,977,,42,-5,935,144,96,,17145
300853,4000,Female,GM1730,Tynaarlo,2019JJ00,2019,17145,,151,,191,,-40,1075,,56,1019,984,,37,-1,947,91,48,,17193
300854,4000,Female,GM1730,Tynaarlo,2020JJ00,2020,17193,,140,,222,,-82,1059,,57,1002,941,,28,0,913,118,37,,17230
300855,4000,Female,GM1730,Tynaarlo,2021JJ00,2021,17230,,153,,234,,-81,1075,,48,1027,877,,29,-1,848,198,118,,17348
300856,4000,Female,GM1730,Tynaarlo,2022JJ00,2022,17348,,159,,270,,-111,1340,,171,1169,1012,,53,-3,959,328,217,,17565
300857,4000,Female,GM1730,Tynaarlo,2023JJ00,2023,17565,,134,,224,,-90,1089,,62,1027,974,,67,-7,907,115,25,,17590
300928,4000,Female,GM0737,Tytsjerksteradiel,2012JJ00,2012,16127,,148,,189,,-41,639,,111,528,713,,51,6,662,-74,-111,,16016
300929,4000,Female,GM0737,Tytsjerksteradiel,2013JJ00,2013,16016,,140,,171,,-31,687,,82,605,654,,34,4,620,33,8,,16024
300930,4000,Female,GM0737,Tytsjerksteradiel,2014JJ00,2014,16024,,136,,184,,-48,737,,57,680,701,,34,-5,667,36,-13,,16011
300931,4000,Female,GM0737,Tytsjerksteradiel,2015JJ00,2015,16011,,144,,166,,-22,758,,46,712,642,,28,5,614,116,93,,16104
300932,4000,Female,GM0737,Tytsjerksteradiel,2016JJ00,2016,16104,,120,,177,,-57,724,,48,676,771,,25,5,746,-47,-102,,16002
300933,4000,Female,GM0737,Tytsjerksteradiel,2017JJ00,2017,16002,,151,,189,,-38,821,,55,766,834,,72,-42,762,-13,-51,,15951
300934,4000,Female,GM0737,Tytsjerksteradiel,2018JJ00,2018,15951,,134,,199,,-65,800,,53,747,808,,39,-24,769,-8,-71,,15880
300935,4000,Female,GM0737,Tytsjerksteradiel,2019JJ00,2019,15880,,153,,163,,-10,840,,36,804,701,,34,-13,667,139,132,,16012
300936,4000,Female,GM0737,Tytsjerksteradiel,2020JJ00,2020,16012,,172,,167,,5,702,,37,665,729,,29,-5,700,-27,-21,,15991
300937,4000,Female,GM0737,Tytsjerksteradiel,2021JJ00,2021,15991,,153,,159,,-6,847,,32,815,663,,26,0,637,184,178,,16169
300938,4000,Female,GM0737,Tytsjerksteradiel,2022JJ00,2022,16169,,131,,186,,-55,877,,152,725,763,,62,-18,701,114,56,,16225
300939,4000,Female,GM0737,Tytsjerksteradiel,2023JJ00,2023,16225,,146,,174,,-28,928,,81,847,795,,83,-39,712,133,106,,16331
301092,4000,Female,GM0282,Ubbergen,2012JJ00,2012,4763,,40,,53,,-13,302,,27,275,248,,18,-1,230,54,40,,4803
301093,4000,Female,GM0282,Ubbergen,2013JJ00,2013,4803,,31,,55,,-24,236,,25,211,258,,23,0,235,-22,-46,,4757
301094,4000,Female,GM0282,Ubbergen,2014JJ00,2014,4757,,35,,59,,-24,241,,23,218,250,,15,-1,235,-9,-32,,4725
301174,4000,Female,GM0856,Uden,2012JJ00,2012,20562,,196,,148,,48,685,,73,612,644,,59,-6,585,41,91,,20653
301175,4000,Female,GM0856,Uden,2013JJ00,2013,20653,,213,,171,,42,672,,95,577,725,,84,-5,641,-53,-14,,20639
301176,4000,Female,GM0856,Uden,2014JJ00,2014,20639,,230,,175,,55,808,,100,708,758,,83,-8,675,50,104,,20743
301177,4000,Female,GM0856,Uden,2015JJ00,2015,20743,,177,,191,,-14,746,,96,650,688,,80,-16,608,58,48,,20791
301178,4000,Female,GM0856,Uden,2016JJ00,2016,20791,,198,,184,,14,830,,114,716,770,,84,-12,686,60,76,,20867
301179,4000,Female,GM0856,Uden,2017JJ00,2017,20867,,209,,192,,17,977,,119,858,799,,77,-3,722,178,195,,21062
301180,4000,Female,GM0856,Uden,2018JJ00,2018,21062,,171,,210,,-39,889,,96,793,843,,79,-11,764,46,5,,21067
301181,4000,Female,GM0856,Uden,2019JJ00,2019,21067,,206,,174,,32,922,,131,791,811,,101,-16,710,111,141,,21208
301182,4000,Female,GM0856,Uden,2020JJ00,2020,21208,,203,,214,,-11,933,,124,809,821,,59,1,762,112,97,,21305
301183,4000,Female,GM0856,Uden,2021JJ00,2021,21305,,189,,215,,-26,844,,93,751,748,,90,-10,658,96,78,,21383
301338,4000,Female,GM0450,Uitgeest,2012JJ00,2012,6425,,59,,41,,18,299,,21,278,239,,14,0,225,60,78,,6503
301339,4000,Female,GM0450,Uitgeest,2013JJ00,2013,6503,,57,,41,,16,308,,25,283,216,,11,-3,205,92,107,,6610
301340,4000,Female,GM0450,Uitgeest,2014JJ00,2014,6610,,69,,40,,29,275,,18,257,286,,12,-3,274,-11,20,,6630
301341,4000,Female,GM0450,Uitgeest,2015JJ00,2015,6630,,72,,37,,35,260,,8,252,279,,15,-1,264,-19,17,,6647
301342,4000,Female,GM0450,Uitgeest,2016JJ00,2016,6647,,67,,41,,26,329,,26,303,296,,3,2,293,33,57,,6704
301343,4000,Female,GM0450,Uitgeest,2017JJ00,2017,6704,,55,,36,,19,313,,24,289,316,,32,-7,284,-3,14,,6718
301344,4000,Female,GM0450,Uitgeest,2018JJ00,2018,6718,,75,,47,,28,255,,19,236,292,,23,-4,269,-37,-10,,6708
301345,4000,Female,GM0450,Uitgeest,2019JJ00,2019,6708,,57,,47,,10,357,,32,325,300,,20,-4,280,57,67,,6775
301346,4000,Female,GM0450,Uitgeest,2020JJ00,2020,6775,,64,,43,,21,339,,21,318,353,,15,-3,338,-14,8,,6783
301347,4000,Female,GM0450,Uitgeest,2021JJ00,2021,6783,,69,,50,,19,277,,22,255,320,,13,-1,307,-43,-25,,6758
301348,4000,Female,GM0450,Uitgeest,2022JJ00,2022,6758,,54,,50,,4,328,,46,282,358,,29,-1,329,-30,-27,,6731
301349,4000,Female,GM0450,Uitgeest,2023JJ00,2023,6731,,60,,44,,16,289,,45,244,338,,27,0,311,-49,-32,,6699
301420,4000,Female,GM0451,Uithoorn,2012JJ00,2012,14334,,133,,102,,31,662,,98,564,612,,72,-5,540,50,80,,14414
301421,4000,Female,GM0451,Uithoorn,2013JJ00,2013,14414,,116,,95,,21,605,,88,517,641,,83,-19,558,-36,-15,,14399
301422,4000,Female,GM0451,Uithoorn,2014JJ00,2014,14399,,135,,110,,25,795,,134,661,670,,73,-19,597,125,146,,14545
301423,4000,Female,GM0451,Uithoorn,2015JJ00,2015,14545,,138,,92,,46,967,,127,840,762,,96,-17,666,205,251,,14796
301424,4000,Female,GM0451,Uithoorn,2016JJ00,2016,14796,,141,,111,,30,773,,118,655,799,,120,-34,679,-26,2,,14798
301425,4000,Female,GM0451,Uithoorn,2017JJ00,2017,14798,,122,,119,,3,912,,124,788,796,,81,4,715,116,119,,14917
301426,4000,Female,GM0451,Uithoorn,2018JJ00,2018,14917,,140,,99,,41,814,,131,683,857,,94,-6,763,-43,-2,,14915
301427,4000,Female,GM0451,Uithoorn,2019JJ00,2019,14915,,140,,101,,39,866,,156,710,854,,114,-12,740,12,50,,14965
301428,4000,Female,GM0451,Uithoorn,2020JJ00,2020,14965,,144,,121,,23,1191,,120,1071,814,,76,-3,738,377,398,,15363
301429,4000,Female,GM0451,Uithoorn,2021JJ00,2021,15363,,185,,137,,48,1161,,144,1017,803,,103,-4,700,358,405,,15768
301430,4000,Female,GM0451,Uithoorn,2022JJ00,2022,15768,,138,,127,,11,1113,,305,808,889,,130,-3,759,224,234,,16002
301431,4000,Female,GM0451,Uithoorn,2023JJ00,2023,16002,,154,,101,,53,1022,,253,769,949,,193,-52,756,73,127,,16129
301830,4000,Female,GM0184,Urk,2012JJ00,2012,9362,,177,,48,,129,111,,20,91,126,,12,0,114,-15,114,,9476
301831,4000,Female,GM0184,Urk,2013JJ00,2013,9476,,206,,37,,169,123,,11,112,138,,4,0,134,-15,153,,9629
301832,4000,Female,GM0184,Urk,2014JJ00,2014,9629,,184,,36,,148,129,,14,115,172,,10,0,162,-43,105,,9734
301833,4000,Female,GM0184,Urk,2015JJ00,2015,9734,,203,,39,,164,174,,28,146,172,,23,-2,149,2,168,,9902
301834,4000,Female,GM0184,Urk,2016JJ00,2016,9902,,185,,46,,139,153,,16,137,165,,18,-1,147,-12,126,,10028
301835,4000,Female,GM0184,Urk,2017JJ00,2017,10028,,189,,47,,142,160,,36,124,174,,9,2,165,-14,128,,10156
301836,4000,Female,GM0184,Urk,2018JJ00,2018,10156,,160,,53,,107,157,,26,131,169,,9,0,160,-12,95,,10251
301837,4000,Female,GM0184,Urk,2019JJ00,2019,10256,,194,,43,,151,157,,33,124,197,,22,-1,175,-40,111,,10367
301838,4000,Female,GM0184,Urk,2020JJ00,2020,10367,,200,,58,,142,162,,35,127,208,,17,-2,191,-46,96,,10463
301839,4000,Female,GM0184,Urk,2021JJ00,2021,10463,,212,,56,,156,168,,30,138,199,,24,1,175,-31,125,,10588
301840,4000,Female,GM0184,Urk,2022JJ00,2022,10588,,183,,45,,138,316,,186,130,283,,52,-19,231,33,169,,10757
301841,4000,Female,GM0184,Urk,2023JJ00,2023,10757,,193,,65,,128,178,,59,119,223,,32,-12,191,-45,84,,10841
302240,4000,Female,GM0344,Utrecht Municipality,2012JJ00,2012,162993,,2471,,999,,1472,12924,,2527,10397,11694,,2382,-261,9312,1230,2700,,165693
302241,4000,Female,GM0344,Utrecht Municipality,2013JJ00,2013,165693,,2437,,966,,1471,13526,,2648,10878,11842,,2627,-235,9215,1684,3166,,168859
302242,4000,Female,GM0344,Utrecht Municipality,2014JJ00,2014,168859,,2538,,985,,1553,14119,,2726,11393,12920,,2427,-158,10493,1199,2761,,171620
302243,4000,Female,GM0344,Utrecht Municipality,2015JJ00,2015,171620,,2459,,1035,,1424,14343,,3057,11286,13780,,2484,-214,11296,563,1988,,173608
302244,4000,Female,GM0344,Utrecht Municipality,2016JJ00,2016,173608,,2415,,1004,,1411,14682,,3420,11262,14249,,2276,-126,11973,433,1843,,175451
302245,4000,Female,GM0344,Utrecht Municipality,2017JJ00,2017,175451,,2440,,1029,,1411,14873,,3670,11203,14226,,2482,-258,11744,647,2058,,177509
302246,4000,Female,GM0344,Utrecht Municipality,2018JJ00,2018,177509,,2328,,918,,1410,15443,,3912,11531,14333,,2926,-264,11407,1110,2500,,180009
302247,4000,Female,GM0344,Utrecht Municipality,2019JJ00,2019,180009,,2309,,978,,1331,15440,,4405,11035,14557,,3040,-141,11517,883,2193,,182202
302248,4000,Female,GM0344,Utrecht Municipality,2020JJ00,2020,182202,,2329,,1063,,1266,14701,,3358,11343,15354,,2855,-34,12499,-653,614,,182816
302249,4000,Female,GM0344,Utrecht Municipality,2021JJ00,2021,182816,,2458,,1057,,1401,15569,,4199,11370,15510,,2389,-138,13121,59,1438,,184254
302250,4000,Female,GM0344,Utrecht Municipality,2022JJ00,2022,184254,,2176,,1053,,1123,17589,,6072,11517,15346,,2866,-76,12480,2243,3358,,187612
302251,4000,Female,GM0344,Utrecht Municipality,2023JJ00,2023,187612,,2048,,1047,,1001,18308,,5091,13217,15476,,3024,-271,12452,2832,3827,,191439
302322,4000,Female,GM1581,Utrechtse Heuvelrug,2012JJ00,2012,24966,,175,,315,,-140,1382,,306,1076,1350,,119,-20,1231,32,-103,,24863
302323,4000,Female,GM1581,Utrechtse Heuvelrug,2013JJ00,2013,24863,,153,,332,,-179,1515,,340,1175,1487,,96,-13,1391,28,-146,,24717
302324,4000,Female,GM1581,Utrechtse Heuvelrug,2014JJ00,2014,24717,,179,,287,,-108,1683,,294,1389,1549,,101,-1,1448,134,27,,24744
302325,4000,Female,GM1581,Utrechtse Heuvelrug,2015JJ00,2015,24744,,185,,323,,-138,1846,,378,1468,1606,,113,0,1493,240,101,,24845
302326,4000,Female,GM1581,Utrechtse Heuvelrug,2016JJ00,2016,24845,,178,,339,,-161,1988,,285,1703,1614,,98,0,1516,374,220,,25065
302327,4000,Female,GM1581,Utrechtse Heuvelrug,2017JJ00,2017,25065,,189,,326,,-137,1942,,156,1786,1601,,100,-6,1501,341,204,,25269
302328,4000,Female,GM1581,Utrechtse Heuvelrug,2018JJ00,2018,25269,,208,,288,,-80,1682,,169,1513,1565,,80,-1,1485,117,40,,25309
302329,4000,Female,GM1581,Utrechtse Heuvelrug,2019JJ00,2019,25309,,174,,322,,-148,1723,,145,1578,1605,,102,-12,1503,118,-30,,25279
302330,4000,Female,GM1581,Utrechtse Heuvelrug,2020JJ00,2020,25279,,206,,352,,-146,1793,,131,1662,1516,,102,-1,1414,277,133,,25412
302331,4000,Female,GM1581,Utrechtse Heuvelrug,2021JJ00,2021,25412,,198,,317,,-119,1770,,144,1626,1561,,136,-31,1425,209,90,,25502
302332,4000,Female,GM1581,Utrechtse Heuvelrug,2022JJ00,2022,25502,,179,,346,,-167,1935,,361,1574,1508,,140,2,1368,427,259,,25761
302333,4000,Female,GM1581,Utrechtse Heuvelrug,2023JJ00,2023,25761,,195,,345,,-150,1866,,176,1690,1650,,175,-16,1475,216,66,,25827
302404,4000,Female,GM0981,Vaals,2012JJ00,2012,4944,,32,,58,,-26,283,,125,158,263,,100,-15,163,20,-7,,4937
302405,4000,Female,GM0981,Vaals,2013JJ00,2013,4937,,33,,59,,-26,283,,130,153,287,,125,-17,162,-4,-31,,4906
302406,4000,Female,GM0981,Vaals,2014JJ00,2014,4906,,32,,83,,-51,328,,139,189,272,,124,-12,148,56,6,,4912
302407,4000,Female,GM0981,Vaals,2015JJ00,2015,4912,,33,,78,,-45,281,,105,176,288,,134,-14,154,-7,-50,,4862
302408,4000,Female,GM0981,Vaals,2016JJ00,2016,4862,,33,,60,,-27,309,,141,168,309,,125,-14,184,0,-27,,4835
302409,4000,Female,GM0981,Vaals,2017JJ00,2017,4835,,21,,67,,-46,371,,205,166,278,,117,-10,161,93,46,,4881
302410,4000,Female,GM0981,Vaals,2018JJ00,2018,4881,,22,,62,,-40,317,,187,130,267,,114,-21,153,50,8,,4889
302411,4000,Female,GM0981,Vaals,2019JJ00,2019,4889,,33,,50,,-17,322,,192,130,276,,143,-9,133,46,32,,4921
302412,4000,Female,GM0981,Vaals,2020JJ00,2020,4921,,33,,63,,-30,317,,177,140,287,,123,-7,164,30,0,,4921
302413,4000,Female,GM0981,Vaals,2021JJ00,2021,4921,,33,,80,,-47,328,,149,179,271,,120,-9,151,57,9,,4930
302414,4000,Female,GM0981,Vaals,2022JJ00,2022,4930,,32,,63,,-31,447,,267,180,333,,151,-2,182,114,81,,5011
302415,4000,Female,GM0981,Vaals,2023JJ00,2023,5011,,21,,78,,-57,356,,166,190,348,,162,-19,186,8,-54,,4957
302650,4000,Female,GM0994,Valkenburg aan de Geul,2012JJ00,2012,8571,,37,,113,,-76,353,,39,314,362,,44,-1,318,-9,-86,,8485
302651,4000,Female,GM0994,Valkenburg aan de Geul,2013JJ00,2013,8485,,53,,118,,-65,397,,51,346,375,,40,-1,335,22,-43,,8442
302652,4000,Female,GM0994,Valkenburg aan de Geul,2014JJ00,2014,8442,,42,,117,,-75,458,,53,405,419,,45,-6,374,39,-36,,8406
302653,4000,Female,GM0994,Valkenburg aan de Geul,2015JJ00,2015,8406,,50,,114,,-64,489,,55,434,482,,43,-7,439,7,-58,,8348
302654,4000,Female,GM0994,Valkenburg aan de Geul,2016JJ00,2016,8348,,53,,113,,-60,505,,30,475,459,,46,-7,413,46,-12,,8336
302655,4000,Female,GM0994,Valkenburg aan de Geul,2017JJ00,2017,8336,,48,,123,,-75,528,,58,470,492,,42,1,450,36,-41,,8295
302656,4000,Female,GM0994,Valkenburg aan de Geul,2018JJ00,2018,8295,,46,,108,,-62,558,,69,489,435,,44,-2,391,123,59,,8354
302657,4000,Female,GM0994,Valkenburg aan de Geul,2019JJ00,2019,8354,,49,,117,,-68,505,,64,441,474,,46,-7,428,31,-36,,8318
302658,4000,Female,GM0994,Valkenburg aan de Geul,2020JJ00,2020,8318,,62,,141,,-79,561,,64,497,504,,31,1,473,57,-19,,8299
302659,4000,Female,GM0994,Valkenburg aan de Geul,2021JJ00,2021,8299,,52,,145,,-93,494,,51,443,509,,50,-6,459,-15,-112,,8187
302660,4000,Female,GM0994,Valkenburg aan de Geul,2022JJ00,2022,8187,,37,,116,,-79,736,,239,497,516,,88,-3,428,220,142,,8329
302661,4000,Female,GM0994,Valkenburg aan de Geul,2023JJ00,2023,8329,,46,,134,,-88,574,,108,466,482,,81,-5,401,92,5,,8334
302896,4000,Female,GM0858,Valkenswaard,2012JJ00,2012,15516,,114,,135,,-21,491,,82,409,525,,82,-13,443,-34,-55,,15461
302897,4000,Female,GM0858,Valkenswaard,2013JJ00,2013,15461,,100,,146,,-46,498,,71,427,565,,62,-3,503,-67,-113,,15348
302898,4000,Female,GM0858,Valkenswaard,2014JJ00,2014,15348,,117,,144,,-27,583,,102,481,573,,93,-6,480,10,-16,,15332
302899,4000,Female,GM0858,Valkenswaard,2015JJ00,2015,15332,,133,,158,,-25,560,,108,452,558,,64,-10,494,2,-25,,15307
302900,4000,Female,GM0858,Valkenswaard,2016JJ00,2016,15307,,115,,174,,-59,792,,139,653,617,,76,-9,541,175,117,,15424
302901,4000,Female,GM0858,Valkenswaard,2017JJ00,2017,15424,,125,,154,,-29,709,,98,611,614,,77,-1,537,95,65,,15489
302902,4000,Female,GM0858,Valkenswaard,2018JJ00,2018,15489,,135,,172,,-37,686,,108,578,525,,61,-4,464,161,127,,15616
302903,4000,Female,GM0858,Valkenswaard,2019JJ00,2019,15616,,128,,189,,-61,683,,116,567,539,,66,0,473,144,81,,15697
302904,4000,Female,GM0858,Valkenswaard,2020JJ00,2020,15697,,128,,183,,-55,701,,103,598,605,,76,-2,529,96,41,,15738
302905,4000,Female,GM0858,Valkenswaard,2021JJ00,2021,15738,,143,,193,,-50,704,,105,599,660,,100,-5,560,44,-7,,15731
302906,4000,Female,GM0858,Valkenswaard,2022JJ00,2022,15731,,120,,177,,-57,828,,216,612,593,,143,-28,450,235,178,,15909
302907,4000,Female,GM0858,Valkenswaard,2023JJ00,2023,15909,,131,,193,,-62,827,,182,645,705,,137,-8,568,122,60,,15969
303142,4000,Female,GM0047,Veendam,2012JJ00,2012,14112,,136,,157,,-21,575,,37,538,571,,34,0,537,4,-16,,14096
303143,4000,Female,GM0047,Veendam,2013JJ00,2013,14096,,132,,177,,-45,578,,23,555,606,,42,-3,564,-28,-73,,14023
303144,4000,Female,GM0047,Veendam,2014JJ00,2014,14023,,128,,165,,-37,548,,36,512,581,,36,-8,545,-33,-69,,13954
303145,4000,Female,GM0047,Veendam,2015JJ00,2015,13954,,100,,150,,-50,578,,38,540,656,,46,-10,610,-78,-128,,13826
303146,4000,Female,GM0047,Veendam,2016JJ00,2016,13826,,109,,150,,-41,693,,45,648,578,,38,-5,540,115,74,,13900
303147,4000,Female,GM0047,Veendam,2017JJ00,2017,13900,,106,,184,,-78,725,,35,690,706,,29,5,677,19,-59,,13841
303148,4000,Female,GM0047,Veendam,2018JJ00,2018,13841,,101,,175,,-74,703,,44,659,665,,51,-4,614,38,-35,,13806
303149,4000,Female,GM0047,Veendam,2019JJ00,2019,13806,,104,,171,,-67,729,,60,669,712,,35,-2,677,17,-51,,13755
303150,4000,Female,GM0047,Veendam,2020JJ00,2020,13755,,82,,158,,-76,714,,46,668,675,,45,-2,630,39,-38,,13717
303151,4000,Female,GM0047,Veendam,2021JJ00,2021,13717,,109,,164,,-55,683,,49,634,615,,36,-1,579,68,12,,13729
303152,4000,Female,GM0047,Veendam,2022JJ00,2022,13729,,122,,147,,-25,682,,98,584,633,,45,-8,588,49,24,,13753
303153,4000,Female,GM0047,Veendam,2023JJ00,2023,13753,,101,,157,,-56,629,,50,579,615,,48,-10,567,14,-41,,13712
303224,4000,Female,GM0345,Veenendaal,2012JJ00,2012,32013,,349,,225,,124,1018,,101,917,1078,,127,-16,951,-60,65,,32078
303225,4000,Female,GM0345,Veenendaal,2013JJ00,2013,32078,,339,,222,,117,1049,,114,935,1047,,94,-18,953,2,121,,32199
303226,4000,Female,GM0345,Veenendaal,2014JJ00,2014,32199,,401,,240,,161,1031,,100,931,1123,,127,0,996,-92,68,,32267
303227,4000,Female,GM0345,Veenendaal,2015JJ00,2015,32267,,358,,230,,128,1114,,139,975,1123,,110,-13,1013,-9,119,,32386
303228,4000,Female,GM0345,Veenendaal,2016JJ00,2016,32386,,445,,277,,168,1250,,120,1130,1233,,111,-16,1122,17,183,,32569
303229,4000,Female,GM0345,Veenendaal,2017JJ00,2017,32569,,377,,240,,137,1387,,112,1275,1214,,91,-11,1123,173,309,,32878
303230,4000,Female,GM0345,Veenendaal,2018JJ00,2018,32878,,357,,270,,87,1389,,133,1256,1118,,76,-6,1042,271,360,,33238
303231,4000,Female,GM0345,Veenendaal,2019JJ00,2019,33238,,421,,281,,140,1413,,141,1272,1158,,61,-2,1097,255,397,,33635
303232,4000,Female,GM0345,Veenendaal,2020JJ00,2020,33635,,387,,329,,58,1290,,137,1153,1200,,62,-12,1138,90,149,,33784
303233,4000,Female,GM0345,Veenendaal,2021JJ00,2021,33784,,390,,301,,89,1463,,142,1321,1195,,107,-18,1088,268,358,,34142
303234,4000,Female,GM0345,Veenendaal,2022JJ00,2022,34142,,403,,299,,104,1462,,308,1154,1165,,115,-15,1050,297,402,,34544
303235,4000,Female,GM0345,Veenendaal,2023JJ00,2023,34544,,335,,288,,47,1570,,218,1352,1243,,130,-25,1113,327,375,,34919
303306,4000,Female,GM0717,Veere,2012JJ00,2012,10965,,92,,92,,0,481,,58,423,495,,37,-4,458,-14,-15,,10950
303307,4000,Female,GM0717,Veere,2013JJ00,2013,10950,,93,,100,,-7,456,,45,411,463,,27,1,436,-7,-14,,10936
303308,4000,Female,GM0717,Veere,2014JJ00,2014,10936,,89,,95,,-6,485,,46,439,480,,41,-7,439,5,-1,,10935
303309,4000,Female,GM0717,Veere,2015JJ00,2015,10935,,114,,117,,-3,498,,52,446,487,,40,-3,447,11,8,,10943
303310,4000,Female,GM0717,Veere,2016JJ00,2016,10943,,90,,119,,-29,484,,39,445,516,,28,-3,488,-32,-61,,10882
303311,4000,Female,GM0717,Veere,2017JJ00,2017,10882,,96,,107,,-11,515,,51,464,468,,24,-3,444,47,35,,10917
303312,4000,Female,GM0717,Veere,2018JJ00,2018,10917,,91,,110,,-19,533,,46,487,487,,38,-5,449,46,25,,10942
303313,4000,Female,GM0717,Veere,2019JJ00,2019,10942,,94,,109,,-15,464,,60,404,429,,24,-1,405,35,21,,10963
303314,4000,Female,GM0717,Veere,2020JJ00,2020,10963,,106,,98,,8,511,,58,453,470,,22,-3,448,41,48,,11011
303315,4000,Female,GM0717,Veere,2021JJ00,2021,11011,,100,,137,,-37,441,,41,400,454,,40,-6,414,-13,-49,,10962
303316,4000,Female,GM0717,Veere,2022JJ00,2022,10962,,93,,114,,-21,673,,241,432,508,,87,-6,421,165,141,,11103
303317,4000,Female,GM0717,Veere,2023JJ00,2023,11103,,89,,129,,-40,585,,96,489,492,,67,-7,425,93,53,,11156
303388,4000,Female,GM0860,Veghel,2012JJ00,2012,18675,,204,,145,,59,623,,121,502,739,,82,-12,657,-116,-59,,18616
303389,4000,Female,GM0860,Veghel,2013JJ00,2013,18616,,169,,154,,15,687,,100,587,677,,72,-11,605,10,25,,18641
303390,4000,Female,GM0860,Veghel,2014JJ00,2014,18641,,193,,131,,62,863,,247,616,748,,119,-17,629,115,173,,18814
303391,4000,Female,GM0860,Veghel,2015JJ00,2015,18814,,173,,158,,15,860,,174,686,777,,118,-22,659,83,99,,18913
303392,4000,Female,GM0860,Veghel,2016JJ00,2016,18913,,216,,149,,67,835,,184,651,776,,127,-20,649,59,99,,19012
303470,4000,Female,GM0861,Veldhoven,2012JJ00,2012,22001,,219,,138,,81,931,,162,769,932,,130,-20,802,-1,79,,22080
303471,4000,Female,GM0861,Veldhoven,2013JJ00,2013,22080,,219,,157,,62,954,,165,789,946,,141,-14,805,8,68,,22148
303472,4000,Female,GM0861,Veldhoven,2014JJ00,2014,22148,,216,,154,,62,977,,141,836,1031,,150,-7,881,-54,6,,22154
303473,4000,Female,GM0861,Veldhoven,2015JJ00,2015,22154,,200,,165,,35,1068,,131,937,1020,,163,-20,857,48,82,,22236
303474,4000,Female,GM0861,Veldhoven,2016JJ00,2016,22236,,206,,190,,16,1220,,158,1062,1033,,128,-10,905,187,203,,22439
303475,4000,Female,GM0861,Veldhoven,2017JJ00,2017,22439,,195,,184,,11,1256,,144,1112,1209,,106,-11,1103,47,57,,22496
303476,4000,Female,GM0861,Veldhoven,2018JJ00,2018,22496,,174,,195,,-21,1296,,173,1123,1085,,114,-17,971,211,189,,22685
303477,4000,Female,GM0861,Veldhoven,2019JJ00,2019,22685,,195,,190,,5,1186,,190,996,1167,,115,-6,1052,19,21,,22706
303478,4000,Female,GM0861,Veldhoven,2020JJ00,2020,22706,,206,,208,,-2,1137,,160,977,1121,,81,-9,1040,16,12,,22718
303479,4000,Female,GM0861,Veldhoven,2021JJ00,2021,22718,,198,,206,,-8,1297,,179,1118,1130,,120,-9,1010,167,152,,22870
303480,4000,Female,GM0861,Veldhoven,2022JJ00,2022,22870,,167,,208,,-41,1499,,337,1162,1274,,179,-17,1095,225,184,,23054
303481,4000,Female,GM0861,Veldhoven,2023JJ00,2023,23054,,188,,230,,-42,1478,,306,1172,1244,,151,-5,1093,234,191,,23245
303716,4000,Female,GM0453,Velsen,2012JJ00,2012,33996,,281,,338,,-57,1154,,194,960,1255,,147,-30,1108,-101,-157,,33839
303717,4000,Female,GM0453,Velsen,2013JJ00,2013,33839,,294,,338,,-44,1213,,179,1034,1123,,135,-20,988,90,42,,33881
303718,4000,Female,GM0453,Velsen,2014JJ00,2014,33881,,315,,342,,-27,1376,,192,1184,1333,,137,-14,1196,43,18,,33899
303719,4000,Female,GM0453,Velsen,2015JJ00,2015,33899,,284,,367,,-83,1482,,217,1265,1296,,153,-26,1143,186,105,,34004
303720,4000,Female,GM0453,Velsen,2016JJ00,2016,34004,,319,,381,,-62,1502,,188,1314,1361,,147,-31,1214,141,74,,34078
303721,4000,Female,GM0453,Velsen,2017JJ00,2017,34078,,286,,386,,-100,1576,,198,1378,1387,,144,-20,1243,189,84,,34162
303722,4000,Female,GM0453,Velsen,2018JJ00,2018,34162,,294,,343,,-49,1583,,247,1336,1266,,172,-23,1094,317,274,,34436
303723,4000,Female,GM0453,Velsen,2019JJ00,2019,34436,,275,,361,,-86,1693,,243,1450,1482,,186,-28,1296,211,122,,34558
303724,4000,Female,GM0453,Velsen,2020JJ00,2020,34558,,289,,394,,-105,1540,,175,1365,1479,,139,-19,1340,61,-40,,34518
303725,4000,Female,GM0453,Velsen,2021JJ00,2021,34518,,319,,381,,-62,1501,,181,1320,1412,,118,-19,1294,89,26,,34544
303726,4000,Female,GM0453,Velsen,2022JJ00,2022,34544,,308,,406,,-98,1712,,374,1338,1477,,155,-24,1322,235,139,,34683
303727,4000,Female,GM0453,Velsen,2023JJ00,2023,34683,,283,,417,,-134,1835,,324,1511,1544,,213,-49,1331,291,153,,34836
303880,4000,Female,GM0983,Venlo,2012JJ00,2012,50428,,500,,444,,56,1598,,578,1020,1635,,333,-48,1302,-37,23,,50451
303881,4000,Female,GM0983,Venlo,2013JJ00,2013,50451,,466,,483,,-17,1659,,585,1074,1551,,303,-50,1248,108,88,,50539
303882,4000,Female,GM0983,Venlo,2014JJ00,2014,50539,,432,,486,,-54,1769,,642,1127,1695,,330,-32,1365,74,19,,50558
303883,4000,Female,GM0983,Venlo,2015JJ00,2015,50558,,404,,496,,-92,1751,,490,1261,1689,,410,-105,1279,62,-29,,50529
303884,4000,Female,GM0983,Venlo,2016JJ00,2016,50529,,466,,499,,-33,1991,,666,1325,1703,,305,-29,1398,288,249,,50778
303885,4000,Female,GM0983,Venlo,2017JJ00,2017,50778,,455,,500,,-45,2017,,648,1369,1897,,435,-75,1462,120,64,,50842
303886,4000,Female,GM0983,Venlo,2018JJ00,2018,50842,,465,,514,,-49,1939,,750,1189,1757,,441,-67,1316,182,135,,50977
303887,4000,Female,GM0983,Venlo,2019JJ00,2019,50977,,441,,503,,-62,1949,,789,1160,1813,,537,-126,1276,136,73,,51050
303888,4000,Female,GM0983,Venlo,2020JJ00,2020,51050,,449,,484,,-35,1831,,671,1160,1745,,385,-39,1360,86,50,,51100
303889,4000,Female,GM0983,Venlo,2021JJ00,2021,51100,,504,,547,,-43,1919,,680,1239,1822,,438,-113,1384,97,50,,51150
303890,4000,Female,GM0983,Venlo,2022JJ00,2022,51150,,444,,503,,-59,2511,,1271,1240,1811,,548,-100,1263,700,647,,51797
303891,4000,Female,GM0983,Venlo,2023JJ00,2023,51797,,436,,558,,-122,2225,,964,1261,2035,,595,-120,1440,190,63,,51860
303962,4000,Female,GM0984,Venray,2012JJ00,2012,21331,,180,,165,,15,717,,173,544,709,,97,-5,612,8,23,,21354
303963,4000,Female,GM0984,Venray,2013JJ00,2013,21354,,194,,160,,34,664,,158,506,712,,108,-11,604,-48,-15,,21339
303964,4000,Female,GM0984,Venray,2014JJ00,2014,21339,,171,,157,,14,777,,181,596,778,,145,-18,633,-1,16,,21355
303965,4000,Female,GM0984,Venray,2015JJ00,2015,21355,,163,,173,,-10,770,,197,573,719,,123,-17,596,51,42,,21397
303966,4000,Female,GM0984,Venray,2016JJ00,2016,21397,,195,,172,,23,868,,194,674,856,,128,-5,728,12,34,,21431
303967,4000,Female,GM0984,Venray,2017JJ00,2017,21431,,191,,173,,18,920,,188,732,1078,,133,-11,945,-158,-138,,21293
303968,4000,Female,GM0984,Venray,2018JJ00,2018,21293,,194,,172,,22,794,,180,614,814,,102,-7,712,-20,0,,21293
303969,4000,Female,GM0984,Venray,2019JJ00,2019,21293,,202,,177,,25,882,,233,649,787,,120,-13,667,95,119,,21412
303970,4000,Female,GM0984,Venray,2020JJ00,2020,21412,,205,,191,,14,800,,175,625,766,,105,-6,661,34,47,,21459
303971,4000,Female,GM0984,Venray,2021JJ00,2021,21459,,200,,200,,0,867,,184,683,765,,132,-17,633,102,103,,21562
303972,4000,Female,GM0984,Venray,2022JJ00,2022,21562,,184,,198,,-14,1149,,456,693,791,,197,-23,594,358,342,,21904
303973,4000,Female,GM0984,Venray,2023JJ00,2023,21904,,152,,210,,-58,983,,365,618,957,,272,-56,685,26,-29,,21875
304126,4000,Female,GM0620,Vianen,2012JJ00,2012,9991,,89,,62,,27,357,,38,319,383,,27,-3,356,-26,0,,9991
304127,4000,Female,GM0620,Vianen,2013JJ00,2013,9991,,106,,86,,20,334,,29,305,409,,47,-6,362,-75,-53,,9938
304128,4000,Female,GM0620,Vianen,2014JJ00,2014,9938,,94,,78,,16,395,,24,371,399,,13,3,386,-4,12,,9950
304129,4000,Female,GM0620,Vianen,2015JJ00,2015,9950,,89,,106,,-17,410,,41,369,444,,44,-7,400,-34,-51,,9899
304130,4000,Female,GM0620,Vianen,2016JJ00,2016,9899,,82,,93,,-11,594,,37,557,464,,26,1,438,130,115,,10014
304131,4000,Female,GM0620,Vianen,2017JJ00,2017,10014,,95,,104,,-9,641,,31,610,493,,28,-1,465,148,138,,10152
304132,4000,Female,GM0620,Vianen,2018JJ00,2018,10152,,104,,90,,14,650,,38,612,444,,30,-3,414,206,221,,10373
304379,4000,Female,GM1961,Vijfheerenlanden,2019JJ00,2019,28146,,332,,289,,43,1492,,131,1361,1033,,83,-12,950,459,502,,28648
304380,4000,Female,GM1961,Vijfheerenlanden,2020JJ00,2020,28648,,337,,319,,18,1518,,85,1433,1006,,45,0,961,512,529,,29177
304381,4000,Female,GM1961,Vijfheerenlanden,2021JJ00,2021,29177,,384,,306,,78,1520,,114,1406,1168,,91,0,1077,352,425,,29602
304382,4000,Female,GM1961,Vijfheerenlanden,2022JJ00,2022,29602,,327,,317,,10,1721,,284,1437,1123,,122,-8,1001,598,604,,30206
304383,4000,Female,GM1961,Vijfheerenlanden,2023JJ00,2023,30206,,390,,298,,92,1860,,177,1683,1114,,128,-16,986,746,837,,31043
304536,4000,Female,GM0622,Vlaardingen,2012JJ00,2012,36332,,381,,371,,10,1528,,321,1207,1579,,284,-54,1295,-51,-39,,36293
304537,4000,Female,GM0622,Vlaardingen,2013JJ00,2013,36293,,381,,369,,12,1643,,335,1308,1563,,299,-41,1264,80,88,,36381
304538,4000,Female,GM0622,Vlaardingen,2014JJ00,2014,36381,,402,,343,,59,1882,,531,1351,1534,,312,-48,1222,348,405,,36786
304539,4000,Female,GM0622,Vlaardingen,2015JJ00,2015,36786,,388,,401,,-13,1746,,343,1403,1698,,367,-124,1331,48,33,,36819
304540,4000,Female,GM0622,Vlaardingen,2016JJ00,2016,36819,,380,,400,,-20,1709,,318,1391,1655,,274,-63,1381,54,33,,36852
304541,4000,Female,GM0622,Vlaardingen,2017JJ00,2017,36852,,370,,376,,-6,1781,,315,1466,1669,,235,-44,1434,112,107,,36959
304542,4000,Female,GM0622,Vlaardingen,2018JJ00,2018,36959,,352,,380,,-28,1857,,333,1524,1660,,226,-25,1434,197,167,,37126
304543,4000,Female,GM0622,Vlaardingen,2019JJ00,2019,37126,,384,,409,,-25,2168,,480,1688,1577,,250,-63,1327,591,564,,37690
304544,4000,Female,GM0622,Vlaardingen,2020JJ00,2020,37690,,442,,427,,15,2126,,466,1660,1835,,285,-51,1550,291,304,,37994
304545,4000,Female,GM0622,Vlaardingen,2021JJ00,2021,37994,,387,,416,,-29,2097,,448,1649,1976,,315,-40,1661,121,88,,38082
304546,4000,Female,GM0622,Vlaardingen,2022JJ00,2022,38082,,367,,426,,-59,2314,,638,1676,1786,,302,-23,1484,528,471,,38553
304547,4000,Female,GM0622,Vlaardingen,2023JJ00,2023,38553,,368,,454,,-86,2703,,650,2053,1909,,392,-38,1517,794,705,,39258
304618,4000,Female,GM0048,Vlagtwedde,2012JJ00,2012,8149,,74,,84,,-10,528,,29,499,563,,85,-51,478,-35,-45,,8104
304619,4000,Female,GM0048,Vlagtwedde,2013JJ00,2013,8104,,58,,93,,-35,333,,29,304,411,,60,-24,351,-78,-109,,7995
304620,4000,Female,GM0048,Vlagtwedde,2014JJ00,2014,7995,,63,,81,,-18,847,,513,334,719,,42,-12,677,128,113,,8108
304621,4000,Female,GM0048,Vlagtwedde,2015JJ00,2015,8108,,72,,87,,-15,1572,,1248,324,1537,,54,-28,1483,35,32,,8140
304622,4000,Female,GM0048,Vlagtwedde,2016JJ00,2016,8140,,66,,91,,-25,1549,,1215,334,1709,,44,-18,1665,-160,-171,,7969
304623,4000,Female,GM0048,Vlagtwedde,2017JJ00,2017,7969,,74,,91,,-17,1160,,679,481,1157,,25,-7,1132,3,-13,,7956
304946,4000,Female,GM0096,Vlieland,2012JJ00,2012,552,,1,,3,,-2,73,,20,53,57,,9,-5,48,16,14,,566
304947,4000,Female,GM0096,Vlieland,2013JJ00,2013,566,,1,,2,,-1,78,,17,61,76,,13,-2,63,2,1,,567
304948,4000,Female,GM0096,Vlieland,2014JJ00,2014,567,,5,,1,,4,73,,13,60,84,,13,-6,71,-11,-7,,560
304949,4000,Female,GM0096,Vlieland,2015JJ00,2015,560,,4,,7,,-3,76,,22,54,74,,18,-10,56,2,-2,,558
304950,4000,Female,GM0096,Vlieland,2016JJ00,2016,558,,1,,14,,-13,80,,11,69,72,,6,-1,66,8,-6,,552
304951,4000,Female,GM0096,Vlieland,2017JJ00,2017,552,,2,,6,,-4,94,,22,72,73,,6,-1,67,21,17,,569
304952,4000,Female,GM0096,Vlieland,2018JJ00,2018,569,,2,,7,,-5,96,,46,50,104,,33,-8,71,-8,-12,,557
304953,4000,Female,GM0096,Vlieland,2019JJ00,2019,557,,6,,2,,4,134,,52,82,121,,47,-11,74,13,15,,572
304954,4000,Female,GM0096,Vlieland,2020JJ00,2020,572,,1,,4,,-3,126,,44,82,98,,28,-1,70,28,26,,598
304955,4000,Female,GM0096,Vlieland,2021JJ00,2021,598,,5,,2,,3,138,,43,95,132,,50,-26,82,6,8,,606
304956,4000,Female,GM0096,Vlieland,2022JJ00,2022,606,,2,,2,,0,125,,54,71,94,,25,-3,69,31,31,,637
304957,4000,Female,GM0096,Vlieland,2023JJ00,2023,637,,5,,5,,0,81,,36,45,104,,37,-14,67,-23,-26,,611
305110,4000,Female,GM0718,Vlissingen,2012JJ00,2012,22348,,199,,265,,-66,1090,,300,790,1054,,234,-74,820,36,-28,,22320
305111,4000,Female,GM0718,Vlissingen,2013JJ00,2013,22320,,186,,279,,-93,1101,,277,824,1022,,198,-68,824,79,-14,,22306
305112,4000,Female,GM0718,Vlissingen,2014JJ00,2014,22306,,206,,241,,-35,1088,,248,840,1049,,227,-59,822,39,5,,22311
305113,4000,Female,GM0718,Vlissingen,2015JJ00,2015,22311,,191,,261,,-70,1231,,332,899,1121,,233,-82,888,110,43,,22354
305114,4000,Female,GM0718,Vlissingen,2016JJ00,2016,22354,,208,,278,,-70,1222,,290,932,1169,,244,-71,925,53,-20,,22334
305115,4000,Female,GM0718,Vlissingen,2017JJ00,2017,22334,,203,,278,,-75,1273,,315,958,1141,,198,-46,943,132,58,,22392
305116,4000,Female,GM0718,Vlissingen,2018JJ00,2018,22392,,170,,290,,-120,1320,,376,944,1307,,275,-90,1032,13,-109,,22283
305117,4000,Female,GM0718,Vlissingen,2019JJ00,2019,22283,,188,,239,,-51,1268,,443,825,1238,,260,-63,978,30,-26,,22257
305118,4000,Female,GM0718,Vlissingen,2020JJ00,2020,22257,,172,,269,,-97,1283,,336,947,1189,,205,-42,984,94,-13,,22244
305119,4000,Female,GM0718,Vlissingen,2021JJ00,2021,22244,,186,,316,,-130,1403,,374,1029,1129,,267,-90,862,274,136,,22380
305120,4000,Female,GM0718,Vlissingen,2022JJ00,2022,22380,,157,,285,,-128,1609,,608,1001,1245,,312,-62,933,364,234,,22614
305121,4000,Female,GM0718,Vlissingen,2023JJ00,2023,22614,,137,,279,,-142,1484,,415,1069,1269,,293,-82,976,215,66,,22680
305192,4000,Female,GM0623,Vlist,2012JJ00,2012,4910,,31,,42,,-11,168,,14,154,201,,5,-1,196,-33,-44,,4866
305193,4000,Female,GM0623,Vlist,2013JJ00,2013,4866,,40,,35,,5,160,,1,159,177,,5,3,172,-17,-12,,4854
305194,4000,Female,GM0623,Vlist,2014JJ00,2014,4854,,54,,44,,10,195,,17,178,174,,12,-3,162,21,17,,4871
305356,4000,Female,GM0986,Voerendaal,2012JJ00,2012,6350,,44,,38,,6,240,,20,220,271,,13,2,258,-31,-24,,6326
305357,4000,Female,GM0986,Voerendaal,2013JJ00,2013,6326,,42,,45,,-3,216,,26,190,280,,13,-2,267,-64,-68,,6258
305358,4000,Female,GM0986,Voerendaal,2014JJ00,2014,6258,,51,,56,,-5,290,,13,277,288,,12,6,276,2,-4,,6254
305359,4000,Female,GM0986,Voerendaal,2015JJ00,2015,6254,,50,,40,,10,293,,16,277,246,,11,-1,235,47,58,,6312
305360,4000,Female,GM0986,Voerendaal,2016JJ00,2016,6312,,45,,51,,-6,286,,13,273,274,,18,-1,256,12,7,,6319
305361,4000,Female,GM0986,Voerendaal,2017JJ00,2017,6319,,36,,61,,-25,336,,19,317,326,,13,0,313,10,-15,,6304
305362,4000,Female,GM0986,Voerendaal,2018JJ00,2018,6304,,55,,53,,2,327,,29,298,320,,15,1,305,7,9,,6313
305363,4000,Female,GM0986,Voerendaal,2019JJ00,2019,6313,,53,,62,,-9,343,,24,319,312,,13,2,299,31,25,,6338
305364,4000,Female,GM0986,Voerendaal,2020JJ00,2020,6338,,35,,68,,-33,344,,32,312,299,,10,0,289,45,11,,6349
305365,4000,Female,GM0986,Voerendaal,2021JJ00,2021,6349,,62,,61,,1,279,,19,260,297,,24,0,273,-18,-16,,6333
305366,4000,Female,GM0986,Voerendaal,2022JJ00,2022,6333,,47,,84,,-37,303,,76,227,284,,23,0,261,19,-17,,6316
305367,4000,Female,GM0986,Voerendaal,2023JJ00,2023,6316,,42,,64,,-22,308,,34,274,310,,22,1,288,-2,-24,,6292
305777,4000,Female,GM1992,Voorne aan Zee,2023JJ00,2023,37363,,276,,396,,-120,1627,,306,1321,1367,,199,-50,1168,260,139,,37502
305848,4000,Female,GM0626,Voorschoten,2012JJ00,2012,12579,,136,,122,,14,683,,74,609,530,,78,-3,452,153,169,,12748
305849,4000,Female,GM0626,Voorschoten,2013JJ00,2013,12748,,128,,129,,-1,680,,105,575,524,,110,-5,414,156,161,,12909
305850,4000,Female,GM0626,Voorschoten,2014JJ00,2014,12909,,114,,117,,-3,696,,100,596,576,,99,-2,477,120,117,,13026
305851,4000,Female,GM0626,Voorschoten,2015JJ00,2015,13026,,122,,112,,10,746,,136,610,677,,141,-6,536,69,79,,13105
305852,4000,Female,GM0626,Voorschoten,2016JJ00,2016,13105,,104,,110,,-6,790,,90,700,748,,120,-10,628,42,36,,13141
305853,4000,Female,GM0626,Voorschoten,2017JJ00,2017,13141,,119,,114,,5,773,,102,671,730,,115,-12,615,43,47,,13188
305854,4000,Female,GM0626,Voorschoten,2018JJ00,2018,13188,,110,,136,,-26,702,,126,576,667,,68,-2,599,35,9,,13197
305855,4000,Female,GM0626,Voorschoten,2019JJ00,2019,13197,,111,,129,,-18,750,,158,592,661,,86,-4,575,89,71,,13268
305856,4000,Female,GM0626,Voorschoten,2020JJ00,2020,13268,,99,,161,,-62,725,,131,594,672,,88,-9,584,53,-8,,13260
305857,4000,Female,GM0626,Voorschoten,2021JJ00,2021,13260,,102,,130,,-28,723,,160,563,745,,91,-4,654,-22,-51,,13209
305858,4000,Female,GM0626,Voorschoten,2022JJ00,2022,13209,,95,,149,,-54,818,,233,585,807,,124,-4,683,11,-44,,13165
305859,4000,Female,GM0626,Voorschoten,2023JJ00,2023,13165,,84,,144,,-60,864,,235,629,822,,150,-5,672,42,-16,,13149
305930,4000,Female,GM0285,Voorst,2012JJ00,2012,11876,,110,,122,,-12,453,,22,431,476,,27,-3,449,-23,-34,,11842
305931,4000,Female,GM0285,Voorst,2013JJ00,2013,11842,,99,,108,,-9,494,,21,473,435,,15,3,420,59,50,,11892
305932,4000,Female,GM0285,Voorst,2014JJ00,2014,11892,,98,,111,,-13,536,,36,500,473,,20,1,453,63,51,,11943
305933,4000,Female,GM0285,Voorst,2015JJ00,2015,11943,,116,,106,,10,511,,30,481,460,,15,-1,445,51,60,,12003
305934,4000,Female,GM0285,Voorst,2016JJ00,2016,12003,,87,,115,,-28,637,,26,611,509,,21,2,488,128,100,,12103
305935,4000,Female,GM0285,Voorst,2017JJ00,2017,12103,,94,,113,,-19,628,,19,609,551,,25,-6,526,77,59,,12162
305936,4000,Female,GM0285,Voorst,2018JJ00,2018,12162,,101,,124,,-23,617,,34,583,523,,17,-1,506,94,71,,12233
305937,4000,Female,GM0285,Voorst,2019JJ00,2019,12233,,95,,130,,-35,586,,26,560,518,,28,0,490,68,32,,12265
305938,4000,Female,GM0285,Voorst,2020JJ00,2020,12265,,118,,106,,12,637,,47,590,531,,17,-1,514,106,117,,12382
305939,4000,Female,GM0285,Voorst,2021JJ00,2021,12382,,94,,116,,-22,616,,31,585,476,,24,2,452,140,117,,12499
305940,4000,Female,GM0285,Voorst,2022JJ00,2022,12499,,110,,139,,-29,596,,90,506,441,,37,-9,404,155,126,,12625
305941,4000,Female,GM0285,Voorst,2023JJ00,2023,12625,,119,,124,,-5,586,,60,526,542,,57,0,485,44,40,,12665
306504,4000,Female,GM0865,Vught,2012JJ00,2012,13061,,113,,176,,-63,710,,51,659,803,,126,-47,677,-93,-156,,12905
306505,4000,Female,GM0865,Vught,2013JJ00,2013,12905,,103,,171,,-68,671,,53,618,590,,47,-11,543,81,14,,12919
306506,4000,Female,GM0865,Vught,2014JJ00,2014,12919,,101,,169,,-68,767,,59,708,581,,26,1,555,186,117,,13036
306507,4000,Female,GM0865,Vught,2015JJ00,2015,13036,,125,,193,,-68,821,,54,767,664,,65,-7,599,157,88,,13124
306508,4000,Female,GM0865,Vught,2016JJ00,2016,13124,,136,,169,,-33,769,,45,724,669,,48,-1,621,100,64,,13188
306509,4000,Female,GM0865,Vught,2017JJ00,2017,13188,,107,,164,,-57,818,,72,746,681,,36,0,645,137,79,,13267
306510,4000,Female,GM0865,Vught,2018JJ00,2018,13267,,133,,170,,-37,733,,53,680,733,,49,-6,684,0,-38,,13229
306511,4000,Female,GM0865,Vught,2019JJ00,2019,13229,,111,,150,,-39,780,,69,711,693,,52,-2,641,87,48,,13277
306512,4000,Female,GM0865,Vught,2020JJ00,2020,13277,,107,,187,,-80,919,,95,824,677,,50,-8,627,242,162,,13439
306513,4000,Female,GM0865,Vught,2021JJ00,2021,15914,,152,,210,,-58,909,,100,809,807,,67,-11,740,102,43,,15957
306514,4000,Female,GM0865,Vught,2022JJ00,2022,15957,,147,,212,,-65,933,,202,731,729,,98,-13,631,204,139,,16096
306515,4000,Female,GM0865,Vught,2023JJ00,2023,16096,,134,,220,,-86,922,,178,744,719,,92,-13,627,203,115,,16211
306674,4000,Female,GM1949,Waadhoeke,2018JJ00,2018,22651,,199,,242,,-43,1158,,166,992,1085,,65,-8,1020,73,29,,22680
306675,4000,Female,GM1949,Waadhoeke,2019JJ00,2019,22680,,196,,221,,-25,1092,,156,936,1080,,60,-4,1020,12,-13,,22667
306676,4000,Female,GM1949,Waadhoeke,2020JJ00,2020,22667,,180,,224,,-44,1095,,104,991,1008,,60,-12,948,87,46,,22713
306677,4000,Female,GM1949,Waadhoeke,2021JJ00,2021,22713,,226,,227,,-1,1161,,88,1073,1062,,70,-9,992,99,100,,22813
306678,4000,Female,GM1949,Waadhoeke,2022JJ00,2022,22813,,172,,253,,-81,1274,,251,1023,1003,,97,-12,906,271,188,,23001
306679,4000,Female,GM1949,Waadhoeke,2023JJ00,2023,23001,,189,,231,,-42,1191,,235,956,1018,,148,-35,870,173,135,,23136
306750,4000,Female,GM0866,Waalre,2012JJ00,2012,8360,,68,,76,,-8,462,,42,420,353,,32,0,321,109,100,,8460
306751,4000,Female,GM0866,Waalre,2013JJ00,2013,8460,,59,,82,,-23,454,,48,406,401,,45,-7,356,53,31,,8491
306752,4000,Female,GM0866,Waalre,2014JJ00,2014,8491,,73,,74,,-1,471,,49,422,413,,50,2,363,58,57,,8548
306753,4000,Female,GM0866,Waalre,2015JJ00,2015,8548,,85,,86,,-1,498,,35,463,418,,43,-4,375,80,80,,8628
306754,4000,Female,GM0866,Waalre,2016JJ00,2016,8628,,73,,86,,-13,442,,55,387,478,,59,-3,419,-36,-49,,8579
306755,4000,Female,GM0866,Waalre,2017JJ00,2017,8579,,56,,69,,-13,551,,58,493,456,,33,0,423,95,81,,8660
306756,4000,Female,GM0866,Waalre,2018JJ00,2018,8660,,71,,85,,-14,516,,58,458,459,,33,3,426,57,44,,8704
306757,4000,Female,GM0866,Waalre,2019JJ00,2019,8704,,72,,95,,-23,551,,66,485,456,,36,1,420,95,71,,8775
306758,4000,Female,GM0866,Waalre,2020JJ00,2020,8775,,78,,89,,-11,543,,70,473,497,,40,-2,457,46,37,,8812
306759,4000,Female,GM0866,Waalre,2021JJ00,2021,8812,,89,,81,,8,545,,65,480,469,,43,-3,426,76,83,,8895
306760,4000,Female,GM0866,Waalre,2022JJ00,2022,8895,,72,,88,,-16,645,,148,497,489,,53,-2,436,156,140,,9035
306761,4000,Female,GM0866,Waalre,2023JJ00,2023,9035,,65,,94,,-29,548,,89,459,505,,69,-1,436,43,13,,9048
306832,4000,Female,GM0867,Waalwijk,2012JJ00,2012,23317,,223,,195,,28,876,,159,717,890,,104,-10,786,-14,13,,23330
306833,4000,Female,GM0867,Waalwijk,2013JJ00,2013,23330,,212,,198,,14,852,,140,712,856,,85,-8,771,-4,10,,23340
306834,4000,Female,GM0867,Waalwijk,2014JJ00,2014,23340,,211,,216,,-5,950,,165,785,850,,69,-7,781,100,97,,23437
306835,4000,Female,GM0867,Waalwijk,2015JJ00,2015,23437,,222,,206,,16,1094,,186,908,965,,99,-12,866,129,145,,23582
306836,4000,Female,GM0867,Waalwijk,2016JJ00,2016,23582,,235,,206,,29,1157,,194,963,973,,103,-19,870,184,212,,23794
306837,4000,Female,GM0867,Waalwijk,2017JJ00,2017,23794,,240,,216,,24,1254,,198,1056,1132,,145,-34,987,122,143,,23937
306838,4000,Female,GM0867,Waalwijk,2018JJ00,2018,23937,,251,,267,,-16,1300,,244,1056,1024,,106,-18,918,276,261,,24198
306839,4000,Female,GM0867,Waalwijk,2019JJ00,2019,24198,,241,,220,,21,1280,,233,1047,1104,,115,-28,989,176,200,,24398
306840,4000,Female,GM0867,Waalwijk,2020JJ00,2020,24398,,202,,244,,-42,1315,,306,1009,1199,,134,-20,1065,116,74,,24472
306841,4000,Female,GM0867,Waalwijk,2021JJ00,2021,24472,,226,,262,,-36,1445,,408,1037,1230,,217,-23,1013,215,174,,24646
306842,4000,Female,GM0867,Waalwijk,2022JJ00,2022,24646,,250,,306,,-56,1612,,586,1026,1239,,293,-26,946,373,316,,24962
306843,4000,Female,GM0867,Waalwijk,2023JJ00,2023,24962,,215,,259,,-44,1434,,411,1023,1256,,251,-14,1005,178,135,,25097
307160,4000,Female,GM0627,Waddinxveen,2012JJ00,2012,12679,,113,,79,,34,456,,39,417,492,,34,-8,458,-36,-2,,12677
307161,4000,Female,GM0627,Waddinxveen,2013JJ00,2013,12677,,120,,91,,29,564,,50,514,465,,37,0,428,99,128,,12805
307162,4000,Female,GM0627,Waddinxveen,2014JJ00,2014,12805,,155,,73,,82,521,,68,453,510,,25,1,485,11,95,,12900
307163,4000,Female,GM0627,Waddinxveen,2015JJ00,2015,12900,,123,,92,,31,678,,69,609,499,,25,-3,474,179,207,,13107
307164,4000,Female,GM0627,Waddinxveen,2016JJ00,2016,13107,,138,,87,,51,699,,53,646,512,,34,0,478,187,237,,13344
307165,4000,Female,GM0627,Waddinxveen,2017JJ00,2017,13344,,167,,77,,90,1041,,80,961,598,,61,-13,537,443,529,,13873
307166,4000,Female,GM0627,Waddinxveen,2018JJ00,2018,13873,,170,,86,,84,897,,60,837,598,,46,-9,552,299,385,,14258
307167,4000,Female,GM0627,Waddinxveen,2019JJ00,2019,14258,,178,,84,,94,1022,,70,952,583,,41,-10,542,439,533,,14791
307168,4000,Female,GM0627,Waddinxveen,2020JJ00,2020,14791,,189,,88,,101,1127,,74,1053,658,,52,-5,606,469,571,,15362
307169,4000,Female,GM0627,Waddinxveen,2021JJ00,2021,15362,,220,,93,,127,953,,88,865,649,,69,-2,580,304,431,,15793
307170,4000,Female,GM0627,Waddinxveen,2022JJ00,2022,15793,,220,,101,,119,1297,,235,1062,806,,127,-10,679,491,611,,16404
307171,4000,Female,GM0627,Waddinxveen,2023JJ00,2023,16404,,238,,98,,140,1356,,159,1197,791,,110,-5,681,565,703,,17107
307324,4000,Female,GM0289,Wageningen,2012JJ00,2012,19283,,147,,235,,-88,2077,,667,1410,1923,,689,-165,1234,154,103,,19386
307325,4000,Female,GM0289,Wageningen,2013JJ00,2013,19386,,146,,187,,-41,2406,,789,1617,2341,,1105,-547,1236,65,25,,19411
307326,4000,Female,GM0289,Wageningen,2014JJ00,2014,19411,,132,,205,,-73,2361,,781,1580,2113,,775,-136,1338,248,176,,19587
307327,4000,Female,GM0289,Wageningen,2015JJ00,2015,19587,,146,,202,,-56,2375,,974,1401,2300,,810,-178,1490,75,25,,19612
307328,4000,Female,GM0289,Wageningen,2016JJ00,2016,19612,,166,,184,,-18,2722,,1079,1643,2341,,844,-169,1497,381,377,,19989
307329,4000,Female,GM0289,Wageningen,2017JJ00,2017,19989,,127,,190,,-63,2561,,1100,1461,2517,,972,-237,1545,44,-40,,19949
307330,4000,Female,GM0289,Wageningen,2018JJ00,2018,19949,,142,,225,,-83,2704,,1094,1610,2460,,841,-115,1619,244,157,,20106
307331,4000,Female,GM0289,Wageningen,2019JJ00,2019,20106,,156,,221,,-65,2984,,1220,1764,2468,,781,-86,1687,516,452,,20558
307332,4000,Female,GM0289,Wageningen,2020JJ00,2020,20558,,164,,241,,-77,2590,,901,1689,2562,,821,-81,1741,28,-52,,20506
307333,4000,Female,GM0289,Wageningen,2021JJ00,2021,20506,,132,,232,,-100,2623,,1162,1461,2261,,624,-70,1637,362,264,,20770
307334,4000,Female,GM0289,Wageningen,2022JJ00,2022,20770,,137,,243,,-106,3097,,1457,1640,2392,,690,-47,1702,705,598,,21368
307335,4000,Female,GM0289,Wageningen,2023JJ00,2023,21368,,136,,247,,-111,3731,,1367,2364,2806,,893,-82,1913,925,809,,22177
308226,4000,Female,GM0629,Wassenaar,2012JJ00,2012,13563,,82,,187,,-105,923,,367,556,863,,404,-9,459,60,-44,,13519
308227,4000,Female,GM0629,Wassenaar,2013JJ00,2013,13519,,71,,158,,-87,962,,361,601,865,,338,-8,527,97,13,,13532
308228,4000,Female,GM0629,Wassenaar,2014JJ00,2014,13532,,82,,178,,-96,1101,,372,729,960,,372,-7,588,141,49,,13581
308229,4000,Female,GM0629,Wassenaar,2015JJ00,2015,13581,,99,,179,,-80,1071,,357,714,918,,405,5,513,153,70,,13651
308230,4000,Female,GM0629,Wassenaar,2016JJ00,2016,13651,,78,,184,,-106,1141,,370,771,943,,361,18,582,198,91,,13742
308231,4000,Female,GM0629,Wassenaar,2017JJ00,2017,13742,,102,,197,,-95,1060,,338,722,952,,359,14,593,108,11,,13753
308232,4000,Female,GM0629,Wassenaar,2018JJ00,2018,13753,,82,,186,,-104,1022,,353,669,857,,354,7,503,165,53,,13806
308233,4000,Female,GM0629,Wassenaar,2019JJ00,2019,13806,,88,,183,,-95,1035,,317,718,885,,333,9,552,150,56,,13862
308234,4000,Female,GM0629,Wassenaar,2020JJ00,2020,13862,,81,,184,,-103,1216,,356,860,971,,322,-13,649,245,142,,14004
308235,4000,Female,GM0629,Wassenaar,2021JJ00,2021,14004,,83,,223,,-140,1296,,388,908,976,,245,48,731,320,181,,14185
308236,4000,Female,GM0629,Wassenaar,2022JJ00,2022,14185,,77,,235,,-158,1227,,469,758,1059,,371,-10,688,168,9,,14194
308237,4000,Female,GM0629,Wassenaar,2023JJ00,2023,14194,,69,,214,,-145,1160,,355,805,1153,,356,-25,797,7,-137,,14057
308390,4000,Female,GM0852,Waterland,2012JJ00,2012,8530,,52,,51,,1,299,,42,257,245,,26,-2,219,54,55,,8585
308391,4000,Female,GM0852,Waterland,2013JJ00,2013,8585,,73,,46,,27,310,,37,273,282,,32,-3,250,28,55,,8640
308392,4000,Female,GM0852,Waterland,2014JJ00,2014,8640,,79,,67,,12,307,,37,270,277,,30,2,247,30,41,,8681
308393,4000,Female,GM0852,Waterland,2015JJ00,2015,8681,,66,,62,,4,415,,55,360,321,,27,-1,294,94,99,,8780
308394,4000,Female,GM0852,Waterland,2016JJ00,2016,8780,,76,,74,,2,344,,47,297,359,,36,1,323,-15,-15,,8765
308395,4000,Female,GM0852,Waterland,2017JJ00,2017,8765,,71,,65,,6,344,,37,307,348,,39,-4,309,-4,2,,8767
308396,4000,Female,GM0852,Waterland,2018JJ00,2018,8767,,49,,90,,-41,398,,40,358,334,,32,-2,302,64,23,,8790
308397,4000,Female,GM0852,Waterland,2019JJ00,2019,8790,,76,,73,,3,395,,42,353,321,,32,-2,289,74,79,,8869
308398,4000,Female,GM0852,Waterland,2020JJ00,2020,8869,,67,,97,,-30,341,,44,297,377,,27,-2,350,-36,-65,,8804
308399,4000,Female,GM0852,Waterland,2021JJ00,2021,8804,,73,,74,,-1,391,,31,360,351,,22,1,329,40,39,,8843
308400,4000,Female,GM0852,Waterland,2022JJ00,2022,8843,,62,,94,,-32,564,,194,370,353,,50,-12,303,211,179,,9022
308401,4000,Female,GM0852,Waterland,2023JJ00,2023,9022,,52,,91,,-39,401,,74,327,413,,59,-10,354,-12,-55,,8967
308718,4000,Female,GM0988,Weert,2012JJ00,2012,24325,,206,,230,,-24,748,,132,616,767,,122,-25,645,-19,-43,,24282
308719,4000,Female,GM0988,Weert,2013JJ00,2013,24282,,230,,222,,8,772,,149,623,675,,81,-5,594,97,105,,24387
308720,4000,Female,GM0988,Weert,2014JJ00,2014,24387,,242,,233,,9,797,,181,616,713,,112,-4,601,84,90,,24477
308721,4000,Female,GM0988,Weert,2015JJ00,2015,24477,,245,,235,,10,856,,163,693,738,,131,-11,607,118,126,,24603
308722,4000,Female,GM0988,Weert,2016JJ00,2016,24603,,216,,231,,-15,1248,,238,1010,1099,,145,-29,954,149,131,,24734
308723,4000,Female,GM0988,Weert,2017JJ00,2017,24734,,197,,262,,-65,1212,,201,1011,1012,,133,-4,879,200,127,,24861
308724,4000,Female,GM0988,Weert,2018JJ00,2018,24861,,197,,243,,-46,1096,,228,868,1022,,150,-30,872,74,25,,24886
308725,4000,Female,GM0988,Weert,2019JJ00,2019,24886,,205,,208,,-3,1140,,290,850,1001,,179,-46,822,139,133,,25019
308726,4000,Female,GM0988,Weert,2020JJ00,2020,25019,,193,,258,,-65,1117,,219,898,1060,,180,-43,880,57,-13,,25006
308727,4000,Female,GM0988,Weert,2021JJ00,2021,25006,,237,,295,,-58,1105,,277,828,897,,169,-29,728,208,144,,25150
308728,4000,Female,GM0988,Weert,2022JJ00,2022,25150,,216,,275,,-59,1331,,524,807,997,,286,-75,711,334,270,,25420
308729,4000,Female,GM0988,Weert,2023JJ00,2023,25420,,212,,288,,-76,1237,,434,803,1051,,337,-101,714,186,107,,25527
308800,4000,Female,GM0457,Weesp,2012JJ00,2012,9294,,101,,110,,-9,515,,50,465,437,,44,-3,393,78,67,,9361
308801,4000,Female,GM0457,Weesp,2013JJ00,2013,9361,,96,,95,,1,537,,71,466,499,,64,-15,435,38,41,,9402
308802,4000,Female,GM0457,Weesp,2014JJ00,2014,9402,,87,,99,,-12,597,,76,521,474,,70,-1,404,123,108,,9510
308803,4000,Female,GM0457,Weesp,2015JJ00,2015,9510,,98,,105,,-7,607,,65,542,497,,52,-12,445,110,103,,9613
308804,4000,Female,GM0457,Weesp,2016JJ00,2016,9613,,93,,97,,-4,606,,71,535,530,,67,-12,463,76,76,,9689
308805,4000,Female,GM0457,Weesp,2017JJ00,2017,9689,,111,,103,,8,750,,93,657,584,,53,-7,531,166,174,,9863
308806,4000,Female,GM0457,Weesp,2018JJ00,2018,9863,,96,,101,,-5,640,,98,542,578,,60,1,518,62,56,,9919
308807,4000,Female,GM0457,Weesp,2019JJ00,2019,9919,,108,,130,,-22,834,,104,730,603,,54,-4,549,231,208,,10127
308808,4000,Female,GM0457,Weesp,2020JJ00,2020,10127,,133,,122,,11,933,,68,865,579,,39,3,540,354,364,,10491
308809,4000,Female,GM0457,Weesp,2021JJ00,2021,10491,,128,,137,,-9,855,,102,753,681,,65,-4,616,174,166,,10657
308810,4000,Female,GM0457,Weesp,2022JJ00,2022,10657,,,,,,,,,,,,,,,,,,,
309210,4000,Female,GM0870,Werkendam,2012JJ00,2012,13236,,121,,84,,37,347,,19,328,367,,13,5,354,-20,17,,13253
309211,4000,Female,GM0870,Werkendam,2013JJ00,2013,13253,,118,,84,,34,340,,30,310,408,,23,-5,385,-68,-34,,13219
309212,4000,Female,GM0870,Werkendam,2014JJ00,2014,13219,,136,,104,,32,373,,25,348,411,,20,-1,391,-38,-6,,13213
309213,4000,Female,GM0870,Werkendam,2015JJ00,2015,13213,,128,,125,,3,425,,21,404,396,,29,-7,367,29,32,,13245
309214,4000,Female,GM0870,Werkendam,2016JJ00,2016,13245,,129,,88,,41,518,,31,487,424,,23,3,401,94,138,,13383
309215,4000,Female,GM0870,Werkendam,2017JJ00,2017,13383,,137,,110,,27,511,,32,479,473,,12,0,461,38,64,,13447
309216,4000,Female,GM0870,Werkendam,2018JJ00,2018,13447,,149,,101,,48,543,,48,495,458,,24,0,434,85,129,,13576
309545,4000,Female,GM1960,West Betuwe,2019JJ00,2019,25375,,262,,194,,68,1087,,112,975,975,,62,-3,913,112,170,,25545
309546,4000,Female,GM1960,West Betuwe,2020JJ00,2020,25545,,234,,264,,-30,1177,,110,1067,1019,,56,0,963,158,126,,25671
309547,4000,Female,GM1960,West Betuwe,2021JJ00,2021,25671,,272,,243,,29,1258,,83,1175,1051,,66,-4,985,207,240,,25911
309548,4000,Female,GM1960,West Betuwe,2022JJ00,2022,25911,,248,,281,,-33,1497,,415,1082,1081,,148,-20,933,416,382,,26293
309549,4000,Female,GM1960,West Betuwe,2023JJ00,2023,26293,,251,,206,,45,1245,,191,1054,1188,,127,-22,1061,57,101,,26394
309620,4000,Female,GM0668,West Maas en Waal,2012JJ00,2012,9196,,70,,80,,-10,346,,41,305,277,,11,2,266,69,59,,9255
309621,4000,Female,GM0668,West Maas en Waal,2013JJ00,2013,9255,,65,,88,,-23,329,,29,300,286,,18,2,268,43,20,,9275
309622,4000,Female,GM0668,West Maas en Waal,2014JJ00,2014,9275,,83,,82,,1,383,,36,347,326,,23,-2,303,57,58,,9333
309623,4000,Female,GM0668,West Maas en Waal,2015JJ00,2015,9333,,70,,93,,-23,441,,41,400,364,,23,-1,341,77,54,,9387
309624,4000,Female,GM0668,West Maas en Waal,2016JJ00,2016,9387,,66,,86,,-20,448,,35,413,373,,18,1,355,75,50,,9437
309625,4000,Female,GM0668,West Maas en Waal,2017JJ00,2017,9437,,69,,105,,-36,454,,29,425,415,,17,0,398,39,-1,,9436
309626,4000,Female,GM0668,West Maas en Waal,2018JJ00,2018,9436,,91,,100,,-9,504,,31,473,410,,22,0,388,94,86,,9522
309627,4000,Female,GM0668,West Maas en Waal,2019JJ00,2019,9522,,85,,91,,-6,505,,30,475,397,,8,0,389,108,103,,9625
309628,4000,Female,GM0668,West Maas en Waal,2020JJ00,2020,9625,,90,,106,,-16,553,,22,531,393,,16,-2,377,160,146,,9771
309629,4000,Female,GM0668,West Maas en Waal,2021JJ00,2021,9771,,92,,96,,-4,467,,31,436,415,,22,-2,393,52,49,,9820
309630,4000,Female,GM0668,West Maas en Waal,2022JJ00,2022,9820,,86,,115,,-29,644,,154,490,415,,43,-3,372,229,199,,10019
309631,4000,Female,GM0668,West Maas en Waal,2023JJ00,2023,10019,,99,,117,,-18,588,,73,515,449,,60,-5,389,139,119,,10138
310201,4000,Female,GM1969,Westerkwartier,2019JJ00,2019,31340,,299,,289,,10,1409,,89,1320,1237,,55,-6,1182,172,179,,31519
310202,4000,Female,GM1969,Westerkwartier,2020JJ00,2020,31519,,294,,291,,3,1357,,74,1283,1232,,42,2,1190,125,125,,31644
310203,4000,Female,GM1969,Westerkwartier,2021JJ00,2021,31644,,337,,308,,29,1397,,58,1339,1081,,56,-5,1025,316,345,,31989
310204,4000,Female,GM1969,Westerkwartier,2022JJ00,2022,31989,,339,,331,,8,1538,,375,1163,1226,,128,-28,1098,312,317,,32306
310205,4000,Female,GM1969,Westerkwartier,2023JJ00,2023,32306,,337,,313,,24,1406,,273,1133,1398,,170,-48,1228,8,31,,32337
310358,4000,Female,GM1701,Westerveld,2012JJ00,2012,9643,,61,,122,,-61,440,,34,406,450,,18,4,432,-10,-72,,9571
310359,4000,Female,GM1701,Westerveld,2013JJ00,2013,9571,,69,,120,,-51,424,,31,393,455,,26,-5,429,-31,-82,,9489
310360,4000,Female,GM1701,Westerveld,2014JJ00,2014,9489,,74,,109,,-35,562,,66,496,474,,26,1,448,88,54,,9543
310361,4000,Female,GM1701,Westerveld,2015JJ00,2015,9543,,62,,124,,-62,567,,99,468,548,,17,1,531,19,-43,,9500
310362,4000,Female,GM1701,Westerveld,2016JJ00,2016,9500,,68,,117,,-49,750,,86,664,613,,18,1,595,137,86,,9586
310363,4000,Female,GM1701,Westerveld,2017JJ00,2017,9586,,72,,104,,-32,620,,33,587,537,,29,-3,508,83,51,,9637
310364,4000,Female,GM1701,Westerveld,2018JJ00,2018,9637,,74,,94,,-20,623,,27,596,520,,21,-1,499,103,83,,9720
310365,4000,Female,GM1701,Westerveld,2019JJ00,2019,9720,,61,,113,,-52,614,,34,580,492,,19,7,473,122,70,,9790
310366,4000,Female,GM1701,Westerveld,2020JJ00,2020,9790,,69,,111,,-42,682,,32,650,526,,22,0,504,156,115,,9905
310367,4000,Female,GM1701,Westerveld,2021JJ00,2021,9905,,51,,119,,-68,635,,30,605,476,,16,0,460,159,93,,9998
310368,4000,Female,GM1701,Westerveld,2022JJ00,2022,9998,,61,,136,,-75,585,,93,492,461,,42,3,419,124,51,,10049
310369,4000,Female,GM1701,Westerveld,2023JJ00,2023,10049,,65,,132,,-67,631,,95,536,526,,41,0,485,105,38,,10087
310440,4000,Female,GM0293,Westervoort,2012JJ00,2012,7720,,62,,64,,-2,360,,26,334,407,,21,4,386,-47,-48,,7672
310441,4000,Female,GM0293,Westervoort,2013JJ00,2013,7672,,68,,56,,12,428,,28,400,427,,22,-2,405,1,13,,7685
310442,4000,Female,GM0293,Westervoort,2014JJ00,2014,7685,,76,,56,,20,384,,27,357,433,,14,1,419,-49,-31,,7654
310443,4000,Female,GM0293,Westervoort,2015JJ00,2015,7654,,72,,65,,7,421,,27,394,393,,30,-6,363,28,34,,7688
310444,4000,Female,GM0293,Westervoort,2016JJ00,2016,7688,,51,,65,,-14,450,,35,415,458,,28,-7,430,-8,-24,,7664
310445,4000,Female,GM0293,Westervoort,2017JJ00,2017,7664,,63,,74,,-11,503,,24,479,502,,34,-8,468,1,-11,,7653
310446,4000,Female,GM0293,Westervoort,2018JJ00,2018,7653,,62,,68,,-6,396,,37,359,450,,33,-6,417,-54,-60,,7593
310447,4000,Female,GM0293,Westervoort,2019JJ00,2019,7593,,63,,56,,7,398,,25,373,400,,18,2,382,-2,3,,7596
310448,4000,Female,GM0293,Westervoort,2020JJ00,2020,7596,,70,,76,,-6,443,,24,419,427,,15,-3,412,16,9,,7605
310449,4000,Female,GM0293,Westervoort,2021JJ00,2021,7605,,74,,57,,17,414,,23,391,445,,20,-2,425,-31,-15,,7590
310450,4000,Female,GM0293,Westervoort,2022JJ00,2022,7590,,65,,73,,-8,471,,83,388,373,,33,2,340,98,91,,7681
310451,4000,Female,GM0293,Westervoort,2023JJ00,2023,7681,,73,,77,,-4,431,,48,383,393,,36,-8,357,38,34,,7715
310528,4000,Female,GM1950,Westerwolde,2018JJ00,2018,12316,,111,,165,,-54,5498,,4853,645,5170,,27,3,5143,328,278,,12594
310529,4000,Female,GM1950,Westerwolde,2019JJ00,2019,12594,,91,,141,,-50,4823,,3981,842,4512,,63,-23,4449,311,284,,12878
310530,4000,Female,GM1950,Westerwolde,2020JJ00,2020,12878,,73,,160,,-87,4221,,3313,908,3958,,55,-27,3903,263,196,,13074
310531,4000,Female,GM1950,Westerwolde,2021JJ00,2021,13074,,109,,211,,-102,7814,,7059,755,7600,,42,-13,7558,214,159,,13233
310532,4000,Female,GM1950,Westerwolde,2022JJ00,2022,13233,,92,,155,,-63,8426,,7763,663,8412,,74,-19,8338,14,-39,,13194
310533,4000,Female,GM1950,Westerwolde,2023JJ00,2023,13194,,83,,187,,-104,7544,,6914,630,7567,,71,-30,7496,-23,-72,,13122
310686,4000,Female,GM1783,Westland,2012JJ00,2012,51179,,477,,335,,142,2499,,1229,1270,2186,,969,-233,1217,313,455,,51634
310687,4000,Female,GM1783,Westland,2013JJ00,2013,51634,,476,,413,,63,2574,,1225,1349,2443,,1106,-174,1337,131,197,,51831
310688,4000,Female,GM1783,Westland,2014JJ00,2014,51831,,458,,359,,99,2861,,1465,1396,2428,,1066,-161,1362,433,534,,52365
310689,4000,Female,GM1783,Westland,2015JJ00,2015,52365,,513,,395,,118,2805,,1317,1488,2618,,1228,-283,1390,187,307,,52672
310690,4000,Female,GM1783,Westland,2016JJ00,2016,52672,,490,,356,,134,2850,,1244,1606,2726,,1199,-246,1527,124,261,,52933
310691,4000,Female,GM1783,Westland,2017JJ00,2017,52933,,486,,447,,39,3210,,1295,1915,2398,,922,-208,1476,812,847,,53780
310692,4000,Female,GM1783,Westland,2018JJ00,2018,53780,,490,,403,,87,3262,,1318,1944,2742,,1295,-193,1447,520,607,,54387
310693,4000,Female,GM1783,Westland,2019JJ00,2019,54387,,554,,380,,174,3293,,1298,1995,2641,,1166,-190,1475,652,824,,55211
310694,4000,Female,GM1783,Westland,2020JJ00,2020,55211,,518,,473,,45,2988,,1051,1937,2460,,921,-74,1539,528,576,,55787
310695,4000,Female,GM1783,Westland,2021JJ00,2021,55787,,592,,475,,117,2874,,996,1878,2448,,778,-147,1670,426,544,,56331
310696,4000,Female,GM1783,Westland,2022JJ00,2022,56331,,560,,489,,71,3911,,2057,1854,2586,,965,-285,1621,1325,1393,,57724
310697,4000,Female,GM1783,Westland,2023JJ00,2023,57724,,540,,517,,23,3524,,1486,2038,3113,,1282,-357,1831,411,433,,58157
310850,4000,Female,GM0098,Weststellingwerf,2012JJ00,2012,12860,,106,,141,,-35,392,,24,368,470,,31,-6,439,-78,-113,,12747
310851,4000,Female,GM0098,Weststellingwerf,2013JJ00,2013,12747,,106,,148,,-42,424,,27,397,452,,23,-4,429,-28,-71,,12676
310852,4000,Female,GM0098,Weststellingwerf,2014JJ00,2014,12676,,125,,126,,-1,509,,33,476,432,,37,-3,395,77,81,,12757
310853,4000,Female,GM0098,Weststellingwerf,2015JJ00,2015,12757,,116,,132,,-16,508,,41,467,495,,32,3,463,13,0,,12757
310854,4000,Female,GM0098,Weststellingwerf,2016JJ00,2016,12757,,113,,161,,-48,592,,41,551,459,,38,-8,421,133,86,,12843
310855,4000,Female,GM0098,Weststellingwerf,2017JJ00,2017,12843,,105,,152,,-47,613,,35,578,488,,28,1,460,125,77,,12920
310856,4000,Female,GM0098,Weststellingwerf,2018JJ00,2018,12920,,137,,149,,-12,562,,32,530,495,,18,-1,477,67,55,,12975
310857,4000,Female,GM0098,Weststellingwerf,2019JJ00,2019,12975,,114,,150,,-36,558,,38,520,513,,27,-1,486,45,9,,12984
310858,4000,Female,GM0098,Weststellingwerf,2020JJ00,2020,12984,,106,,172,,-66,636,,39,597,501,,12,2,489,135,69,,13053
310859,4000,Female,GM0098,Weststellingwerf,2021JJ00,2021,13053,,125,,155,,-30,594,,41,553,515,,23,-9,492,79,48,,13101
310860,4000,Female,GM0098,Weststellingwerf,2022JJ00,2022,13101,,104,,170,,-66,647,,111,536,466,,52,-9,414,181,114,,13215
310861,4000,Female,GM0098,Weststellingwerf,2023JJ00,2023,13215,,121,,181,,-60,561,,65,496,504,,38,-9,466,57,-7,,13208
310932,4000,Female,GM0614,Westvoorne,2012JJ00,2012,6998,,31,,75,,-44,339,,42,297,281,,34,-9,247,58,16,,7014
310933,4000,Female,GM0614,Westvoorne,2013JJ00,2013,7014,,37,,66,,-29,375,,47,328,300,,40,-6,260,75,47,,7061
310934,4000,Female,GM0614,Westvoorne,2014JJ00,2014,7061,,41,,81,,-40,391,,43,348,294,,40,-7,254,97,57,,7118
310935,4000,Female,GM0614,Westvoorne,2015JJ00,2015,7118,,48,,79,,-31,381,,41,340,300,,29,2,271,81,49,,7167
310936,4000,Female,GM0614,Westvoorne,2016JJ00,2016,7167,,40,,95,,-55,400,,29,371,322,,31,-4,291,78,24,,7191
310937,4000,Female,GM0614,Westvoorne,2017JJ00,2017,7191,,45,,85,,-40,476,,30,446,309,,22,0,287,167,128,,7319
310938,4000,Female,GM0614,Westvoorne,2018JJ00,2018,7319,,48,,86,,-38,489,,33,456,402,,26,-2,376,87,49,,7368
310939,4000,Female,GM0614,Westvoorne,2019JJ00,2019,7368,,35,,87,,-52,406,,29,377,329,,30,-2,299,77,25,,7393
310940,4000,Female,GM0614,Westvoorne,2020JJ00,2020,7393,,50,,87,,-37,472,,43,429,342,,20,-1,322,130,94,,7487
310941,4000,Female,GM0614,Westvoorne,2021JJ00,2021,7487,,51,,90,,-39,410,,31,379,322,,25,-3,297,88,49,,7536
310942,4000,Female,GM0614,Westvoorne,2022JJ00,2022,7536,,51,,112,,-61,440,,97,343,340,,36,-1,304,100,32,,7568
311178,4000,Female,GM0189,Wierden,2012JJ00,2012,11897,,126,,82,,44,321,,18,303,351,,23,2,328,-30,14,,11911
311179,4000,Female,GM0189,Wierden,2013JJ00,2013,11911,,126,,98,,28,382,,27,355,371,,13,-3,358,11,40,,11951
311180,4000,Female,GM0189,Wierden,2014JJ00,2014,11951,,130,,110,,20,363,,20,343,383,,22,-2,361,-20,0,,11951
311181,4000,Female,GM0189,Wierden,2015JJ00,2015,11951,,113,,91,,22,391,,15,376,365,,18,-1,347,26,47,,11998
311182,4000,Female,GM0189,Wierden,2016JJ00,2016,11998,,130,,100,,30,511,,32,479,406,,18,0,388,105,135,,12133
311183,4000,Female,GM0189,Wierden,2017JJ00,2017,12133,,106,,97,,9,501,,29,472,496,,21,0,475,5,14,,12147
311184,4000,Female,GM0189,Wierden,2018JJ00,2018,12147,,141,,102,,39,436,,29,407,426,,15,2,411,10,49,,12196
311185,4000,Female,GM0189,Wierden,2019JJ00,2019,12196,,106,,119,,-13,508,,38,470,460,,27,-3,433,48,34,,12230
311186,4000,Female,GM0189,Wierden,2020JJ00,2020,12230,,91,,106,,-15,451,,30,421,432,,13,0,419,19,3,,12233
311187,4000,Female,GM0189,Wierden,2021JJ00,2021,12233,,124,,127,,-3,499,,16,483,440,,21,-4,419,59,56,,12289
311188,4000,Female,GM0189,Wierden,2022JJ00,2022,12289,,131,,112,,19,524,,120,404,396,,31,-3,365,128,148,,12437
311189,4000,Female,GM0189,Wierden,2023JJ00,2023,12437,,113,,106,,7,466,,31,435,465,,30,-8,435,1,9,,12446
311506,4000,Female,GM0296,Wijchen,2012JJ00,2012,20638,,177,,177,,0,820,,68,752,690,,48,-6,642,130,134,,20772
311507,4000,Female,GM0296,Wijchen,2013JJ00,2013,20772,,166,,162,,4,666,,56,610,705,,48,0,657,-39,-33,,20739
311508,4000,Female,GM0296,Wijchen,2014JJ00,2014,20739,,150,,167,,-17,696,,61,635,749,,43,-4,706,-53,-72,,20667
311509,4000,Female,GM0296,Wijchen,2015JJ00,2015,20667,,171,,167,,4,715,,80,635,764,,53,-11,711,-49,-44,,20623
311510,4000,Female,GM0296,Wijchen,2016JJ00,2016,20623,,188,,182,,6,798,,64,734,769,,50,-9,719,29,33,,20656
311511,4000,Female,GM0296,Wijchen,2017JJ00,2017,20656,,159,,182,,-23,846,,53,793,861,,45,-2,816,-15,-39,,20617
311512,4000,Female,GM0296,Wijchen,2018JJ00,2018,20617,,165,,166,,-1,800,,75,725,729,,50,-2,679,71,70,,20687
311513,4000,Female,GM0296,Wijchen,2019JJ00,2019,20687,,154,,176,,-22,831,,75,756,721,,54,-4,667,110,89,,20776
311514,4000,Female,GM0296,Wijchen,2020JJ00,2020,20776,,198,,200,,-2,862,,96,766,722,,28,-1,694,140,135,,20911
311515,4000,Female,GM0296,Wijchen,2021JJ00,2021,20911,,190,,188,,2,781,,71,710,718,,39,-4,679,63,64,,20975
311516,4000,Female,GM0296,Wijchen,2022JJ00,2022,20975,,164,,208,,-44,910,,212,698,752,,81,-13,671,158,111,,21086
311517,4000,Female,GM0296,Wijchen,2023JJ00,2023,21086,,170,,200,,-30,782,,96,686,767,,81,-10,686,15,-19,,21067
311588,4000,Female,GM1696,Wijdemeren,2012JJ00,2012,11884,,89,,111,,-22,551,,59,492,546,,45,-7,501,5,-17,,11867
311589,4000,Female,GM1696,Wijdemeren,2013JJ00,2013,11867,,83,,130,,-47,516,,45,471,494,,35,2,459,22,-25,,11842
311590,4000,Female,GM1696,Wijdemeren,2014JJ00,2014,11842,,86,,117,,-31,608,,66,542,555,,49,6,506,53,23,,11865
311591,4000,Female,GM1696,Wijdemeren,2015JJ00,2015,11865,,77,,119,,-42,714,,61,653,588,,58,3,530,126,84,,11949
311592,4000,Female,GM1696,Wijdemeren,2016JJ00,2016,11949,,83,,135,,-52,781,,62,719,649,,54,-1,595,132,80,,12029
311593,4000,Female,GM1696,Wijdemeren,2017JJ00,2017,12029,,89,,126,,-37,754,,76,678,614,,39,4,575,140,106,,12135
311594,4000,Female,GM1696,Wijdemeren,2018JJ00,2018,12135,,118,,137,,-19,740,,82,658,591,,52,-3,539,149,134,,12269
311595,4000,Female,GM1696,Wijdemeren,2019JJ00,2019,12269,,98,,137,,-39,818,,79,739,646,,51,-2,595,172,135,,12404
311596,4000,Female,GM1696,Wijdemeren,2020JJ00,2020,12404,,86,,124,,-38,780,,66,714,706,,37,0,669,74,34,,12438
311597,4000,Female,GM1696,Wijdemeren,2021JJ00,2021,12438,,95,,128,,-33,688,,48,640,641,,41,-5,600,47,13,,12451
311598,4000,Female,GM1696,Wijdemeren,2022JJ00,2022,12451,,91,,117,,-26,764,,165,599,605,,66,0,539,159,133,,12584
311599,4000,Female,GM1696,Wijdemeren,2023JJ00,2023,12584,,96,,141,,-45,701,,86,615,707,,68,0,639,-6,-54,,12530
311998,4000,Female,GM0352,Wijk bij Duurstede,2012JJ00,2012,11669,,89,,66,,23,375,,19,356,415,,26,-1,389,-40,-18,,11651
311999,4000,Female,GM0352,Wijk bij Duurstede,2013JJ00,2013,11651,,108,,76,,32,413,,19,394,418,,35,-8,383,-5,27,,11678
312000,4000,Female,GM0352,Wijk bij Duurstede,2014JJ00,2014,11678,,109,,83,,26,459,,36,423,371,,24,3,347,88,112,,11790
312001,4000,Female,GM0352,Wijk bij Duurstede,2015JJ00,2015,11790,,108,,63,,45,458,,37,421,419,,29,3,390,39,84,,11874
312002,4000,Female,GM0352,Wijk bij Duurstede,2016JJ00,2016,11874,,96,,75,,21,515,,51,464,485,,21,0,464,30,50,,11924
312003,4000,Female,GM0352,Wijk bij Duurstede,2017JJ00,2017,11924,,94,,74,,20,548,,38,510,484,,41,-1,443,64,83,,12007
312004,4000,Female,GM0352,Wijk bij Duurstede,2018JJ00,2018,12007,,122,,97,,25,479,,28,451,476,,38,-1,438,3,30,,12037
312005,4000,Female,GM0352,Wijk bij Duurstede,2019JJ00,2019,12037,,112,,81,,31,531,,48,483,457,,25,-2,432,74,104,,12141
312006,4000,Female,GM0352,Wijk bij Duurstede,2020JJ00,2020,12141,,107,,99,,8,499,,42,457,517,,20,0,497,-18,-15,,12126
312007,4000,Female,GM0352,Wijk bij Duurstede,2021JJ00,2021,12126,,112,,87,,25,448,,33,415,488,,32,-2,456,-40,-14,,12112
312008,4000,Female,GM0352,Wijk bij Duurstede,2022JJ00,2022,12112,,105,,109,,-4,505,,93,412,459,,47,0,412,46,42,,12154
312009,4000,Female,GM0352,Wijk bij Duurstede,2023JJ00,2023,12154,,102,,81,,21,462,,60,402,501,,42,-4,459,-39,-18,,12136
312982,4000,Female,GM0053,Winsum,2012JJ00,2012,7031,,55,,65,,-10,256,,22,234,282,,17,-1,265,-26,-35,,6996
312983,4000,Female,GM0053,Winsum,2013JJ00,2013,6996,,57,,72,,-15,273,,12,261,276,,12,-3,264,-3,-19,,6977
312984,4000,Female,GM0053,Winsum,2014JJ00,2014,6977,,52,,63,,-11,281,,10,271,295,,10,0,285,-14,-29,,6948
312985,4000,Female,GM0053,Winsum,2015JJ00,2015,6948,,50,,76,,-26,272,,27,245,316,,14,-1,302,-44,-70,,6878
312986,4000,Female,GM0053,Winsum,2016JJ00,2016,6878,,63,,77,,-14,328,,20,308,300,,16,-3,284,28,14,,6892
312987,4000,Female,GM0053,Winsum,2017JJ00,2017,6892,,48,,88,,-40,334,,24,310,354,,7,-1,347,-20,-59,,6833
312988,4000,Female,GM0053,Winsum,2018JJ00,2018,6833,,57,,77,,-20,328,,12,316,303,,10,1,293,25,3,,6836
313064,4000,Female,GM0294,Winterswijk,2012JJ00,2012,14561,,117,,141,,-24,596,,219,377,584,,57,-27,527,12,-10,,14551
313065,4000,Female,GM0294,Winterswijk,2013JJ00,2013,14551,,129,,153,,-24,578,,235,343,621,,64,-32,557,-43,-67,,14484
313066,4000,Female,GM0294,Winterswijk,2014JJ00,2014,14484,,120,,153,,-33,611,,219,392,574,,47,-12,527,37,4,,14488
313067,4000,Female,GM0294,Winterswijk,2015JJ00,2015,14488,,109,,152,,-43,720,,268,452,674,,64,-13,610,46,3,,14491
313068,4000,Female,GM0294,Winterswijk,2016JJ00,2016,14491,,111,,151,,-40,589,,166,423,602,,59,-6,543,-13,-52,,14439
313069,4000,Female,GM0294,Winterswijk,2017JJ00,2017,14439,,111,,192,,-81,744,,98,646,620,,57,-9,563,124,40,,14479
313070,4000,Female,GM0294,Winterswijk,2018JJ00,2018,14479,,119,,142,,-23,610,,99,511,606,,49,-6,557,4,-18,,14461
313071,4000,Female,GM0294,Winterswijk,2019JJ00,2019,14461,,110,,154,,-44,581,,93,488,564,,68,-23,496,17,-27,,14434
313072,4000,Female,GM0294,Winterswijk,2020JJ00,2020,14434,,130,,161,,-31,626,,63,563,493,,43,-6,450,133,100,,14534
313073,4000,Female,GM0294,Winterswijk,2021JJ00,2021,14534,,131,,183,,-52,711,,47,664,592,,32,2,560,119,63,,14597
313074,4000,Female,GM0294,Winterswijk,2022JJ00,2022,14597,,97,,195,,-98,779,,166,613,650,,76,-13,574,129,30,,14627
313075,4000,Female,GM0294,Winterswijk,2023JJ00,2023,14627,,134,,190,,-56,655,,88,567,638,,93,-18,545,17,-40,,14587
313474,4000,Female,GM0873,Woensdrecht,2012JJ00,2012,10813,,59,,84,,-25,397,,136,261,395,,67,0,328,2,-23,,10790
313475,4000,Female,GM0873,Woensdrecht,2013JJ00,2013,10790,,66,,84,,-18,418,,115,303,414,,71,-4,343,4,-14,,10776
313476,4000,Female,GM0873,Woensdrecht,2014JJ00,2014,10776,,95,,83,,12,429,,146,283,410,,80,-9,330,19,32,,10808
313477,4000,Female,GM0873,Woensdrecht,2015JJ00,2015,10808,,93,,107,,-14,462,,154,308,424,,78,-6,346,38,26,,10834
313478,4000,Female,GM0873,Woensdrecht,2016JJ00,2016,10834,,76,,109,,-33,566,,212,354,490,,100,-14,390,76,40,,10874
313479,4000,Female,GM0873,Woensdrecht,2017JJ00,2017,10874,,80,,83,,-3,512,,169,343,518,,106,-11,412,-6,-12,,10862
313480,4000,Female,GM0873,Woensdrecht,2018JJ00,2018,10862,,82,,91,,-9,514,,171,343,489,,95,-5,394,25,16,,10878
313481,4000,Female,GM0873,Woensdrecht,2019JJ00,2019,10878,,89,,100,,-11,527,,186,341,502,,90,0,412,25,16,,10894
313482,4000,Female,GM0873,Woensdrecht,2020JJ00,2020,10894,,76,,109,,-33,559,,168,391,472,,73,0,399,87,55,,10949
313483,4000,Female,GM0873,Woensdrecht,2021JJ00,2021,10949,,98,,114,,-16,544,,165,379,441,,122,-11,319,103,87,,11036
313484,4000,Female,GM0873,Woensdrecht,2022JJ00,2022,11036,,81,,105,,-24,552,,195,357,489,,124,-14,365,63,40,,11076
313485,4000,Female,GM0873,Woensdrecht,2023JJ00,2023,11076,,71,,90,,-19,555,,169,386,535,,142,-16,393,20,3,,11079
313556,4000,Female,GM0632,Woerden,2012JJ00,2012,25322,,310,,171,,139,788,,67,721,815,,86,-19,729,-27,113,,25435
313557,4000,Female,GM0632,Woerden,2013JJ00,2013,25435,,276,,170,,106,834,,90,744,773,,61,0,712,61,169,,25604
313558,4000,Female,GM0632,Woerden,2014JJ00,2014,25604,,261,,191,,70,867,,92,775,900,,74,-8,826,-33,39,,25643
313559,4000,Female,GM0632,Woerden,2015JJ00,2015,25643,,278,,181,,97,1036,,107,929,889,,67,-3,822,147,242,,25885
313560,4000,Female,GM0632,Woerden,2016JJ00,2016,25885,,267,,199,,68,1046,,101,945,965,,65,-3,900,81,146,,26031
313561,4000,Female,GM0632,Woerden,2017JJ00,2017,26031,,263,,205,,58,1062,,95,967,978,,78,-3,900,84,140,,26171
313562,4000,Female,GM0632,Woerden,2018JJ00,2018,26171,,246,,187,,59,1106,,123,983,944,,59,-4,885,162,223,,26394
313563,4000,Female,GM0632,Woerden,2019JJ00,2019,26394,,229,,208,,21,999,,113,886,961,,77,-7,884,38,59,,26453
313564,4000,Female,GM0632,Woerden,2020JJ00,2020,26453,,227,,220,,7,1149,,107,1042,991,,62,-1,929,158,164,,26617
313565,4000,Female,GM0632,Woerden,2021JJ00,2021,26617,,283,,233,,50,1069,,126,943,1036,,65,-2,971,33,81,,26698
313566,4000,Female,GM0632,Woerden,2022JJ00,2022,26698,,240,,242,,-2,1299,,259,1040,1050,,108,0,942,249,251,,26949
313567,4000,Female,GM0632,Woerden,2023JJ00,2023,26949,,254,,239,,15,1302,,179,1123,1089,,102,-6,987,213,227,,27176
313720,4000,Female,GM1690,De Wolden,2012JJ00,2012,11854,,101,,115,,-14,498,,26,472,493,,21,-2,472,5,-7,,11847
313721,4000,Female,GM1690,De Wolden,2013JJ00,2013,11847,,95,,133,,-38,440,,25,415,466,,20,5,446,-26,-63,,11784
313722,4000,Female,GM1690,De Wolden,2014JJ00,2014,11784,,93,,115,,-22,517,,19,498,482,,31,-2,451,35,12,,11796
313723,4000,Female,GM1690,De Wolden,2015JJ00,2015,11796,,89,,95,,-6,535,,31,504,490,,29,-3,461,45,40,,11836
313724,4000,Female,GM1690,De Wolden,2016JJ00,2016,11836,,88,,133,,-45,604,,36,568,504,,22,0,482,100,55,,11891
313725,4000,Female,GM1690,De Wolden,2017JJ00,2017,11891,,91,,125,,-34,703,,32,671,600,,27,-1,573,103,69,,11960
313726,4000,Female,GM1690,De Wolden,2018JJ00,2018,11960,,98,,130,,-32,696,,42,654,546,,24,-2,522,150,119,,12079
313727,4000,Female,GM1690,De Wolden,2019JJ00,2019,12079,,113,,118,,-5,626,,32,594,540,,18,-1,522,86,80,,12159
313728,4000,Female,GM1690,De Wolden,2020JJ00,2020,12159,,98,,120,,-22,620,,46,574,583,,17,-2,566,37,18,,12177
313729,4000,Female,GM1690,De Wolden,2021JJ00,2021,12177,,106,,158,,-52,655,,39,616,534,,24,-6,510,121,68,,12245
313730,4000,Female,GM1690,De Wolden,2022JJ00,2022,12245,,79,,163,,-84,617,,99,518,546,,33,0,513,71,-15,,12230
313731,4000,Female,GM1690,De Wolden,2023JJ00,2023,12230,,82,,118,,-36,608,,65,543,578,,43,-16,535,30,-8,,12222
314130,4000,Female,GM0880,Wormerland,2012JJ00,2012,7888,,46,,60,,-14,314,,32,282,308,,20,0,288,6,-9,,7879
314131,4000,Female,GM0880,Wormerland,2013JJ00,2013,7879,,48,,43,,5,340,,30,310,311,,27,-1,284,29,36,,7915
314132,4000,Female,GM0880,Wormerland,2014JJ00,2014,7915,,53,,53,,0,307,,27,280,322,,40,-8,282,-15,-15,,7900
314133,4000,Female,GM0880,Wormerland,2015JJ00,2015,7900,,61,,73,,-12,336,,30,306,350,,31,-4,319,-14,-26,,7874
314134,4000,Female,GM0880,Wormerland,2016JJ00,2016,7874,,50,,62,,-12,510,,31,479,384,,27,-10,357,126,113,,7987
314135,4000,Female,GM0880,Wormerland,2017JJ00,2017,7987,,59,,66,,-7,399,,16,383,306,,20,-4,286,93,86,,8073
314136,4000,Female,GM0880,Wormerland,2018JJ00,2018,8073,,73,,85,,-12,496,,24,472,325,,23,1,302,171,159,,8232
314137,4000,Female,GM0880,Wormerland,2019JJ00,2019,8232,,71,,55,,16,326,,35,291,367,,24,1,343,-41,-25,,8207
314138,4000,Female,GM0880,Wormerland,2020JJ00,2020,8207,,64,,75,,-11,417,,37,380,361,,15,-4,346,56,46,,8253
314139,4000,Female,GM0880,Wormerland,2021JJ00,2021,8253,,69,,73,,-4,424,,23,401,371,,18,-1,353,53,49,,8302
314140,4000,Female,GM0880,Wormerland,2022JJ00,2022,8302,,66,,80,,-14,517,,100,417,366,,31,-4,335,151,138,,8440
314141,4000,Female,GM0880,Wormerland,2023JJ00,2023,8440,,65,,93,,-28,364,,42,322,410,,33,-5,377,-46,-78,,8362
314376,4000,Female,GM0351,Woudenberg,2012JJ00,2012,6010,,69,,28,,41,295,,13,282,188,,19,-6,169,107,148,,6158
314377,4000,Female,GM0351,Woudenberg,2013JJ00,2013,6158,,81,,31,,50,209,,19,190,222,,16,2,206,-13,39,,6197
314378,4000,Female,GM0351,Woudenberg,2014JJ00,2014,6197,,71,,50,,21,244,,25,219,218,,17,-5,201,26,40,,6237
314379,4000,Female,GM0351,Woudenberg,2015JJ00,2015,6237,,73,,55,,18,256,,13,243,248,,13,-7,235,8,25,,6262
314380,4000,Female,GM0351,Woudenberg,2016JJ00,2016,6262,,66,,53,,13,342,,24,318,289,,10,1,279,53,65,,6327
314381,4000,Female,GM0351,Woudenberg,2017JJ00,2017,6327,,75,,38,,37,395,,19,376,273,,13,-1,260,122,158,,6485
314382,4000,Female,GM0351,Woudenberg,2018JJ00,2018,6485,,67,,59,,8,332,,13,319,274,,19,-3,255,58,67,,6552
314383,4000,Female,GM0351,Woudenberg,2019JJ00,2019,6552,,89,,58,,31,340,,21,319,250,,9,0,241,90,121,,6673
314384,4000,Female,GM0351,Woudenberg,2020JJ00,2020,6673,,79,,64,,15,421,,10,411,279,,14,-3,265,142,158,,6831
314385,4000,Female,GM0351,Woudenberg,2021JJ00,2021,6831,,86,,46,,40,354,,17,337,268,,3,1,265,86,125,,6956
314386,4000,Female,GM0351,Woudenberg,2022JJ00,2022,6956,,85,,60,,25,517,,118,399,293,,21,0,272,224,247,,7203
314387,4000,Female,GM0351,Woudenberg,2023JJ00,2023,7203,,78,,75,,3,448,,55,393,314,,34,-3,280,134,137,,7340
314458,4000,Female,GM0874,Woudrichem,2012JJ00,2012,7203,,56,,79,,-23,262,,21,241,230,,3,2,227,32,9,,7212
314459,4000,Female,GM0874,Woudrichem,2013JJ00,2013,7212,,78,,63,,15,230,,25,205,242,,19,0,223,-12,3,,7215
314460,4000,Female,GM0874,Woudrichem,2014JJ00,2014,7215,,60,,70,,-10,257,,21,236,276,,14,0,262,-19,-29,,7186
314461,4000,Female,GM0874,Woudrichem,2015JJ00,2015,7186,,82,,64,,18,303,,20,283,252,,12,0,240,51,70,,7256
314462,4000,Female,GM0874,Woudrichem,2016JJ00,2016,7256,,65,,67,,-2,300,,20,280,299,,20,0,279,1,-1,,7255
314463,4000,Female,GM0874,Woudrichem,2017JJ00,2017,7255,,80,,69,,11,373,,26,347,333,,16,-2,317,40,50,,7305
314464,4000,Female,GM0874,Woudrichem,2018JJ00,2018,7305,,74,,70,,4,363,,22,341,272,,16,1,256,91,89,,7394
315196,4000,Female,GM0479,Zaanstad,2012JJ00,2012,74969,,781,,653,,128,2806,,472,2334,2293,,401,-62,1892,513,651,,75620
315197,4000,Female,GM0479,Zaanstad,2013JJ00,2013,75620,,772,,664,,108,2853,,530,2323,2444,,472,-88,1972,409,523,,76143
315198,4000,Female,GM0479,Zaanstad,2014JJ00,2014,76143,,794,,651,,143,2890,,587,2303,2544,,445,-94,2099,346,497,,76640
315199,4000,Female,GM0479,Zaanstad,2015JJ00,2015,76640,,827,,659,,168,3094,,555,2539,2783,,463,-69,2320,311,482,,77122
315200,4000,Female,GM0479,Zaanstad,2016JJ00,2016,77122,,879,,675,,204,3243,,569,2674,2900,,504,-59,2396,343,543,,77665
315201,4000,Female,GM0479,Zaanstad,2017JJ00,2017,77665,,837,,654,,183,3455,,611,2844,3047,,461,-39,2586,408,588,,78253
315202,4000,Female,GM0479,Zaanstad,2018JJ00,2018,78253,,828,,688,,140,3582,,720,2862,3287,,517,-54,2770,295,437,,78690
315203,4000,Female,GM0479,Zaanstad,2019JJ00,2019,78690,,879,,648,,231,3592,,763,2829,3283,,469,-83,2814,309,541,,79231
315204,4000,Female,GM0479,Zaanstad,2020JJ00,2020,79231,,753,,819,,-66,3416,,716,2700,3436,,432,-49,3004,-20,-95,,79136
315205,4000,Female,GM0479,Zaanstad,2021JJ00,2021,79136,,873,,693,,180,3444,,691,2753,3453,,446,-47,3007,-9,172,,79308
315206,4000,Female,GM0479,Zaanstad,2022JJ00,2022,79308,,783,,794,,-11,4421,,1323,3098,3448,,542,-65,2906,973,962,,80270
315207,4000,Female,GM0479,Zaanstad,2023JJ00,2023,80270,,759,,772,,-13,4466,,1127,3339,3492,,692,-105,2800,974,957,,81227
315278,4000,Female,GM0297,Zaltbommel,2012JJ00,2012,13374,,133,,102,,31,468,,98,370,422,,31,-4,391,46,77,,13451
315279,4000,Female,GM0297,Zaltbommel,2013JJ00,2013,13451,,153,,99,,54,462,,61,401,414,,37,-2,377,48,101,,13552
315280,4000,Female,GM0297,Zaltbommel,2014JJ00,2014,13552,,148,,102,,46,498,,104,394,460,,57,-3,403,38,83,,13635
315281,4000,Female,GM0297,Zaltbommel,2015JJ00,2015,13635,,151,,108,,43,535,,80,455,489,,52,2,437,46,90,,13725
315282,4000,Female,GM0297,Zaltbommel,2016JJ00,2016,13725,,155,,102,,53,593,,116,477,552,,68,-10,484,41,94,,13819
315283,4000,Female,GM0297,Zaltbommel,2017JJ00,2017,13819,,164,,113,,51,662,,116,546,618,,86,-17,532,44,95,,13914
315284,4000,Female,GM0297,Zaltbommel,2018JJ00,2018,13914,,143,,99,,44,788,,233,555,629,,113,-11,516,159,202,,14116
315285,4000,Female,GM0297,Zaltbommel,2019JJ00,2019,14116,,151,,104,,47,823,,227,596,685,,142,-31,543,138,185,,14301
315286,4000,Female,GM0297,Zaltbommel,2020JJ00,2020,14301,,164,,112,,52,936,,215,721,676,,137,-27,539,260,313,,14614
315287,4000,Female,GM0297,Zaltbommel,2021JJ00,2021,14614,,182,,104,,78,876,,211,665,661,,157,-40,504,215,292,,14906
315288,4000,Female,GM0297,Zaltbommel,2022JJ00,2022,14906,,159,,104,,55,964,,373,591,762,,222,-71,540,202,253,,15159
315289,4000,Female,GM0297,Zaltbommel,2023JJ00,2023,15159,,168,,106,,62,899,,429,470,918,,314,-104,604,-19,43,,15202
315442,4000,Female,GM0473,Zandvoort,2012JJ00,2012,8649,,63,,136,,-73,463,,84,379,400,,65,-16,335,63,-10,,8639
315443,4000,Female,GM0473,Zandvoort,2013JJ00,2013,8639,,65,,120,,-55,446,,86,360,423,,67,-12,356,23,-31,,8608
315444,4000,Female,GM0473,Zandvoort,2014JJ00,2014,8608,,60,,119,,-59,540,,87,453,448,,61,-11,387,92,33,,8641
315445,4000,Female,GM0473,Zandvoort,2015JJ00,2015,8641,,62,,122,,-60,549,,77,472,435,,46,5,389,114,56,,8697
315446,4000,Female,GM0473,Zandvoort,2016JJ00,2016,8697,,54,,142,,-88,612,,71,541,493,,72,-8,421,119,30,,8727
315447,4000,Female,GM0473,Zandvoort,2017JJ00,2017,8727,,69,,148,,-79,605,,89,516,477,,72,-12,405,128,49,,8776
315448,4000,Female,GM0473,Zandvoort,2018JJ00,2018,8776,,71,,128,,-57,555,,92,463,476,,58,-7,418,79,21,,8797
315449,4000,Female,GM0473,Zandvoort,2019JJ00,2019,8797,,56,,100,,-44,547,,114,433,430,,79,-10,351,117,71,,8868
315450,4000,Female,GM0473,Zandvoort,2020JJ00,2020,8868,,60,,121,,-61,601,,104,497,523,,79,-17,444,78,19,,8887
315451,4000,Female,GM0473,Zandvoort,2021JJ00,2021,8887,,52,,124,,-72,551,,89,462,574,,84,-5,490,-23,-96,,8791
315452,4000,Female,GM0473,Zandvoort,2022JJ00,2022,8791,,60,,109,,-49,758,,191,567,483,,85,-5,398,275,227,,9018
315453,4000,Female,GM0473,Zandvoort,2023JJ00,2023,9018,,60,,117,,-57,597,,130,467,560,,105,-33,455,37,-21,,8997
315524,4000,Female,GM0707,Zederik,2012JJ00,2012,6754,,73,,46,,27,208,,9,199,193,,5,3,188,15,42,,6796
315525,4000,Female,GM0707,Zederik,2013JJ00,2013,6796,,69,,68,,1,222,,16,206,193,,11,0,182,29,31,,6827
315526,4000,Female,GM0707,Zederik,2014JJ00,2014,6827,,77,,76,,1,244,,10,234,231,,5,-1,226,13,15,,6842
315527,4000,Female,GM0707,Zederik,2015JJ00,2015,6842,,67,,61,,6,268,,18,250,271,,13,-3,258,-3,4,,6846
315528,4000,Female,GM0707,Zederik,2016JJ00,2016,6846,,108,,61,,47,276,,17,259,264,,6,2,258,12,61,,6907
315529,4000,Female,GM0707,Zederik,2017JJ00,2017,6907,,77,,63,,14,346,,12,334,287,,9,0,278,59,72,,6979
315530,4000,Female,GM0707,Zederik,2018JJ00,2018,6979,,90,,74,,16,286,,21,265,302,,9,1,293,-16,-4,,6975
315688,4000,Female,GM0478,Zeevang,2012JJ00,2012,3177,,23,,19,,4,120,,6,114,143,,17,0,126,-23,-19,,3158
315689,4000,Female,GM0478,Zeevang,2013JJ00,2013,3158,,18,,28,,-10,155,,27,128,134,,8,2,126,21,12,,3170
315690,4000,Female,GM0478,Zeevang,2014JJ00,2014,3170,,17,,17,,0,147,,44,103,163,,36,1,127,-16,-17,,3153
315691,4000,Female,GM0478,Zeevang,2015JJ00,2015,3153,,21,,22,,-1,170,,19,151,176,,26,-2,150,-6,-10,,3143
315770,4000,Female,GM0050,Zeewolde,2012JJ00,2012,10488,,120,,42,,78,390,,45,345,469,,36,-4,433,-79,-3,,10485
315771,4000,Female,GM0050,Zeewolde,2013JJ00,2013,10485,,102,,40,,62,507,,145,362,497,,61,-7,436,10,72,,10557
315772,4000,Female,GM0050,Zeewolde,2014JJ00,2014,10557,,113,,30,,83,631,,248,383,643,,180,-1,463,-12,138,,10695
315773,4000,Female,GM0050,Zeewolde,2015JJ00,2015,10695,,100,,38,,62,822,,399,423,824,,310,2,514,-2,57,,10752
315774,4000,Female,GM0050,Zeewolde,2016JJ00,2016,10752,,97,,35,,62,1034,,447,587,938,,317,-44,621,96,156,,10908
315775,4000,Female,GM0050,Zeewolde,2017JJ00,2017,10908,,106,,41,,65,1233,,421,812,1249,,415,-28,834,-16,50,,10958
315776,4000,Female,GM0050,Zeewolde,2018JJ00,2018,10958,,110,,56,,54,1009,,401,608,1101,,401,-19,700,-92,-41,,10917
315777,4000,Female,GM0050,Zeewolde,2019JJ00,2019,10917,,103,,48,,55,1178,,574,604,1072,,494,-14,578,106,162,,11079
315778,4000,Female,GM0050,Zeewolde,2020JJ00,2020,11079,,102,,49,,53,1041,,342,699,951,,323,-13,628,90,138,,11217
315779,4000,Female,GM0050,Zeewolde,2021JJ00,2021,11217,,113,,64,,49,1041,,397,644,860,,353,-6,507,181,231,,11448
315780,4000,Female,GM0050,Zeewolde,2022JJ00,2022,11448,,125,,54,,71,1073,,498,575,901,,397,-6,504,172,241,,11689
315781,4000,Female,GM0050,Zeewolde,2023JJ00,2023,11689,,113,,75,,38,1127,,433,694,1069,,422,-7,647,58,97,,11786
315934,4000,Female,GM0355,Zeist,2012JJ00,2012,31724,,296,,356,,-60,1956,,293,1663,1877,,170,-30,1707,79,18,,31742
315935,4000,Female,GM0355,Zeist,2013JJ00,2013,31742,,306,,391,,-85,1963,,267,1696,1999,,201,-33,1798,-36,-127,,31615
315936,4000,Female,GM0355,Zeist,2014JJ00,2014,31615,,313,,361,,-48,2263,,330,1933,2078,,245,-50,1833,185,141,,31756
315937,4000,Female,GM0355,Zeist,2015JJ00,2015,31756,,313,,380,,-67,2580,,433,2147,2213,,193,-46,2020,367,299,,32055
315938,4000,Female,GM0355,Zeist,2016JJ00,2016,32055,,321,,407,,-86,2659,,391,2268,2323,,207,-26,2116,336,248,,32303
315939,4000,Female,GM0355,Zeist,2017JJ00,2017,32303,,316,,434,,-118,2739,,388,2351,2349,,237,-61,2112,390,271,,32574
315940,4000,Female,GM0355,Zeist,2018JJ00,2018,32574,,318,,395,,-77,2588,,324,2264,2238,,232,-47,2006,350,268,,32842
315941,4000,Female,GM0355,Zeist,2019JJ00,2019,32842,,319,,419,,-100,2625,,396,2229,2039,,221,-32,1818,586,486,,33328
315942,4000,Female,GM0355,Zeist,2020JJ00,2020,33328,,299,,421,,-122,2358,,260,2098,2261,,168,-5,2093,97,-28,,33300
315943,4000,Female,GM0355,Zeist,2021JJ00,2021,33300,,353,,432,,-79,2796,,346,2450,2236,,181,-20,2055,560,480,,33780
315944,4000,Female,GM0355,Zeist,2022JJ00,2022,33780,,315,,454,,-139,3073,,583,2490,2653,,261,-39,2392,420,288,,34068
315945,4000,Female,GM0355,Zeist,2023JJ00,2023,34068,,272,,426,,-154,2722,,379,2343,2612,,292,-50,2320,110,-43,,34025
316098,4000,Female,GM0299,Zevenaar,2012JJ00,2012,16467,,135,,129,,6,623,,57,566,636,,49,-9,587,-13,-8,,16459
316099,4000,Female,GM0299,Zevenaar,2013JJ00,2013,16459,,156,,146,,10,611,,55,556,624,,44,-1,580,-13,-4,,16455
316100,4000,Female,GM0299,Zevenaar,2014JJ00,2014,16455,,155,,116,,39,641,,55,586,665,,50,-2,615,-24,15,,16470
316101,4000,Female,GM0299,Zevenaar,2015JJ00,2015,16470,,128,,156,,-28,731,,59,672,694,,35,0,659,37,10,,16480
316102,4000,Female,GM0299,Zevenaar,2016JJ00,2016,16480,,135,,151,,-16,753,,49,704,729,,40,-6,689,24,9,,16489
316103,4000,Female,GM0299,Zevenaar,2017JJ00,2017,16489,,133,,146,,-13,887,,55,832,775,,32,-7,743,112,110,,16599
316104,4000,Female,GM0299,Zevenaar,2018JJ00,2018,22056,,159,,215,,-56,988,,76,912,924,,48,-7,876,64,7,,22063
316105,4000,Female,GM0299,Zevenaar,2019JJ00,2019,22063,,168,,263,,-95,1080,,86,994,858,,49,2,809,222,127,,22190
316106,4000,Female,GM0299,Zevenaar,2020JJ00,2020,22190,,158,,222,,-64,1142,,104,1038,891,,54,0,837,251,186,,22376
316107,4000,Female,GM0299,Zevenaar,2021JJ00,2021,22376,,195,,271,,-76,1171,,84,1087,877,,63,-7,814,294,218,,22594
316108,4000,Female,GM0299,Zevenaar,2022JJ00,2022,22594,,196,,280,,-84,1209,,255,954,937,,127,-27,810,272,184,,22778
316109,4000,Female,GM0299,Zevenaar,2023JJ00,2023,22778,,184,,235,,-51,974,,118,856,939,,95,-38,844,35,-19,,22759
316590,4000,Female,GM0476,Zijpe,2012JJ00,2012,5738,,43,,37,,6,258,,34,224,278,,32,-8,246,-20,-19,,5719
316754,4000,Female,GM0637,Zoetermeer,2012JJ00,2012,62377,,641,,376,,265,2500,,298,2202,2335,,355,-30,1980,165,431,,62808
316755,4000,Female,GM0637,Zoetermeer,2013JJ00,2013,62808,,627,,417,,210,2424,,296,2128,2280,,363,-40,1917,144,354,,63162
316756,4000,Female,GM0637,Zoetermeer,2014JJ00,2014,63162,,652,,408,,244,2407,,320,2087,2347,,342,-24,2005,60,309,,63471
316757,4000,Female,GM0637,Zoetermeer,2015JJ00,2015,63471,,598,,415,,183,2409,,305,2104,2568,,360,-62,2208,-159,30,,63501
316758,4000,Female,GM0637,Zoetermeer,2016JJ00,2016,63501,,670,,436,,234,2887,,355,2532,2778,,352,-27,2426,109,339,,63840
316759,4000,Female,GM0637,Zoetermeer,2017JJ00,2017,63840,,623,,424,,199,2555,,303,2252,2727,,232,-13,2495,-172,30,,63870
316760,4000,Female,GM0637,Zoetermeer,2018JJ00,2018,63870,,631,,472,,159,2644,,401,2243,2716,,296,-14,2420,-72,91,,63961
316761,4000,Female,GM0637,Zoetermeer,2019JJ00,2019,63961,,577,,470,,107,2631,,359,2272,2607,,191,1,2416,24,132,,64093
316762,4000,Female,GM0637,Zoetermeer,2020JJ00,2020,64093,,596,,518,,78,2585,,296,2289,2702,,168,-5,2534,-117,-36,,64057
316763,4000,Female,GM0637,Zoetermeer,2021JJ00,2021,64057,,629,,523,,106,2751,,307,2444,2569,,198,-1,2371,182,290,,64347
316764,4000,Female,GM0637,Zoetermeer,2022JJ00,2022,64347,,589,,551,,38,3196,,686,2510,2653,,285,-22,2368,543,579,,64926
316765,4000,Female,GM0637,Zoetermeer,2023JJ00,2023,64926,,550,,481,,69,3264,,519,2745,2683,,307,-13,2376,581,643,,65569
316836,4000,Female,GM0638,Zoeterwoude,2012JJ00,2012,4129,,29,,32,,-3,174,,20,154,195,,15,-1,180,-21,-25,,4104
316837,4000,Female,GM0638,Zoeterwoude,2013JJ00,2013,4104,,27,,38,,-11,143,,8,135,173,,6,2,167,-30,-42,,4062
316838,4000,Female,GM0638,Zoeterwoude,2014JJ00,2014,4062,,42,,33,,9,196,,12,184,190,,15,0,175,6,15,,4077
316839,4000,Female,GM0638,Zoeterwoude,2015JJ00,2015,4077,,27,,26,,1,190,,15,175,189,,9,3,180,1,2,,4079
316840,4000,Female,GM0638,Zoeterwoude,2016JJ00,2016,4079,,38,,26,,12,326,,23,303,196,,12,2,184,130,142,,4221
316841,4000,Female,GM0638,Zoeterwoude,2017JJ00,2017,4221,,27,,32,,-5,253,,12,241,219,,17,-1,202,34,29,,4250
316842,4000,Female,GM0638,Zoeterwoude,2018JJ00,2018,4250,,42,,41,,1,184,,16,168,187,,11,1,176,-3,-3,,4247
316843,4000,Female,GM0638,Zoeterwoude,2019JJ00,2019,4247,,34,,34,,0,272,,25,247,221,,18,0,203,51,52,,4299
316844,4000,Female,GM0638,Zoeterwoude,2020JJ00,2020,4299,,41,,51,,-10,356,,24,332,236,,14,0,222,120,110,,4409
316845,4000,Female,GM0638,Zoeterwoude,2021JJ00,2021,4409,,42,,41,,1,423,,34,389,189,,11,0,178,234,235,,4644
316846,4000,Female,GM0638,Zoeterwoude,2022JJ00,2022,4644,,43,,40,,3,285,,61,224,205,,30,-2,175,80,83,,4727
316847,4000,Female,GM0638,Zoeterwoude,2023JJ00,2023,4727,,53,,40,,13,409,,55,354,250,,29,2,221,159,171,,4898
317410,4000,Female,GM0056,Zuidhorn,2012JJ00,2012,9375,,105,,78,,27,364,,34,330,384,,28,-5,356,-20,7,,9382
317411,4000,Female,GM0056,Zuidhorn,2013JJ00,2013,9382,,76,,74,,2,403,,16,387,389,,18,0,371,14,16,,9398
317412,4000,Female,GM0056,Zuidhorn,2014JJ00,2014,9398,,93,,79,,14,396,,15,381,403,,21,-5,382,-7,7,,9405
317413,4000,Female,GM0056,Zuidhorn,2015JJ00,2015,9405,,97,,101,,-4,452,,23,429,423,,14,-2,409,29,25,,9430
317414,4000,Female,GM0056,Zuidhorn,2016JJ00,2016,9430,,93,,89,,4,490,,20,470,492,,30,-1,462,-2,2,,9432
317415,4000,Female,GM0056,Zuidhorn,2017JJ00,2017,9432,,106,,83,,23,504,,14,490,501,,21,-3,480,3,27,,9459
317416,4000,Female,GM0056,Zuidhorn,2018JJ00,2018,9459,,84,,93,,-9,526,,33,493,452,,14,2,438,74,64,,9523
317656,4000,Female,GM1892,Zuidplas,2012JJ00,2012,20495,,195,,145,,50,688,,65,623,692,,40,0,652,-4,44,,20539
317657,4000,Female,GM1892,Zuidplas,2013JJ00,2013,20539,,202,,143,,59,770,,90,680,754,,63,2,691,16,80,,20619
317658,4000,Female,GM1892,Zuidplas,2014JJ00,2014,20619,,196,,123,,73,713,,85,628,842,,69,-6,773,-129,-56,,20563
317659,4000,Female,GM1892,Zuidplas,2015JJ00,2015,20563,,197,,138,,59,836,,90,746,830,,68,-4,762,6,68,,20631
317660,4000,Female,GM1892,Zuidplas,2016JJ00,2016,20631,,207,,150,,57,1047,,90,957,851,,64,-4,787,196,255,,20886
317661,4000,Female,GM1892,Zuidplas,2017JJ00,2017,20886,,213,,154,,59,1165,,79,1086,985,,59,-6,926,180,240,,21126
317662,4000,Female,GM1892,Zuidplas,2018JJ00,2018,21126,,217,,165,,52,1246,,92,1154,866,,51,-3,815,380,432,,21558
317663,4000,Female,GM1892,Zuidplas,2019JJ00,2019,21558,,245,,121,,124,1395,,99,1296,977,,58,-1,919,418,546,,22104
317664,4000,Female,GM1892,Zuidplas,2020JJ00,2020,22104,,267,,163,,104,1501,,88,1413,965,,47,5,918,536,639,,22743
317665,4000,Female,GM1892,Zuidplas,2021JJ00,2021,22743,,271,,173,,98,1208,,74,1134,1005,,64,-7,941,203,301,,23044
317666,4000,Female,GM1892,Zuidplas,2022JJ00,2022,23044,,247,,176,,71,1440,,220,1220,942,,89,-6,853,498,568,,23612
317667,4000,Female,GM1892,Zuidplas,2023JJ00,2023,23612,,264,,170,,94,1419,,214,1205,1103,,163,-14,940,316,411,,24023
318066,4000,Female,GM0879,Zundert,2012JJ00,2012,10357,,98,,102,,-4,450,,159,291,454,,170,-56,284,-4,-10,,10347
318067,4000,Female,GM0879,Zundert,2013JJ00,2013,10347,,81,,90,,-9,719,,454,265,646,,344,-10,302,73,64,,10411
318068,4000,Female,GM0879,Zundert,2014JJ00,2014,10411,,70,,91,,-21,681,,401,280,672,,336,-3,336,9,-11,,10400
318069,4000,Female,GM0879,Zundert,2015JJ00,2015,10400,,91,,81,,10,743,,373,370,692,,322,-2,370,51,67,,10467
318070,4000,Female,GM0879,Zundert,2016JJ00,2016,10467,,82,,100,,-18,749,,355,394,655,,330,2,325,94,69,,10536
318071,4000,Female,GM0879,Zundert,2017JJ00,2017,10536,,86,,104,,-18,727,,324,403,720,,327,-1,393,7,-14,,10522
318072,4000,Female,GM0879,Zundert,2018JJ00,2018,10522,,90,,120,,-30,795,,312,483,713,,337,-4,376,82,47,,10569
318073,4000,Female,GM0879,Zundert,2019JJ00,2019,10569,,96,,108,,-12,701,,278,423,568,,240,1,328,133,121,,10690
318074,4000,Female,GM0879,Zundert,2020JJ00,2020,10690,,81,,115,,-34,670,,223,447,585,,228,-6,357,85,51,,10741
318075,4000,Female,GM0879,Zundert,2021JJ00,2021,10741,,106,,115,,-9,636,,254,382,512,,203,-1,309,124,114,,10855
318076,4000,Female,GM0879,Zundert,2022JJ00,2022,10855,,96,,122,,-26,735,,299,436,545,,224,-9,321,190,164,,11019
318077,4000,Female,GM0879,Zundert,2023JJ00,2023,11019,,94,,130,,-36,668,,281,387,616,,273,-4,343,52,16,,11035
318148,4000,Female,GM0301,Zutphen,2012JJ00,2012,24120,,197,,231,,-34,1128,,103,1025,1040,,89,-4,951,88,54,,24174
318149,4000,Female,GM0301,Zutphen,2013JJ00,2013,24174,,203,,228,,-25,1013,,90,923,1038,,122,-22,916,-25,-50,,24124
318150,4000,Female,GM0301,Zutphen,2014JJ00,2014,24124,,207,,249,,-42,977,,74,903,1143,,107,-17,1036,-166,-210,,23914
318151,4000,Female,GM0301,Zutphen,2015JJ00,2015,23914,,218,,218,,0,1110,,97,1013,1021,,66,-2,955,89,90,,24004
318152,4000,Female,GM0301,Zutphen,2016JJ00,2016,24004,,181,,241,,-60,1321,,180,1141,1145,,77,-4,1068,176,113,,24117
318153,4000,Female,GM0301,Zutphen,2017JJ00,2017,24117,,196,,247,,-51,1501,,147,1354,1325,,81,-15,1244,176,125,,24242
318154,4000,Female,GM0301,Zutphen,2018JJ00,2018,24242,,176,,239,,-63,1306,,142,1164,1240,,82,-8,1158,66,2,,24244
318155,4000,Female,GM0301,Zutphen,2019JJ00,2019,24244,,183,,262,,-79,1453,,162,1291,1180,,98,-8,1082,273,192,,24436
318156,4000,Female,GM0301,Zutphen,2020JJ00,2020,24436,,194,,238,,-44,1334,,104,1230,1207,,50,-7,1157,127,80,,24516
318157,4000,Female,GM0301,Zutphen,2021JJ00,2021,24516,,194,,269,,-75,1418,,91,1327,1234,,78,-20,1156,184,102,,24618
318158,4000,Female,GM0301,Zutphen,2022JJ00,2022,24618,,187,,306,,-119,1364,,175,1189,1137,,104,-22,1033,227,104,,24722
318159,4000,Female,GM0301,Zutphen,2023JJ00,2023,24722,,195,,269,,-74,1402,,124,1278,1285,,119,-15,1166,117,35,,24757
318476,4000,Female,GM1896,Zwartewaterland,2012JJ00,2012,10872,,131,,69,,62,324,,38,286,331,,24,-6,307,-7,56,,10928
318477,4000,Female,GM1896,Zwartewaterland,2013JJ00,2013,10928,,140,,72,,68,300,,39,261,371,,39,-14,332,-71,-4,,10924
318478,4000,Female,GM1896,Zwartewaterland,2014JJ00,2014,10924,,140,,84,,56,279,,52,227,374,,16,1,358,-95,-39,,10885
318479,4000,Female,GM1896,Zwartewaterland,2015JJ00,2015,10885,,151,,87,,64,343,,42,301,348,,21,-4,327,-5,57,,10942
318480,4000,Female,GM1896,Zwartewaterland,2016JJ00,2016,10942,,127,,72,,55,362,,40,322,410,,32,-1,378,-48,7,,10949
318481,4000,Female,GM1896,Zwartewaterland,2017JJ00,2017,10949,,144,,70,,74,424,,55,369,411,,38,-4,373,13,88,,11037
318482,4000,Female,GM1896,Zwartewaterland,2018JJ00,2018,11037,,133,,83,,50,353,,32,321,386,,35,-3,351,-33,17,,11054
318483,4000,Female,GM1896,Zwartewaterland,2019JJ00,2019,11054,,150,,85,,65,430,,63,367,389,,29,-4,360,41,107,,11161
318484,4000,Female,GM1896,Zwartewaterland,2020JJ00,2020,11161,,159,,97,,62,406,,61,345,403,,35,-2,368,3,64,,11225
318485,4000,Female,GM1896,Zwartewaterland,2021JJ00,2021,11225,,138,,79,,59,405,,42,363,364,,29,-2,335,41,99,,11324
318486,4000,Female,GM1896,Zwartewaterland,2022JJ00,2022,11324,,156,,76,,80,564,,172,392,452,,79,-7,373,112,192,,11516
318487,4000,Female,GM1896,Zwartewaterland,2023JJ00,2023,11516,,135,,80,,55,408,,74,334,416,,54,-13,362,-8,46,,11562
318722,4000,Female,GM0642,Zwijndrecht,2012JJ00,2012,22857,,236,,187,,49,935,,66,869,875,,82,-11,793,60,108,,22965
318723,4000,Female,GM0642,Zwijndrecht,2013JJ00,2013,22965,,221,,212,,9,932,,87,845,1001,,97,-13,904,-69,-61,,22904
318724,4000,Female,GM0642,Zwijndrecht,2014JJ00,2014,22904,,244,,223,,21,907,,87,820,962,,112,-15,850,-55,-35,,22869
318725,4000,Female,GM0642,Zwijndrecht,2015JJ00,2015,22869,,194,,229,,-35,990,,86,904,994,,90,-2,904,-4,-38,,22831
318726,4000,Female,GM0642,Zwijndrecht,2016JJ00,2016,22831,,228,,247,,-19,1147,,84,1063,1100,,73,-4,1027,47,27,,22858
318727,4000,Female,GM0642,Zwijndrecht,2017JJ00,2017,22858,,262,,255,,7,1270,,94,1176,1194,,65,1,1129,76,85,,22943
318728,4000,Female,GM0642,Zwijndrecht,2018JJ00,2018,22943,,202,,244,,-42,1199,,107,1092,1117,,85,-8,1032,82,40,,22983
318729,4000,Female,GM0642,Zwijndrecht,2019JJ00,2019,22983,,221,,253,,-32,1131,,112,1019,1036,,48,-1,988,95,60,,23043
318730,4000,Female,GM0642,Zwijndrecht,2020JJ00,2020,23043,,185,,283,,-98,1159,,81,1078,1082,,73,-6,1009,77,-22,,23021
318731,4000,Female,GM0642,Zwijndrecht,2021JJ00,2021,23021,,259,,281,,-22,1263,,99,1164,1220,,74,-7,1146,43,20,,23041
318732,4000,Female,GM0642,Zwijndrecht,2022JJ00,2022,23041,,241,,266,,-25,1235,,251,984,1123,,84,-17,1039,112,86,,23127
318733,4000,Female,GM0642,Zwijndrecht,2023JJ00,2023,23127,,183,,252,,-69,1173,,158,1015,1211,,131,-6,1080,-38,-113,,23014
318804,4000,Female,GM0193,Zwolle,2012JJ00,2012,62247,,841,,473,,368,3121,,375,2746,3087,,353,-64,2734,34,399,,62646
318805,4000,Female,GM0193,Zwolle,2013JJ00,2013,62646,,783,,517,,266,3070,,346,2724,3213,,404,-73,2809,-143,126,,62772
318806,4000,Female,GM0193,Zwolle,2014JJ00,2014,62772,,799,,492,,307,3219,,343,2876,3197,,367,-77,2830,22,330,,63102
318807,4000,Female,GM0193,Zwolle,2015JJ00,2015,63102,,743,,508,,235,3432,,366,3066,3213,,335,-14,2878,219,452,,63554
318808,4000,Female,GM0193,Zwolle,2016JJ00,2016,63554,,760,,501,,259,3507,,408,3099,3496,,407,-37,3089,11,267,,63821
318809,4000,Female,GM0193,Zwolle,2017JJ00,2017,63821,,724,,510,,214,3523,,447,3076,3460,,327,-29,3133,63,265,,64086
318810,4000,Female,GM0193,Zwolle,2018JJ00,2018,64086,,715,,514,,201,3680,,445,3235,3263,,379,-16,2884,417,617,,64703
318811,4000,Female,GM0193,Zwolle,2019JJ00,2019,64703,,719,,497,,222,3639,,493,3146,3202,,348,-19,2854,437,649,,65352
318812,4000,Female,GM0193,Zwolle,2020JJ00,2020,65352,,731,,535,,196,3504,,331,3173,3153,,294,-29,2859,351,544,,65896
318813,4000,Female,GM0193,Zwolle,2021JJ00,2021,65896,,692,,535,,157,3421,,432,2989,3181,,268,-24,2913,240,392,,66288
318814,4000,Female,GM0193,Zwolle,2022JJ00,2022,66288,,700,,570,,130,4061,,1075,2986,3246,,467,-73,2779,815,940,,67228
318815,4000,Female,GM0193,Zwolle,2023JJ00,2023,67228,,691,,526,,165,3653,,611,3042,3492,,502,-80,2990,161,318,,67546